seID,SrcIp,DstIp,SrcPort,DstPort,timestamp,ActualUlVolume,ActualDlVolume,ActualTotalVolume,ActualUlPacket,ActualDlPacket,ActualTotalPacket
1,201392386,2170660915,0,0,2024-10-04 19:18:50,128,0,128,1,0,1
1,201392386,2170660915,0,0,2024-10-04 19:18:51,0,84,84,0,1,1
1,201392386,2170660915,0,0,2024-10-04 19:18:52,256,84,340,2,1,3
1,201392386,2170660915,0,0,2024-10-04 19:18:53,128,84,212,1,1,2
1,201392386,2170660915,0,0,2024-10-04 19:18:54,128,84,212,1,1,2
1,201392386,2170660915,0,0,2024-10-04 19:18:55,128,84,212,1,1,2
1,201392386,2170660915,0,0,2024-10-04 19:18:56,128,84,212,1,1,2
1,201392386,2170660915,0,0,2024-10-04 19:18:57,128,84,212,1,1,2
1,201392386,2170660915,0,0,2024-10-04 19:18:58,128,84,212,1,1,2
1,201392386,2170660915,0,0,2024-10-04 19:18:59,128,84,212,1,1,2
1,201392386,2170660915,0,0,2024-10-04 19:19:00,0,84,84,0,1,1
1,201392386,2170660915,0,0,2024-10-04 19:19:01,0,0,0,0,0,0
1,201392386,2170660915,57029,36895,2024-10-04 19:19:02,666,507,1173,6,6,12
1,201392386,2170660915,0,0,2024-10-04 19:19:02,128,0,128,1,0,1
1,201392386,2170660915,57029,36895,2024-10-04 19:19:03,0,0,0,0,0,0
1,201392386,2170660915,0,0,2024-10-04 19:19:03,128,84,212,1,1,2
1,201392386,2170660915,57029,36895,2024-10-04 19:19:04,0,0,0,0,0,0
1,201392386,2170660915,0,0,2024-10-04 19:19:04,128,84,212,1,1,2
1,201392386,2170660915,57029,36895,2024-10-04 19:19:05,0,0,0,0,0,0
1,201392386,2170660915,0,0,2024-10-04 19:19:05,0,84,84,0,1,1
1,201392386,2170660915,57029,36895,2024-10-04 19:19:06,0,0,0,0,0,0
1,201392386,2170660915,0,0,2024-10-04 19:19:06,0,0,0,0,0,0
1,201392386,2170660915,57029,36895,2024-10-04 19:19:07,0,0,0,0,0,0
1,201392386,2170660915,0,0,2024-10-04 19:19:07,0,0,0,0,0,0
1,201392386,2170660915,57029,36895,2024-10-04 19:19:08,0,0,0,0,0,0
1,201392386,2170660915,0,0,2024-10-04 19:19:08,128,84,212,1,1,2
1,201392386,2170660915,57029,36895,2024-10-04 19:19:09,0,0,0,0,0,0
1,201392386,2170660915,0,0,2024-10-04 19:19:09,128,84,212,1,1,2
1,201392386,2170660915,57029,36895,2024-10-04 19:19:10,0,0,0,0,0,0
1,201392386,1145490692,38630,47873,2024-10-04 19:19:10,3516,52813,56329,26,42,68
1,201392386,2170660915,0,0,2024-10-04 19:19:10,128,84,212,1,1,2
1,201392386,2170660915,57029,36895,2024-10-04 19:19:11,0,0,0,0,0,0
1,201392386,1145490692,38630,47873,2024-10-04 19:19:11,576,16656,17232,6,10,16
1,201392386,2170660915,0,0,2024-10-04 19:19:11,0,0,0,0,0,0
1,201392386,2170660915,57029,36895,2024-10-04 19:19:12,0,0,0,0,0,0
1,201392386,1145490692,38630,47873,2024-10-04 19:19:12,2520,39951,42471,25,30,55
1,201392386,2170660915,0,0,2024-10-04 19:19:12,0,0,0,0,0,0
1,201392386,2170660915,57029,36895,2024-10-04 19:19:13,0,0,0,0,0,0
1,201392386,1145490692,38630,47873,2024-10-04 19:19:13,0,0,0,0,0,0
1,201392386,2170660915,0,0,2024-10-04 19:19:13,0,0,0,0,0,0
1,201392386,2170660915,57029,36895,2024-10-04 19:19:14,0,0,0,0,0,0
1,201392386,1145490692,38630,47873,2024-10-04 19:19:14,0,0,0,0,0,0
1,201392386,2170660915,0,0,2024-10-04 19:19:14,0,0,0,0,0,0
1,201392386,2170660915,57029,36895,2024-10-04 19:19:15,0,0,0,0,0,0
1,201392386,1145490692,38630,47873,2024-10-04 19:19:15,0,0,0,0,0,0
1,201392386,2170660915,0,0,2024-10-04 19:19:15,0,0,0,0,0,0
1,201392386,2170660915,57029,36895,2024-10-04 19:19:16,0,0,0,0,0,0
1,201392386,1145490692,38630,47873,2024-10-04 19:19:16,0,0,0,0,0,0
1,201392386,2170660915,0,0,2024-10-04 19:19:16,0,0,0,0,0,0
1,201392386,2170660915,57029,36895,2024-10-04 19:19:17,0,0,0,0,0,0
1,201392386,1145490692,38630,47873,2024-10-04 19:19:17,0,0,0,0,0,0
1,201392386,2170660915,0,0,2024-10-04 19:19:17,0,0,0,0,0,0
1,201392386,2170660915,57029,36895,2024-10-04 19:19:18,0,0,0,0,0,0
1,201392386,1145490692,38630,47873,2024-10-04 19:19:18,0,0,0,0,0,0
1,201392386,2170660915,0,0,2024-10-04 19:19:18,0,0,0,0,0,0
1,201392386,2170660915,57029,36895,2024-10-04 19:19:19,0,0,0,0,0,0
1,201392386,1145490692,38630,47873,2024-10-04 19:19:19,0,0,0,0,0,0
1,201392386,2170660915,0,0,2024-10-04 19:19:19,0,0,0,0,0,0
1,201392386,2170660915,57029,36895,2024-10-04 19:19:20,0,0,0,0,0,0
1,201392386,1145490692,38630,47873,2024-10-04 19:19:20,0,0,0,0,0,0
1,201392386,2170660915,0,0,2024-10-04 19:19:20,0,0,0,0,0,0
1,201392386,2170660915,57029,36895,2024-10-04 19:19:21,0,0,0,0,0,0
1,201392386,1145490692,38630,47873,2024-10-04 19:19:21,0,0,0,0,0,0
1,201392386,2170660915,0,0,2024-10-04 19:19:21,0,0,0,0,0,0
1,201392386,2170660915,57029,36895,2024-10-04 19:19:22,0,0,0,0,0,0
1,201392386,1145490692,38630,47873,2024-10-04 19:19:22,0,0,0,0,0,0
1,201392386,2170660915,0,0,2024-10-04 19:19:22,128,0,128,1,0,1
1,201392386,2170660915,57029,36895,2024-10-04 19:19:23,0,0,0,0,0,0
1,201392386,1145490692,38630,47873,2024-10-04 19:19:23,0,0,0,0,0,0
1,201392386,2170660915,0,0,2024-10-04 19:19:23,128,168,296,1,2,3
1,201392386,2170660915,57029,36895,2024-10-04 19:19:24,0,0,0,0,0,0
1,201392386,1145490692,38630,47873,2024-10-04 19:19:24,0,0,0,0,0,0
1,201392386,2170660915,0,0,2024-10-04 19:19:24,0,0,0,0,0,0
1,201392386,2170660915,57029,36895,2024-10-04 19:19:25,0,0,0,0,0,0
1,201392386,1145490692,38630,47873,2024-10-04 19:19:25,0,0,0,0,0,0
1,201392386,2170660915,0,0,2024-10-04 19:19:25,256,84,340,2,1,3
1,201392386,2170660915,57029,36895,2024-10-04 19:19:26,0,0,0,0,0,0
1,201392386,1145490692,38630,47873,2024-10-04 19:19:26,0,0,0,0,0,0
1,201392386,2170660915,0,0,2024-10-04 19:19:26,128,84,212,1,1,2
1,201392386,2170660915,57029,36895,2024-10-04 19:19:27,0,0,0,0,0,0
1,201392386,1145490692,38630,47873,2024-10-04 19:19:27,0,0,0,0,0,0
1,201392386,2170660915,0,0,2024-10-04 19:19:27,128,84,212,1,1,2
1,201392386,2170660915,57029,36895,2024-10-04 19:19:28,0,0,0,0,0,0
1,201392386,1145490692,38630,47873,2024-10-04 19:19:28,0,0,0,0,0,0
1,201392386,2170660915,0,0,2024-10-04 19:19:28,128,84,212,1,1,2
1,201392386,2170660915,57029,36895,2024-10-04 19:19:29,0,0,0,0,0,0
1,201392386,1145490692,38630,47873,2024-10-04 19:19:29,0,0,0,0,0,0
1,201392386,2170660915,0,0,2024-10-04 19:19:29,128,84,212,1,1,2
1,201392386,2170660915,57029,36895,2024-10-04 19:19:30,0,0,0,0,0,0
1,201392386,1145490692,38630,47873,2024-10-04 19:19:30,0,0,0,0,0,0
1,201392386,2170660915,0,0,2024-10-04 19:19:30,128,84,212,1,1,2
1,201392386,2170660915,57029,36895,2024-10-04 19:19:31,0,0,0,0,0,0
1,201392386,1145490692,38630,47873,2024-10-04 19:19:31,0,0,0,0,0,0
1,201392386,2170660915,0,0,2024-10-04 19:19:31,128,84,212,1,1,2
1,201392386,2170660915,57029,36895,2024-10-04 19:19:32,0,0,0,0,0,0
1,201392386,1145490692,38630,47873,2024-10-04 19:19:32,0,0,0,0,0,0
1,201392386,2170660915,0,0,2024-10-04 19:19:32,0,84,84,0,1,1
1,201392386,2170660915,44760,36895,2024-10-04 19:19:33,666,507,1173,6,6,12
1,201392386,2170660915,57029,36895,2024-10-04 19:19:33,0,0,0,0,0,0
1,201392386,2170660915,0,0,2024-10-04 19:19:33,0,0,0,0,0,0
1,201392386,2170660915,44760,36895,2024-10-04 19:19:34,0,0,0,0,0,0
1,201392386,2170660915,57029,36895,2024-10-04 19:19:34,0,0,0,0,0,0
1,201392386,2170660915,0,0,2024-10-04 19:19:34,0,0,0,0,0,0
1,201392386,2170660915,44760,36895,2024-10-04 19:19:35,0,0,0,0,0,0
1,201392386,2170660915,57029,36895,2024-10-04 19:19:35,0,0,0,0,0,0
1,201392386,2170660915,0,0,2024-10-04 19:19:35,256,84,340,2,1,3
1,201392386,2170660915,44760,36895,2024-10-04 19:19:36,0,0,0,0,0,0
1,201392386,2170660915,57029,36895,2024-10-04 19:19:36,0,0,0,0,0,0
1,201392386,2170660915,0,0,2024-10-04 19:19:36,128,84,212,1,1,2
1,201392386,2170660915,44760,36895,2024-10-04 19:19:37,0,0,0,0,0,0
1,201392386,2170660915,57029,36895,2024-10-04 19:19:37,0,0,0,0,0,0
1,201392386,2170660915,0,0,2024-10-04 19:19:37,0,84,84,0,1,1
1,201392386,2170660915,44760,36895,2024-10-04 19:19:38,0,0,0,0,0,0
1,201392386,2170660915,57029,36895,2024-10-04 19:19:38,0,0,0,0,0,0
1,201392386,2170660915,0,0,2024-10-04 19:19:38,0,0,0,0,0,0
1,201392386,2170660915,44760,36895,2024-10-04 19:19:39,0,0,0,0,0,0
1,201392386,2170660915,57029,36895,2024-10-04 19:19:39,0,0,0,0,0,0
1,201392386,2170660915,0,0,2024-10-04 19:19:39,128,0,128,1,0,1
1,201392386,2170660915,44760,36895,2024-10-04 19:19:40,0,0,0,0,0,0
1,201392386,2170660915,57029,36895,2024-10-04 19:19:40,0,0,0,0,0,0
1,201392386,2170660915,0,0,2024-10-04 19:19:40,128,84,212,1,1,2
1,201392386,2170660915,44760,36895,2024-10-04 19:19:41,0,0,0,0,0,0
1,201392386,2170660915,57029,36895,2024-10-04 19:19:41,0,0,0,0,0,0
1,201392386,2170660915,0,0,2024-10-04 19:19:41,128,84,212,1,1,2
1,201392386,2170660915,44760,36895,2024-10-04 19:19:42,0,0,0,0,0,0
1,201392386,2170660915,57029,36895,2024-10-04 19:19:42,0,0,0,0,0,0
1,201392386,1145490689,57041,47873,2024-10-04 19:19:42,3552,50831,54383,27,42,69
1,201392386,2170660915,0,0,2024-10-04 19:19:42,0,84,84,0,1,1
1,201392386,2170660915,44760,36895,2024-10-04 19:19:43,0,0,0,0,0,0
1,201392386,2170660915,57029,36895,2024-10-04 19:19:43,0,0,0,0,0,0
1,201392386,1145490689,57041,47873,2024-10-04 19:19:43,2268,53192,55460,22,34,56
1,201392386,2170660915,0,0,2024-10-04 19:19:43,0,0,0,0,0,0
1,201392386,2170660915,44760,36895,2024-10-04 19:19:44,0,0,0,0,0,0
1,201392386,2170660915,57029,36895,2024-10-04 19:19:44,0,0,0,0,0,0
1,201392386,1145490689,57041,47873,2024-10-04 19:19:44,0,0,0,0,0,0
1,201392386,2170660915,0,0,2024-10-04 19:19:44,0,0,0,0,0,0
1,201392386,2170660915,44760,36895,2024-10-04 19:19:45,0,0,0,0,0,0
1,201392386,2170660915,57029,36895,2024-10-04 19:19:45,0,0,0,0,0,0
1,201392386,1145490689,57041,47873,2024-10-04 19:19:45,0,0,0,0,0,0
1,201392386,2170660915,0,0,2024-10-04 19:19:45,0,0,0,0,0,0
1,201392386,2170660915,44760,36895,2024-10-04 19:19:46,0,0,0,0,0,0
1,201392386,2170660915,57029,36895,2024-10-04 19:19:46,0,0,0,0,0,0
1,201392386,1145490689,57041,47873,2024-10-04 19:19:46,0,0,0,0,0,0
1,201392386,2170660915,0,0,2024-10-04 19:19:46,0,0,0,0,0,0
1,201392386,2170660915,44760,36895,2024-10-04 19:19:47,0,0,0,0,0,0
1,201392386,2170660915,57029,36895,2024-10-04 19:19:47,0,0,0,0,0,0
1,201392386,1145490689,57041,47873,2024-10-04 19:19:47,0,0,0,0,0,0
1,201392386,2170660915,0,0,2024-10-04 19:19:47,0,0,0,0,0,0
1,201392386,2170660915,44760,36895,2024-10-04 19:19:48,0,0,0,0,0,0
1,201392386,2170660915,57029,36895,2024-10-04 19:19:48,0,0,0,0,0,0
1,201392386,1145490689,57041,47873,2024-10-04 19:19:48,0,0,0,0,0,0
1,201392386,2170660915,0,0,2024-10-04 19:19:48,0,0,0,0,0,0
1,201392386,2170660915,44760,36895,2024-10-04 19:19:49,0,0,0,0,0,0
1,201392386,2170660915,57029,36895,2024-10-04 19:19:49,0,0,0,0,0,0
1,201392386,1145490689,57041,47873,2024-10-04 19:19:49,0,0,0,0,0,0
1,201392386,2170660915,0,0,2024-10-04 19:19:49,0,0,0,0,0,0
1,201392386,2170660915,44760,36895,2024-10-04 19:19:50,0,0,0,0,0,0
1,201392386,2170660915,57029,36895,2024-10-04 19:19:50,0,0,0,0,0,0
1,201392386,1145490689,57041,47873,2024-10-04 19:19:50,0,0,0,0,0,0
1,201392386,2170660915,0,0,2024-10-04 19:19:50,0,0,0,0,0,0
1,201392386,2170660915,44760,36895,2024-10-04 19:19:51,0,0,0,0,0,0
1,201392386,2170660915,57029,36895,2024-10-04 19:19:51,0,0,0,0,0,0
1,201392386,1145490689,57041,47873,2024-10-04 19:19:51,0,0,0,0,0,0
1,201392386,2170660915,0,0,2024-10-04 19:19:51,0,0,0,0,0,0
1,201392386,2170660915,44760,36895,2024-10-04 19:19:52,0,0,0,0,0,0
1,201392386,2170660915,57029,36895,2024-10-04 19:19:52,0,0,0,0,0,0
1,201392386,1145490689,57041,47873,2024-10-04 19:19:52,612,5449,6061,6,7,13
1,201392386,2170660915,0,0,2024-10-04 19:19:52,0,0,0,0,0,0
1,201392386,2170660915,44760,36895,2024-10-04 19:19:53,0,0,0,0,0,0
1,201392386,2170660915,57029,36895,2024-10-04 19:19:53,0,0,0,0,0,0
1,201392386,1145490689,57041,47873,2024-10-04 19:19:53,0,0,0,0,0,0
1,201392386,2170660915,0,0,2024-10-04 19:19:53,0,0,0,0,0,0
1,201392386,2170660915,44760,36895,2024-10-04 19:19:54,0,0,0,0,0,0
1,201392386,2170660915,57029,36895,2024-10-04 19:19:54,0,0,0,0,0,0
1,201392386,1145490689,57041,47873,2024-10-04 19:19:54,0,0,0,0,0,0
1,201392386,2170660915,0,0,2024-10-04 19:19:54,128,84,212,1,1,2
1,201392386,2170660915,44760,36895,2024-10-04 19:19:55,0,0,0,0,0,0
1,201392386,2170660915,57029,36895,2024-10-04 19:19:55,0,0,0,0,0,0
1,201392386,1145490689,57041,47873,2024-10-04 19:19:55,0,0,0,0,0,0
1,201392386,2170660915,0,0,2024-10-04 19:19:55,128,84,212,1,1,2
1,201392386,2170660915,44760,36895,2024-10-04 19:19:56,0,0,0,0,0,0
1,201392386,2170660915,57029,36895,2024-10-04 19:19:56,0,0,0,0,0,0
1,201392386,1145490689,57041,47873,2024-10-04 19:19:56,0,0,0,0,0,0
1,201392386,2170660915,0,0,2024-10-04 19:19:56,128,84,212,1,1,2
1,201392386,2170660915,44760,36895,2024-10-04 19:19:57,0,0,0,0,0,0
1,201392386,2170660915,57029,36895,2024-10-04 19:19:57,0,0,0,0,0,0
1,201392386,1145490689,57041,47873,2024-10-04 19:19:57,0,0,0,0,0,0
1,201392386,2170660915,0,0,2024-10-04 19:19:57,128,84,212,1,1,2
1,201392386,2170660915,44760,36895,2024-10-04 19:19:58,0,0,0,0,0,0
1,201392386,2170660915,57029,36895,2024-10-04 19:19:58,0,0,0,0,0,0
1,201392386,1145490689,57041,47873,2024-10-04 19:19:58,0,0,0,0,0,0
1,201392386,2170660915,0,0,2024-10-04 19:19:58,128,84,212,1,1,2
1,201392386,2170660915,44760,36895,2024-10-04 19:19:59,0,0,0,0,0,0
1,201392386,2170660915,57029,36895,2024-10-04 19:19:59,0,0,0,0,0,0
1,201392386,1145490689,57041,47873,2024-10-04 19:19:59,0,0,0,0,0,0
1,201392386,2170660915,0,0,2024-10-04 19:19:59,128,84,212,1,1,2
1,201392386,2170660915,44760,36895,2024-10-04 19:20:00,0,0,0,0,0,0
1,201392386,2170660915,57029,36895,2024-10-04 19:20:00,0,0,0,0,0,0
1,201392386,1145490689,57041,47873,2024-10-04 19:20:00,0,0,0,0,0,0
1,201392386,2170660915,0,0,2024-10-04 19:20:00,128,84,212,1,1,2
1,201392386,2170660915,44760,36895,2024-10-04 19:20:01,0,0,0,0,0,0
1,201392386,2170660915,57029,36895,2024-10-04 19:20:01,0,0,0,0,0,0
1,201392386,1145490689,57041,47873,2024-10-04 19:20:01,0,0,0,0,0,0
1,201392386,2170660915,0,0,2024-10-04 19:20:01,128,84,212,1,1,2
1,201392386,2170660915,44760,36895,2024-10-04 19:20:02,0,0,0,0,0,0
1,201392386,2170660915,57029,36895,2024-10-04 19:20:02,0,0,0,0,0,0
1,201392386,1145490689,57041,47873,2024-10-04 19:20:02,0,0,0,0,0,0
1,201392386,2170660915,0,0,2024-10-04 19:20:02,128,84,212,1,1,2
1,201392386,2170660915,44760,36895,2024-10-04 19:20:03,0,0,0,0,0,0
1,201392386,2170660915,57029,36895,2024-10-04 19:20:03,0,0,0,0,0,0
1,201392386,1145490689,57041,47873,2024-10-04 19:20:03,0,0,0,0,0,0
1,201392386,2170660915,0,0,2024-10-04 19:20:03,128,84,212,1,1,2
1,201392386,2170660915,44760,36895,2024-10-04 19:20:04,0,0,0,0,0,0
1,201392386,2170660915,57029,36895,2024-10-04 19:20:04,0,0,0,0,0,0
1,201392386,2170660915,0,0,2024-10-04 19:20:04,0,0,0,0,0,0
1,201392386,2170660915,57029,36895,2024-10-04 19:20:05,0,0,0,0,0,0
1,201392386,2170660915,15082,36895,2024-10-04 19:20:05,666,507,1173,6,6,12
1,201392386,2170660915,0,0,2024-10-04 19:20:05,128,0,128,1,0,1
1,201392386,2170660915,57029,36895,2024-10-04 19:20:06,0,0,0,0,0,0
1,201392386,2170660915,15082,36895,2024-10-04 19:20:06,0,0,0,0,0,0
1,201392386,2170660915,0,0,2024-10-04 19:20:06,128,84,212,1,1,2
1,201392386,2170660915,57029,36895,2024-10-04 19:20:07,0,0,0,0,0,0
1,201392386,2170660915,15082,36895,2024-10-04 19:20:07,0,0,0,0,0,0
1,201392386,2170660915,0,0,2024-10-04 19:20:07,128,84,212,1,1,2
1,201392386,2170660915,57029,36895,2024-10-04 19:20:08,0,0,0,0,0,0
1,201392386,2170660915,15082,36895,2024-10-04 19:20:08,0,0,0,0,0,0
1,201392386,2170660915,0,0,2024-10-04 19:20:08,0,0,0,0,0,0
1,201392386,2170660915,57029,36895,2024-10-04 19:20:09,0,0,0,0,0,0
1,201392386,2170660915,15082,36895,2024-10-04 19:20:09,0,0,0,0,0,0
1,201392386,2170660915,0,0,2024-10-04 19:20:09,0,0,0,0,0,0
1,201392386,2170660915,57029,36895,2024-10-04 19:20:10,0,0,0,0,0,0
1,201392386,2170660915,15082,36895,2024-10-04 19:20:10,0,0,0,0,0,0
1,201392386,2170660915,0,0,2024-10-04 19:20:10,0,84,84,0,1,1
1,201392386,2170660915,57029,36895,2024-10-04 19:20:11,0,0,0,0,0,0
1,201392386,2170660915,15082,36895,2024-10-04 19:20:11,0,0,0,0,0,0
1,201392386,2170660915,0,0,2024-10-04 19:20:11,128,84,212,1,1,2
1,201392386,2170660915,57029,36895,2024-10-04 19:20:12,0,0,0,0,0,0
1,201392386,2170660915,15082,36895,2024-10-04 19:20:12,0,0,0,0,0,0
1,201392386,2170660915,0,0,2024-10-04 19:20:12,128,84,212,1,1,2
1,201392386,2170660915,57029,36895,2024-10-04 19:20:13,0,0,0,0,0,0
1,201392386,1145490689,38555,47873,2024-10-04 19:20:13,2316,17349,19665,15,21,36
1,201392386,2170660915,15082,36895,2024-10-04 19:20:13,0,0,0,0,0,0
1,201392386,2170660915,0,0,2024-10-04 19:20:13,128,84,212,1,1,2
1,201392386,2170660915,57029,36895,2024-10-04 19:20:14,0,0,0,0,0,0
1,201392386,1145490689,38555,47873,2024-10-04 19:20:14,1464,31470,32934,15,20,35
1,201392386,2170660915,15082,36895,2024-10-04 19:20:14,0,0,0,0,0,0
1,201392386,2170660915,0,0,2024-10-04 19:20:14,0,0,0,0,0,0
1,201392386,2170660915,57029,36895,2024-10-04 19:20:15,0,0,0,0,0,0
1,201392386,1145490689,38555,47873,2024-10-04 19:20:15,0,0,0,0,0,0
1,201392386,2170660915,15082,36895,2024-10-04 19:20:15,0,0,0,0,0,0
1,201392386,2170660915,0,0,2024-10-04 19:20:15,0,0,0,0,0,0
1,201392386,2170660915,57029,36895,2024-10-04 19:20:16,0,0,0,0,0,0
1,201392386,1145490689,38555,47873,2024-10-04 19:20:16,0,0,0,0,0,0
1,201392386,2170660915,15082,36895,2024-10-04 19:20:16,0,0,0,0,0,0
1,201392386,2170660915,0,0,2024-10-04 19:20:16,0,0,0,0,0,0
1,201392386,2170660915,57029,36895,2024-10-04 19:20:17,0,0,0,0,0,0
1,201392386,1145490689,38555,47873,2024-10-04 19:20:17,0,0,0,0,0,0
1,201392386,2170660915,15082,36895,2024-10-04 19:20:17,0,0,0,0,0,0
1,201392386,2170660915,0,0,2024-10-04 19:20:17,0,0,0,0,0,0
1,201392386,2170660915,57029,36895,2024-10-04 19:20:18,0,0,0,0,0,0
1,201392386,1145490689,38555,47873,2024-10-04 19:20:18,0,0,0,0,0,0
1,201392386,2170660915,15082,36895,2024-10-04 19:20:18,0,0,0,0,0,0
1,201392386,2170660915,0,0,2024-10-04 19:20:18,0,0,0,0,0,0
1,201392386,2170660915,57029,36895,2024-10-04 19:20:19,0,0,0,0,0,0
1,201392386,1145490689,38555,47873,2024-10-04 19:20:19,0,0,0,0,0,0
1,201392386,2170660915,15082,36895,2024-10-04 19:20:19,0,0,0,0,0,0
1,201392386,2170660915,0,0,2024-10-04 19:20:19,0,0,0,0,0,0
1,201392386,2170660915,57029,36895,2024-10-04 19:20:20,0,0,0,0,0,0
1,201392386,1145490689,38555,47873,2024-10-04 19:20:20,0,0,0,0,0,0
1,201392386,2170660915,15082,36895,2024-10-04 19:20:20,0,0,0,0,0,0
1,201392386,2170660915,0,0,2024-10-04 19:20:20,0,0,0,0,0,0
1,201392386,2170660915,57029,36895,2024-10-04 19:20:21,0,0,0,0,0,0
1,201392386,1145490689,38555,47873,2024-10-04 19:20:21,0,0,0,0,0,0
1,201392386,2170660915,15082,36895,2024-10-04 19:20:21,0,0,0,0,0,0
1,201392386,2170660915,0,0,2024-10-04 19:20:21,0,0,0,0,0,0
1,201392386,2170660915,57029,36895,2024-10-04 19:20:22,0,0,0,0,0,0
1,201392386,1145490689,38555,47873,2024-10-04 19:20:22,0,0,0,0,0,0
1,201392386,2170660915,15082,36895,2024-10-04 19:20:22,0,0,0,0,0,0
1,201392386,2170660915,0,0,2024-10-04 19:20:22,0,0,0,0,0,0
1,201392386,2170660915,57029,36895,2024-10-04 19:20:23,0,0,0,0,0,0
1,201392386,1145490689,38555,47873,2024-10-04 19:20:23,2844,50505,53349,28,37,65
1,201392386,2170660915,15082,36895,2024-10-04 19:20:23,0,0,0,0,0,0
1,201392386,2170660915,0,0,2024-10-04 19:20:23,0,0,0,0,0,0
1,201392386,2170660915,57029,36895,2024-10-04 19:20:24,0,0,0,0,0,0
1,201392386,1145490689,38555,47873,2024-10-04 19:20:24,0,0,0,0,0,0
1,201392386,2170660915,15082,36895,2024-10-04 19:20:24,0,0,0,0,0,0
1,201392386,2170660915,0,0,2024-10-04 19:20:24,0,0,0,0,0,0
1,201392386,2170660915,57029,36895,2024-10-04 19:20:25,0,0,0,0,0,0
1,201392386,1145490689,38555,47873,2024-10-04 19:20:25,0,0,0,0,0,0
1,201392386,2170660915,15082,36895,2024-10-04 19:20:25,0,0,0,0,0,0
1,201392386,2170660915,0,0,2024-10-04 19:20:25,128,84,212,1,1,2
1,201392386,2170660915,57029,36895,2024-10-04 19:20:26,0,0,0,0,0,0
1,201392386,1145490689,38555,47873,2024-10-04 19:20:26,0,0,0,0,0,0
1,201392386,2170660915,15082,36895,2024-10-04 19:20:26,0,0,0,0,0,0
1,201392386,2170660915,0,0,2024-10-04 19:20:26,128,84,212,1,1,2
1,201392386,2170660915,57029,36895,2024-10-04 19:20:27,0,0,0,0,0,0
1,201392386,1145490689,38555,47873,2024-10-04 19:20:27,0,0,0,0,0,0
1,201392386,2170660915,15082,36895,2024-10-04 19:20:27,0,0,0,0,0,0
1,201392386,2170660915,0,0,2024-10-04 19:20:27,128,84,212,1,1,2
1,201392386,2170660915,57029,36895,2024-10-04 19:20:28,0,0,0,0,0,0
1,201392386,1145490689,38555,47873,2024-10-04 19:20:28,0,0,0,0,0,0
1,201392386,2170660915,15082,36895,2024-10-04 19:20:28,0,0,0,0,0,0
1,201392386,2170660915,0,0,2024-10-04 19:20:28,128,84,212,1,1,2
1,201392386,2170660915,57029,36895,2024-10-04 19:20:29,0,0,0,0,0,0
1,201392386,1145490689,38555,47873,2024-10-04 19:20:29,0,0,0,0,0,0
1,201392386,2170660915,15082,36895,2024-10-04 19:20:29,0,0,0,0,0,0
1,201392386,2170660915,0,0,2024-10-04 19:20:29,128,84,212,1,1,2
1,201392386,2170660915,57029,36895,2024-10-04 19:20:30,0,0,0,0,0,0
1,201392386,1145490689,38555,47873,2024-10-04 19:20:30,0,0,0,0,0,0
1,201392386,2170660915,15082,36895,2024-10-04 19:20:30,0,0,0,0,0,0
1,201392386,2170660915,0,0,2024-10-04 19:20:30,128,84,212,1,1,2
1,201392386,2170660915,57029,36895,2024-10-04 19:20:31,0,0,0,0,0,0
1,201392386,1145490689,38555,47873,2024-10-04 19:20:31,0,0,0,0,0,0
1,201392386,2170660915,15082,36895,2024-10-04 19:20:31,0,0,0,0,0,0
1,201392386,2170660915,0,0,2024-10-04 19:20:31,128,84,212,1,1,2
1,201392386,2170660915,57029,36895,2024-10-04 19:20:32,0,0,0,0,0,0
1,201392386,1145490689,38555,47873,2024-10-04 19:20:32,0,0,0,0,0,0
1,201392386,2170660915,15082,36895,2024-10-04 19:20:32,0,0,0,0,0,0
1,201392386,2170660915,0,0,2024-10-04 19:20:32,128,84,212,1,1,2
1,201392386,2170660915,57029,36895,2024-10-04 19:20:33,0,0,0,0,0,0
1,201392386,1145490689,38555,47873,2024-10-04 19:20:33,0,0,0,0,0,0
1,201392386,2170660915,15082,36895,2024-10-04 19:20:33,0,0,0,0,0,0
1,201392386,2170660915,0,0,2024-10-04 19:20:33,128,84,212,1,1,2
1,201392386,2170660915,57029,36895,2024-10-04 19:20:34,0,0,0,0,0,0
1,201392386,2170660915,15082,36895,2024-10-04 19:20:34,0,0,0,0,0,0
1,201392386,2170660915,0,0,2024-10-04 19:20:34,128,84,212,1,1,2
1,201392386,2170660915,57029,36895,2024-10-04 19:20:35,0,0,0,0,0,0
1,201392386,2170660915,15082,36895,2024-10-04 19:20:35,0,0,0,0,0,0
1,201392386,2170660915,0,0,2024-10-04 19:20:35,0,0,0,0,0,0
1,201392386,2170660915,57029,36895,2024-10-04 19:20:36,0,0,0,0,0,0
1,201392386,2170660915,43193,36895,2024-10-04 19:20:36,666,507,1173,6,6,12
1,201392386,2170660915,0,0,2024-10-04 19:20:36,128,0,128,1,0,1
1,201392386,2170660915,57029,36895,2024-10-04 19:20:37,0,0,0,0,0,0
1,201392386,2170660915,43193,36895,2024-10-04 19:20:37,0,0,0,0,0,0
1,201392386,2170660915,0,0,2024-10-04 19:20:37,128,84,212,1,1,2
1,201392386,2170660915,57029,36895,2024-10-04 19:20:38,0,0,0,0,0,0
1,201392386,2170660915,43193,36895,2024-10-04 19:20:38,0,0,0,0,0,0
1,201392386,2170660915,0,0,2024-10-04 19:20:38,128,84,212,1,1,2
1,201392386,2170660915,57029,36895,2024-10-04 19:20:39,0,0,0,0,0,0
1,201392386,2170660915,43193,36895,2024-10-04 19:20:39,0,0,0,0,0,0
1,201392386,2170660915,0,0,2024-10-04 19:20:39,0,0,0,0,0,0
1,201392386,2170660915,57029,36895,2024-10-04 19:20:40,0,0,0,0,0,0
1,201392386,2170660915,43193,36895,2024-10-04 19:20:40,0,0,0,0,0,0
1,201392386,2170660915,0,0,2024-10-04 19:20:40,0,84,84,0,1,1
1,201392386,2170660915,57029,36895,2024-10-04 19:20:41,0,0,0,0,0,0
1,201392386,2170660915,43193,36895,2024-10-04 19:20:41,0,0,0,0,0,0
1,201392386,2170660915,0,0,2024-10-04 19:20:41,0,0,0,0,0,0
1,201392386,2170660915,57029,36895,2024-10-04 19:20:42,0,0,0,0,0,0
1,201392386,2170660915,43193,36895,2024-10-04 19:20:42,0,0,0,0,0,0
1,201392386,2170660915,0,0,2024-10-04 19:20:42,128,84,212,1,1,2
1,201392386,2170660915,57029,36895,2024-10-04 19:20:43,0,0,0,0,0,0
1,201392386,2170660915,43193,36895,2024-10-04 19:20:43,0,0,0,0,0,0
1,201392386,2170660915,0,0,2024-10-04 19:20:43,128,84,212,1,1,2
1,201392386,2170660915,57029,36895,2024-10-04 19:20:44,0,0,0,0,0,0
1,201392386,2170660915,43193,36895,2024-10-04 19:20:44,0,0,0,0,0,0
1,201392386,1145490691,46263,47873,2024-10-04 19:20:44,4512,73573,78085,35,58,93
1,201392386,2170660915,0,0,2024-10-04 19:20:44,128,84,212,1,1,2
1,201392386,2170660915,57029,36895,2024-10-04 19:20:45,0,0,0,0,0,0
1,201392386,2170660915,43193,36895,2024-10-04 19:20:45,0,0,0,0,0,0
1,201392386,1145490691,46263,47873,2024-10-04 19:20:45,0,0,0,0,0,0
1,201392386,2170660915,0,0,2024-10-04 19:20:45,0,0,0,0,0,0
1,201392386,2170660915,57029,36895,2024-10-04 19:20:46,0,0,0,0,0,0
1,201392386,2170660915,43193,36895,2024-10-04 19:20:46,0,0,0,0,0,0
1,201392386,1145490691,46263,47873,2024-10-04 19:20:46,0,0,0,0,0,0
1,201392386,2170660915,0,0,2024-10-04 19:20:46,0,0,0,0,0,0
1,201392386,2170660915,57029,36895,2024-10-04 19:20:47,0,0,0,0,0,0
1,201392386,2170660915,43193,36895,2024-10-04 19:20:47,0,0,0,0,0,0
1,201392386,1145490691,46263,47873,2024-10-04 19:20:47,0,0,0,0,0,0
1,201392386,2170660915,0,0,2024-10-04 19:20:47,0,0,0,0,0,0
1,201392386,2170660915,57029,36895,2024-10-04 19:20:48,0,0,0,0,0,0
1,201392386,2170660915,43193,36895,2024-10-04 19:20:48,0,0,0,0,0,0
1,201392386,1145490691,46263,47873,2024-10-04 19:20:48,0,0,0,0,0,0
1,201392386,2170660915,0,0,2024-10-04 19:20:48,0,0,0,0,0,0
1,201392386,2170660915,57029,36895,2024-10-04 19:20:49,0,0,0,0,0,0
1,201392386,2170660915,43193,36895,2024-10-04 19:20:49,0,0,0,0,0,0
1,201392386,1145490691,46263,47873,2024-10-04 19:20:49,0,0,0,0,0,0
1,201392386,2170660915,0,0,2024-10-04 19:20:49,0,0,0,0,0,0
1,201392386,2170660915,57029,36895,2024-10-04 19:20:50,0,0,0,0,0,0
1,201392386,2170660915,43193,36895,2024-10-04 19:20:50,0,0,0,0,0,0
1,201392386,1145490691,46263,47873,2024-10-04 19:20:50,0,0,0,0,0,0
1,201392386,2170660915,0,0,2024-10-04 19:20:50,0,0,0,0,0,0
1,201392386,2170660915,57029,36895,2024-10-04 19:20:51,0,0,0,0,0,0
1,201392386,2170660915,43193,36895,2024-10-04 19:20:51,0,0,0,0,0,0
1,201392386,1145490691,46263,47873,2024-10-04 19:20:51,0,0,0,0,0,0
1,201392386,2170660915,0,0,2024-10-04 19:20:51,0,0,0,0,0,0
1,201392386,2170660915,57029,36895,2024-10-04 19:20:52,0,0,0,0,0,0
1,201392386,2170660915,43193,36895,2024-10-04 19:20:52,0,0,0,0,0,0
1,201392386,1145490691,46263,47873,2024-10-04 19:20:52,0,0,0,0,0,0
1,201392386,2170660915,0,0,2024-10-04 19:20:52,0,0,0,0,0,0
1,201392386,2170660915,57029,36895,2024-10-04 19:20:53,0,0,0,0,0,0
1,201392386,2170660915,43193,36895,2024-10-04 19:20:53,0,0,0,0,0,0
1,201392386,1145490691,46263,47873,2024-10-04 19:20:53,1220,19545,20765,12,15,27
1,201392386,2170660915,0,0,2024-10-04 19:20:53,0,0,0,0,0,0
1,201392386,2170660915,57029,36895,2024-10-04 19:20:54,0,0,0,0,0,0
1,201392386,2170660915,43193,36895,2024-10-04 19:20:54,0,0,0,0,0,0
1,201392386,1145490691,46263,47873,2024-10-04 19:20:54,0,0,0,0,0,0
1,201392386,2170660915,0,0,2024-10-04 19:20:54,128,0,128,1,0,1
1,201392386,2170660915,57029,36895,2024-10-04 19:20:55,0,0,0,0,0,0
1,201392386,2170660915,43193,36895,2024-10-04 19:20:55,0,0,0,0,0,0
1,201392386,1145490691,46263,47873,2024-10-04 19:20:55,0,0,0,0,0,0
1,201392386,2170660915,0,0,2024-10-04 19:20:55,128,84,212,1,1,2
1,201392386,2170660915,57029,36895,2024-10-04 19:20:56,0,0,0,0,0,0
1,201392386,2170660915,43193,36895,2024-10-04 19:20:56,0,0,0,0,0,0
1,201392386,1145490691,46263,47873,2024-10-04 19:20:56,0,0,0,0,0,0
1,201392386,2170660915,0,0,2024-10-04 19:20:56,128,84,212,1,1,2
1,201392386,2170660915,57029,36895,2024-10-04 19:20:57,0,0,0,0,0,0
1,201392386,2170660915,43193,36895,2024-10-04 19:20:57,0,0,0,0,0,0
1,201392386,1145490691,46263,47873,2024-10-04 19:20:57,0,0,0,0,0,0
1,201392386,2170660915,0,0,2024-10-04 19:20:57,128,84,212,1,1,2
1,201392386,2170660915,57029,36895,2024-10-04 19:20:58,0,0,0,0,0,0
1,201392386,2170660915,43193,36895,2024-10-04 19:20:58,0,0,0,0,0,0
1,201392386,1145490691,46263,47873,2024-10-04 19:20:58,0,0,0,0,0,0
1,201392386,2170660915,0,0,2024-10-04 19:20:58,128,84,212,1,1,2
1,201392386,2170660915,57029,36895,2024-10-04 19:20:59,0,0,0,0,0,0
1,201392386,2170660915,43193,36895,2024-10-04 19:20:59,0,0,0,0,0,0
1,201392386,1145490691,46263,47873,2024-10-04 19:20:59,0,0,0,0,0,0
1,201392386,2170660915,0,0,2024-10-04 19:20:59,128,84,212,1,1,2
1,201392386,2170660915,57029,36895,2024-10-04 19:21:00,0,0,0,0,0,0
1,201392386,2170660915,43193,36895,2024-10-04 19:21:00,0,0,0,0,0,0
1,201392386,1145490691,46263,47873,2024-10-04 19:21:00,0,0,0,0,0,0
1,201392386,2170660915,0,0,2024-10-04 19:21:00,128,84,212,1,1,2
1,201392386,2170660915,57029,36895,2024-10-04 19:21:01,0,0,0,0,0,0
1,201392386,2170660915,43193,36895,2024-10-04 19:21:01,0,0,0,0,0,0
1,201392386,1145490691,46263,47873,2024-10-04 19:21:01,0,0,0,0,0,0
1,201392386,2170660915,0,0,2024-10-04 19:21:01,128,84,212,1,1,2
1,201392386,2170660915,57029,36895,2024-10-04 19:21:02,0,0,0,0,0,0
1,201392386,2170660915,43193,36895,2024-10-04 19:21:02,0,0,0,0,0,0
1,201392386,1145490691,46263,47873,2024-10-04 19:21:02,0,0,0,0,0,0
1,201392386,2170660915,0,0,2024-10-04 19:21:02,128,84,212,1,1,2
1,201392386,2170660915,57029,36895,2024-10-04 19:21:03,0,0,0,0,0,0
1,201392386,2170660915,43193,36895,2024-10-04 19:21:03,0,0,0,0,0,0
1,201392386,1145490691,46263,47873,2024-10-04 19:21:03,0,0,0,0,0,0
1,201392386,2170660915,0,0,2024-10-04 19:21:03,0,84,84,0,1,1
1,201392386,2170660915,57029,36895,2024-10-04 19:21:04,0,0,0,0,0,0
1,201392386,2170660915,43193,36895,2024-10-04 19:21:04,0,0,0,0,0,0
1,201392386,2170660915,0,0,2024-10-04 19:21:04,128,84,212,1,1,2
1,201392386,2170660915,57029,36895,2024-10-04 19:21:05,0,0,0,0,0,0
1,201392386,2170660915,43193,36895,2024-10-04 19:21:05,0,0,0,0,0,0
1,201392386,2170660915,0,0,2024-10-04 19:21:05,0,0,0,0,0,0
1,201392386,2170660915,57029,36895,2024-10-04 19:21:06,0,0,0,0,0,0
1,201392386,2170660915,43658,36895,2024-10-04 19:21:06,570,455,1025,5,5,10
1,201392386,2170660915,0,0,2024-10-04 19:21:06,0,0,0,0,0,0
1,201392386,2170660915,57029,36895,2024-10-04 19:21:07,0,0,0,0,0,0
1,201392386,2170660915,43658,36895,2024-10-04 19:21:07,0,0,0,0,0,0
1,201392386,2170660915,0,0,2024-10-04 19:21:07,256,84,340,2,1,3
1,201392386,2170660915,57029,36895,2024-10-04 19:21:08,0,0,0,0,0,0
1,201392386,2170660915,43658,36895,2024-10-04 19:21:08,0,0,0,0,0,0
1,201392386,2170660915,0,0,2024-10-04 19:21:08,128,84,212,1,1,2
1,201392386,2170660915,57029,36895,2024-10-04 19:21:09,0,0,0,0,0,0
1,201392386,2170660915,43658,36895,2024-10-04 19:21:09,0,0,0,0,0,0
1,201392386,2170660915,0,0,2024-10-04 19:21:09,0,0,0,0,0,0
1,201392386,2170660915,57029,36895,2024-10-04 19:21:10,0,0,0,0,0,0
1,201392386,2170660915,43658,36895,2024-10-04 19:21:10,0,0,0,0,0,0
1,201392386,2170660915,0,0,2024-10-04 19:21:10,0,84,84,0,1,1
1,201392386,2170660915,57029,36895,2024-10-04 19:21:11,0,0,0,0,0,0
1,201392386,2170660915,43658,36895,2024-10-04 19:21:11,0,0,0,0,0,0
1,201392386,2170660915,0,0,2024-10-04 19:21:11,128,0,128,1,0,1
1,201392386,2170660915,57029,36895,2024-10-04 19:21:12,0,0,0,0,0,0
1,201392386,2170660915,43658,36895,2024-10-04 19:21:12,0,0,0,0,0,0
1,201392386,2170660915,0,0,2024-10-04 19:21:12,128,84,212,1,1,2
1,201392386,2170660915,57029,36895,2024-10-04 19:21:13,0,0,0,0,0,0
1,201392386,2170660915,43658,36895,2024-10-04 19:21:13,0,0,0,0,0,0
1,201392386,2170660915,0,0,2024-10-04 19:21:13,0,84,84,0,1,1
1,201392386,2170660915,57029,36895,2024-10-04 19:21:14,0,0,0,0,0,0
1,201392386,1145490690,9401,47873,2024-10-04 19:21:14,5436,76531,81967,46,60,106
1,201392386,2170660915,0,0,2024-10-04 19:21:14,128,84,212,1,1,2
1,201392386,2170660915,57029,36895,2024-10-04 19:21:15,0,0,0,0,0,0
1,201392386,1145490690,9401,47873,2024-10-04 19:21:15,0,0,0,0,0,0
1,201392386,2170660915,0,0,2024-10-04 19:21:15,0,0,0,0,0,0
1,201392386,2170660915,57029,36895,2024-10-04 19:21:16,0,0,0,0,0,0
1,201392386,1145490690,9401,47873,2024-10-04 19:21:16,0,0,0,0,0,0
1,201392386,2170660915,0,0,2024-10-04 19:21:16,0,0,0,0,0,0
1,201392386,2170660915,57029,36895,2024-10-04 19:21:17,0,0,0,0,0,0
1,201392386,1145490690,9401,47873,2024-10-04 19:21:17,0,0,0,0,0,0
1,201392386,2170660915,0,0,2024-10-04 19:21:17,0,0,0,0,0,0
1,201392386,2170660915,57029,36895,2024-10-04 19:21:18,0,0,0,0,0,0
1,201392386,1145490690,9401,47873,2024-10-04 19:21:18,0,0,0,0,0,0
1,201392386,2170660915,0,0,2024-10-04 19:21:18,0,0,0,0,0,0
1,201392386,2170660915,57029,36895,2024-10-04 19:21:19,0,0,0,0,0,0
1,201392386,1145490690,9401,47873,2024-10-04 19:21:19,0,0,0,0,0,0
1,201392386,2170660915,0,0,2024-10-04 19:21:19,0,0,0,0,0,0
1,201392386,2170660915,57029,36895,2024-10-04 19:21:20,0,0,0,0,0,0
1,201392386,1145490690,9401,47873,2024-10-04 19:21:20,0,0,0,0,0,0
1,201392386,2170660915,0,0,2024-10-04 19:21:20,0,0,0,0,0,0
1,201392386,2170660915,57029,36895,2024-10-04 19:21:21,0,0,0,0,0,0
1,201392386,1145490690,9401,47873,2024-10-04 19:21:21,0,0,0,0,0,0
1,201392386,2170660915,0,0,2024-10-04 19:21:21,0,0,0,0,0,0
1,201392386,2170660915,57029,36895,2024-10-04 19:21:22,0,0,0,0,0,0
1,201392386,1145490690,9401,47873,2024-10-04 19:21:22,0,0,0,0,0,0
1,201392386,2170660915,0,0,2024-10-04 19:21:22,0,0,0,0,0,0
1,201392386,2170660915,57029,36895,2024-10-04 19:21:23,0,0,0,0,0,0
1,201392386,1145490690,9401,47873,2024-10-04 19:21:23,0,0,0,0,0,0
1,201392386,2170660915,0,0,2024-10-04 19:21:23,0,0,0,0,0,0
1,201392386,2170660915,57029,36895,2024-10-04 19:21:24,0,0,0,0,0,0
1,201392386,1145490690,9401,47873,2024-10-04 19:21:24,1008,14531,15539,10,12,22
1,201392386,2170660915,0,0,2024-10-04 19:21:24,128,0,128,1,0,1
1,201392386,2170660915,57029,36895,2024-10-04 19:21:25,0,0,0,0,0,0
1,201392386,1145490690,9401,47873,2024-10-04 19:21:25,0,0,0,0,0,0
1,201392386,2170660915,0,0,2024-10-04 19:21:25,128,84,212,1,1,2
1,201392386,2170660915,57029,36895,2024-10-04 19:21:26,0,0,0,0,0,0
1,201392386,1145490690,9401,47873,2024-10-04 19:21:26,0,0,0,0,0,0
1,201392386,2170660915,0,0,2024-10-04 19:21:26,128,84,212,1,1,2
1,201392386,2170660915,57029,36895,2024-10-04 19:21:27,0,0,0,0,0,0
1,201392386,1145490690,9401,47873,2024-10-04 19:21:27,0,0,0,0,0,0
1,201392386,2170660915,0,0,2024-10-04 19:21:27,128,84,212,1,1,2
1,201392386,2170660915,57029,36895,2024-10-04 19:21:28,0,0,0,0,0,0
1,201392386,1145490690,9401,47873,2024-10-04 19:21:28,0,0,0,0,0,0
1,201392386,2170660915,0,0,2024-10-04 19:21:28,128,84,212,1,1,2
1,201392386,2170660915,57029,36895,2024-10-04 19:21:29,0,0,0,0,0,0
1,201392386,1145490690,9401,47873,2024-10-04 19:21:29,0,0,0,0,0,0
1,201392386,2170660915,0,0,2024-10-04 19:21:29,128,84,212,1,1,2
1,201392386,2170660915,57029,36895,2024-10-04 19:21:30,0,0,0,0,0,0
1,201392386,1145490690,9401,47873,2024-10-04 19:21:30,0,0,0,0,0,0
1,201392386,2170660915,0,0,2024-10-04 19:21:30,128,84,212,1,1,2
1,201392386,2170660915,57029,36895,2024-10-04 19:21:31,0,0,0,0,0,0
1,201392386,1145490690,9401,47873,2024-10-04 19:21:31,0,0,0,0,0,0
1,201392386,2170660915,0,0,2024-10-04 19:21:31,128,84,212,1,1,2
1,201392386,2170660915,57029,36895,2024-10-04 19:21:32,0,0,0,0,0,0
1,201392386,1145490690,9401,47873,2024-10-04 19:21:32,0,0,0,0,0,0
1,201392386,2170660915,0,0,2024-10-04 19:21:32,0,84,84,0,1,1
1,201392386,2170660915,57029,36895,2024-10-04 19:21:33,0,0,0,0,0,0
1,201392386,1145490690,9401,47873,2024-10-04 19:21:33,0,0,0,0,0,0
1,201392386,2170660915,0,0,2024-10-04 19:21:33,128,84,212,1,1,2
1,201392386,2170660915,57029,36895,2024-10-04 19:21:34,0,0,0,0,0,0
1,201392386,1145490690,9401,47873,2024-10-04 19:21:34,0,0,0,0,0,0
1,201392386,2170660915,0,0,2024-10-04 19:21:34,128,84,212,1,1,2
1,201392386,2170660915,57029,36895,2024-10-04 19:21:35,0,0,0,0,0,0
1,201392386,2170660915,0,0,2024-10-04 19:21:35,0,0,0,0,0,0
1,201392386,2170660915,37534,36895,2024-10-04 19:21:35,666,507,1173,6,6,12
1,201392386,2170660915,57029,36895,2024-10-04 19:21:36,0,0,0,0,0,0
1,201392386,2170660915,0,0,2024-10-04 19:21:36,128,84,212,1,1,2
1,201392386,2170660915,37534,36895,2024-10-04 19:21:36,0,0,0,0,0,0
1,201392386,2170660915,57029,36895,2024-10-04 19:21:37,0,0,0,0,0,0
1,201392386,2170660915,0,0,2024-10-04 19:21:37,128,84,212,1,1,2
1,201392386,2170660915,37534,36895,2024-10-04 19:21:37,0,0,0,0,0,0
1,201392386,2170660915,57029,36895,2024-10-04 19:21:38,0,0,0,0,0,0
1,201392386,2170660915,0,0,2024-10-04 19:21:38,128,84,212,1,1,2
1,201392386,2170660915,37534,36895,2024-10-04 19:21:38,0,0,0,0,0,0
1,201392386,2170660915,57029,36895,2024-10-04 19:21:39,0,0,0,0,0,0
1,201392386,2170660915,0,0,2024-10-04 19:21:39,0,0,0,0,0,0
1,201392386,2170660915,37534,36895,2024-10-04 19:21:39,0,0,0,0,0,0
1,201392386,2170660915,57029,36895,2024-10-04 19:21:40,0,0,0,0,0,0
1,201392386,2170660915,0,0,2024-10-04 19:21:40,0,0,0,0,0,0
1,201392386,2170660915,37534,36895,2024-10-04 19:21:40,0,0,0,0,0,0
1,201392386,2170660915,57029,36895,2024-10-04 19:21:41,0,0,0,0,0,0
1,201392386,2170660915,0,0,2024-10-04 19:21:41,128,0,128,1,0,1
1,201392386,2170660915,37534,36895,2024-10-04 19:21:41,0,0,0,0,0,0
1,201392386,2170660915,57029,36895,2024-10-04 19:21:42,0,0,0,0,0,0
1,201392386,2170660915,0,0,2024-10-04 19:21:42,128,84,212,1,1,2
1,201392386,2170660915,37534,36895,2024-10-04 19:21:42,0,0,0,0,0,0
1,201392386,2170660915,57029,36895,2024-10-04 19:21:43,0,0,0,0,0,0
1,201392386,2170660915,0,0,2024-10-04 19:21:43,128,84,212,1,1,2
1,201392386,2170660915,37534,36895,2024-10-04 19:21:43,0,0,0,0,0,0
1,201392386,2170660915,57029,36895,2024-10-04 19:21:44,0,0,0,0,0,0
1,201392386,1145490692,42167,47873,2024-10-04 19:21:44,4320,66067,70387,34,51,85
1,201392386,2170660915,0,0,2024-10-04 19:21:44,0,84,84,0,1,1
1,201392386,2170660915,37534,36895,2024-10-04 19:21:44,0,0,0,0,0,0
1,201392386,2170660915,57029,36895,2024-10-04 19:21:45,0,0,0,0,0,0
1,201392386,1145490692,42167,47873,2024-10-04 19:21:45,0,0,0,0,0,0
1,201392386,2170660915,0,0,2024-10-04 19:21:45,0,0,0,0,0,0
1,201392386,2170660915,37534,36895,2024-10-04 19:21:45,0,0,0,0,0,0
1,201392386,2170660915,57029,36895,2024-10-04 19:21:46,0,0,0,0,0,0
1,201392386,1145490692,42167,47873,2024-10-04 19:21:46,0,0,0,0,0,0
1,201392386,2170660915,0,0,2024-10-04 19:21:46,0,0,0,0,0,0
1,201392386,2170660915,37534,36895,2024-10-04 19:21:46,0,0,0,0,0,0
1,201392386,2170660915,57029,36895,2024-10-04 19:21:47,0,0,0,0,0,0
1,201392386,1145490692,42167,47873,2024-10-04 19:21:47,0,0,0,0,0,0
1,201392386,2170660915,0,0,2024-10-04 19:21:47,0,0,0,0,0,0
1,201392386,2170660915,37534,36895,2024-10-04 19:21:47,0,0,0,0,0,0
1,201392386,2170660915,57029,36895,2024-10-04 19:21:48,0,0,0,0,0,0
1,201392386,1145490692,42167,47873,2024-10-04 19:21:48,0,0,0,0,0,0
1,201392386,2170660915,0,0,2024-10-04 19:21:48,0,0,0,0,0,0
1,201392386,2170660915,37534,36895,2024-10-04 19:21:48,0,0,0,0,0,0
1,201392386,2170660915,57029,36895,2024-10-04 19:21:49,0,0,0,0,0,0
1,201392386,1145490692,42167,47873,2024-10-04 19:21:49,0,0,0,0,0,0
1,201392386,2170660915,0,0,2024-10-04 19:21:49,0,0,0,0,0,0
1,201392386,2170660915,37534,36895,2024-10-04 19:21:49,0,0,0,0,0,0
1,201392386,2170660915,57029,36895,2024-10-04 19:21:50,0,0,0,0,0,0
1,201392386,1145490692,42167,47873,2024-10-04 19:21:50,0,0,0,0,0,0
1,201392386,2170660915,0,0,2024-10-04 19:21:50,0,0,0,0,0,0
1,201392386,2170660915,37534,36895,2024-10-04 19:21:50,0,0,0,0,0,0
1,201392386,2170660915,57029,36895,2024-10-04 19:21:51,0,0,0,0,0,0
1,201392386,1145490692,42167,47873,2024-10-04 19:21:51,0,0,0,0,0,0
1,201392386,2170660915,0,0,2024-10-04 19:21:51,0,0,0,0,0,0
1,201392386,2170660915,37534,36895,2024-10-04 19:21:51,0,0,0,0,0,0
1,201392386,2170660915,57029,36895,2024-10-04 19:21:52,0,0,0,0,0,0
1,201392386,1145490692,42167,47873,2024-10-04 19:21:52,0,0,0,0,0,0
1,201392386,2170660915,0,0,2024-10-04 19:21:52,0,0,0,0,0,0
1,201392386,2170660915,37534,36895,2024-10-04 19:21:52,0,0,0,0,0,0
1,201392386,2170660915,57029,36895,2024-10-04 19:21:53,0,0,0,0,0,0
1,201392386,1145490692,42167,47873,2024-10-04 19:21:53,0,0,0,0,0,0
1,201392386,2170660915,0,0,2024-10-04 19:21:53,0,0,0,0,0,0
1,201392386,2170660915,37534,36895,2024-10-04 19:21:53,0,0,0,0,0,0
1,201392386,2170660915,57029,36895,2024-10-04 19:21:54,0,0,0,0,0,0
1,201392386,1145490692,42167,47873,2024-10-04 19:21:54,0,0,0,0,0,0
1,201392386,2170660915,0,0,2024-10-04 19:21:54,0,0,0,0,0,0
1,201392386,2170660915,37534,36895,2024-10-04 19:21:54,0,0,0,0,0,0
1,201392386,2170660915,57029,36895,2024-10-04 19:21:55,0,0,0,0,0,0
1,201392386,1145490692,42167,47873,2024-10-04 19:21:55,2664,41319,43983,27,30,57
1,201392386,2170660915,0,0,2024-10-04 19:21:55,0,0,0,0,0,0
1,201392386,2170660915,37534,36895,2024-10-04 19:21:55,0,0,0,0,0,0
1,201392386,2170660915,57029,36895,2024-10-04 19:21:56,0,0,0,0,0,0
1,201392386,1145490692,42167,47873,2024-10-04 19:21:56,0,0,0,0,0,0
1,201392386,2170660915,0,0,2024-10-04 19:21:56,128,84,212,1,1,2
1,201392386,2170660915,37534,36895,2024-10-04 19:21:56,0,0,0,0,0,0
1,201392386,2170660915,57029,36895,2024-10-04 19:21:57,0,0,0,0,0,0
1,201392386,1145490692,42167,47873,2024-10-04 19:21:57,0,0,0,0,0,0
1,201392386,2170660915,0,0,2024-10-04 19:21:57,128,84,212,1,1,2
1,201392386,2170660915,37534,36895,2024-10-04 19:21:57,0,0,0,0,0,0
1,201392386,2170660915,57029,36895,2024-10-04 19:21:58,0,0,0,0,0,0
1,201392386,1145490692,42167,47873,2024-10-04 19:21:58,0,0,0,0,0,0
1,201392386,2170660915,0,0,2024-10-04 19:21:58,128,84,212,1,1,2
1,201392386,2170660915,37534,36895,2024-10-04 19:21:58,0,0,0,0,0,0
1,201392386,2170660915,57029,36895,2024-10-04 19:21:59,0,0,0,0,0,0
1,201392386,1145490692,42167,47873,2024-10-04 19:21:59,0,0,0,0,0,0
1,201392386,2170660915,0,0,2024-10-04 19:21:59,128,84,212,1,1,2
1,201392386,2170660915,37534,36895,2024-10-04 19:21:59,0,0,0,0,0,0
1,201392386,2170660915,57029,36895,2024-10-04 19:22:00,0,0,0,0,0,0
1,201392386,1145490692,42167,47873,2024-10-04 19:22:00,0,0,0,0,0,0
1,201392386,2170660915,0,0,2024-10-04 19:22:00,256,168,424,2,2,4
1,201392386,2170660915,37534,36895,2024-10-04 19:22:00,0,0,0,0,0,0
1,201392386,2170660915,57029,36895,2024-10-04 19:22:01,0,0,0,0,0,0
1,201392386,1145490692,42167,47873,2024-10-04 19:22:01,0,0,0,0,0,0
1,201392386,2170660915,0,0,2024-10-04 19:22:01,128,84,212,1,1,2
1,201392386,2170660915,37534,36895,2024-10-04 19:22:01,0,0,0,0,0,0
1,201392386,2170660915,57029,36895,2024-10-04 19:22:02,0,0,0,0,0,0
1,201392386,1145490692,42167,47873,2024-10-04 19:22:02,0,0,0,0,0,0
1,201392386,2170660915,0,0,2024-10-04 19:22:02,128,84,212,1,1,2
1,201392386,2170660915,37534,36895,2024-10-04 19:22:02,0,0,0,0,0,0
1,201392386,2170660915,57029,36895,2024-10-04 19:22:03,0,0,0,0,0,0
1,201392386,1145490692,42167,47873,2024-10-04 19:22:03,0,0,0,0,0,0
1,201392386,2170660915,0,0,2024-10-04 19:22:03,128,84,212,1,1,2
1,201392386,2170660915,37534,36895,2024-10-04 19:22:03,0,0,0,0,0,0
1,201392386,2170660915,57029,36895,2024-10-04 19:22:04,0,0,0,0,0,0
1,201392386,1145490692,42167,47873,2024-10-04 19:22:04,0,0,0,0,0,0
1,201392386,2170660915,0,0,2024-10-04 19:22:04,128,84,212,1,1,2
1,201392386,2170660915,37534,36895,2024-10-04 19:22:04,0,0,0,0,0,0
1,201392386,2170660915,57029,36895,2024-10-04 19:22:05,0,0,0,0,0,0
1,201392386,1145490692,42167,47873,2024-10-04 19:22:05,0,0,0,0,0,0
1,201392386,2170660915,0,0,2024-10-04 19:22:05,0,0,0,0,0,0
1,201392386,2170660915,37534,36895,2024-10-04 19:22:05,0,0,0,0,0,0
1,201392386,2170660915,57029,36895,2024-10-04 19:22:06,0,0,0,0,0,0
1,201392386,2170660915,41653,36895,2024-10-04 19:22:06,666,507,1173,6,6,12
1,201392386,2170660915,0,0,2024-10-04 19:22:06,0,0,0,0,0,0
1,201392386,2170660915,37534,36895,2024-10-04 19:22:06,0,0,0,0,0,0
1,201392386,2170660915,57029,36895,2024-10-04 19:22:07,0,0,0,0,0,0
1,201392386,2170660915,41653,36895,2024-10-04 19:22:07,0,0,0,0,0,0
1,201392386,2170660915,0,0,2024-10-04 19:22:07,128,84,212,1,1,2
1,201392386,2170660915,37534,36895,2024-10-04 19:22:07,0,0,0,0,0,0
1,201392386,2170660915,57029,36895,2024-10-04 19:22:08,0,0,0,0,0,0
1,201392386,2170660915,41653,36895,2024-10-04 19:22:08,0,0,0,0,0,0
1,201392386,2170660915,0,0,2024-10-04 19:22:08,128,84,212,1,1,2
1,201392386,2170660915,37534,36895,2024-10-04 19:22:08,0,0,0,0,0,0
1,201392386,2170660915,57029,36895,2024-10-04 19:22:09,0,0,0,0,0,0
1,201392386,2170660915,41653,36895,2024-10-04 19:22:09,0,0,0,0,0,0
1,201392386,2170660915,0,0,2024-10-04 19:22:09,0,0,0,0,0,0
1,201392386,2170660915,37534,36895,2024-10-04 19:22:09,0,0,0,0,0,0
1,201392386,2170660915,57029,36895,2024-10-04 19:22:10,0,0,0,0,0,0
1,201392386,2170660915,41653,36895,2024-10-04 19:22:10,0,0,0,0,0,0
1,201392386,2170660915,0,0,2024-10-04 19:22:10,0,0,0,0,0,0
1,201392386,2170660915,37534,36895,2024-10-04 19:22:10,0,0,0,0,0,0
1,201392386,2170660915,57029,36895,2024-10-04 19:22:11,0,0,0,0,0,0
1,201392386,2170660915,41653,36895,2024-10-04 19:22:11,0,0,0,0,0,0
1,201392386,2170660915,0,0,2024-10-04 19:22:11,0,0,0,0,0,0
1,201392386,2170660915,37534,36895,2024-10-04 19:22:11,0,0,0,0,0,0
1,201392386,2170660915,57029,36895,2024-10-04 19:22:12,0,0,0,0,0,0
1,201392386,2170660915,41653,36895,2024-10-04 19:22:12,0,0,0,0,0,0
1,201392386,2170660915,0,0,2024-10-04 19:22:12,256,168,424,2,2,4
1,201392386,2170660915,37534,36895,2024-10-04 19:22:12,0,0,0,0,0,0
1,201392386,2170660915,57029,36895,2024-10-04 19:22:13,0,0,0,0,0,0
1,201392386,2170660915,41653,36895,2024-10-04 19:22:13,0,0,0,0,0,0
1,201392386,2170660915,0,0,2024-10-04 19:22:13,128,84,212,1,1,2
1,201392386,2170660915,37534,36895,2024-10-04 19:22:13,0,0,0,0,0,0
1,201392386,2170660915,57029,36895,2024-10-04 19:22:14,0,0,0,0,0,0
1,201392386,2170660915,41653,36895,2024-10-04 19:22:14,0,0,0,0,0,0
1,201392386,1145490689,3745,47873,2024-10-04 19:22:14,813,112,925,3,2,5
1,201392386,2170660915,0,0,2024-10-04 19:22:14,128,84,212,1,1,2
1,201392386,2170660915,37534,36895,2024-10-04 19:22:14,0,0,0,0,0,0
1,201392386,2170660915,57029,36895,2024-10-04 19:22:15,0,0,0,0,0,0
1,201392386,2170660915,41653,36895,2024-10-04 19:22:15,0,0,0,0,0,0
1,201392386,1145490689,3745,47873,2024-10-04 19:22:15,3879,71352,75231,36,53,89
1,201392386,2170660915,0,0,2024-10-04 19:22:15,0,0,0,0,0,0
1,201392386,2170660915,37534,36895,2024-10-04 19:22:15,0,0,0,0,0,0
1,201392386,2170660915,57029,36895,2024-10-04 19:22:16,0,0,0,0,0,0
1,201392386,2170660915,41653,36895,2024-10-04 19:22:16,0,0,0,0,0,0
1,201392386,1145490689,3745,47873,2024-10-04 19:22:16,0,0,0,0,0,0
1,201392386,2170660915,0,0,2024-10-04 19:22:16,0,0,0,0,0,0
1,201392386,2170660915,37534,36895,2024-10-04 19:22:16,0,0,0,0,0,0
1,201392386,2170660915,57029,36895,2024-10-04 19:22:17,0,0,0,0,0,0
1,201392386,2170660915,41653,36895,2024-10-04 19:22:17,0,0,0,0,0,0
1,201392386,1145490689,3745,47873,2024-10-04 19:22:17,0,0,0,0,0,0
1,201392386,2170660915,0,0,2024-10-04 19:22:17,0,0,0,0,0,0
1,201392386,2170660915,37534,36895,2024-10-04 19:22:17,0,0,0,0,0,0
1,201392386,2170660915,57029,36895,2024-10-04 19:22:18,0,0,0,0,0,0
1,201392386,2170660915,41653,36895,2024-10-04 19:22:18,0,0,0,0,0,0
1,201392386,1145490689,3745,47873,2024-10-04 19:22:18,0,0,0,0,0,0
1,201392386,2170660915,0,0,2024-10-04 19:22:18,0,0,0,0,0,0
1,201392386,2170660915,37534,36895,2024-10-04 19:22:18,0,0,0,0,0,0
1,201392386,2170660915,57029,36895,2024-10-04 19:22:19,0,0,0,0,0,0
1,201392386,2170660915,41653,36895,2024-10-04 19:22:19,0,0,0,0,0,0
1,201392386,1145490689,3745,47873,2024-10-04 19:22:19,0,0,0,0,0,0
1,201392386,2170660915,0,0,2024-10-04 19:22:19,0,0,0,0,0,0
1,201392386,2170660915,37534,36895,2024-10-04 19:22:19,0,0,0,0,0,0
1,201392386,2170660915,57029,36895,2024-10-04 19:22:20,0,0,0,0,0,0
1,201392386,2170660915,41653,36895,2024-10-04 19:22:20,0,0,0,0,0,0
1,201392386,1145490689,3745,47873,2024-10-04 19:22:20,0,0,0,0,0,0
1,201392386,2170660915,0,0,2024-10-04 19:22:20,0,0,0,0,0,0
1,201392386,2170660915,37534,36895,2024-10-04 19:22:20,0,0,0,0,0,0
1,201392386,2170660915,57029,36895,2024-10-04 19:22:21,0,0,0,0,0,0
1,201392386,2170660915,41653,36895,2024-10-04 19:22:21,0,0,0,0,0,0
1,201392386,1145490689,3745,47873,2024-10-04 19:22:21,0,0,0,0,0,0
1,201392386,2170660915,0,0,2024-10-04 19:22:21,0,0,0,0,0,0
1,201392386,2170660915,37534,36895,2024-10-04 19:22:21,0,0,0,0,0,0
1,201392386,2170660915,57029,36895,2024-10-04 19:22:22,0,0,0,0,0,0
1,201392386,2170660915,41653,36895,2024-10-04 19:22:22,0,0,0,0,0,0
1,201392386,1145490689,3745,47873,2024-10-04 19:22:22,0,0,0,0,0,0
1,201392386,2170660915,0,0,2024-10-04 19:22:22,0,0,0,0,0,0
1,201392386,2170660915,37534,36895,2024-10-04 19:22:22,0,0,0,0,0,0
1,201392386,2170660915,57029,36895,2024-10-04 19:22:23,0,0,0,0,0,0
1,201392386,2170660915,41653,36895,2024-10-04 19:22:23,0,0,0,0,0,0
1,201392386,1145490689,3745,47873,2024-10-04 19:22:23,0,0,0,0,0,0
1,201392386,2170660915,0,0,2024-10-04 19:22:23,0,0,0,0,0,0
1,201392386,2170660915,37534,36895,2024-10-04 19:22:23,0,0,0,0,0,0
1,201392386,2170660915,57029,36895,2024-10-04 19:22:24,0,0,0,0,0,0
1,201392386,2170660915,41653,36895,2024-10-04 19:22:24,0,0,0,0,0,0
1,201392386,1145490689,3745,47873,2024-10-04 19:22:24,0,0,0,0,0,0
1,201392386,2170660915,0,0,2024-10-04 19:22:24,0,0,0,0,0,0
1,201392386,2170660915,37534,36895,2024-10-04 19:22:24,0,0,0,0,0,0
1,201392386,2170660915,57029,36895,2024-10-04 19:22:25,0,0,0,0,0,0
1,201392386,2170660915,41653,36895,2024-10-04 19:22:25,0,0,0,0,0,0
1,201392386,1145490689,3745,47873,2024-10-04 19:22:25,2112,31854,33966,21,24,45
1,201392386,2170660915,0,0,2024-10-04 19:22:25,0,0,0,0,0,0
1,201392386,2170660915,37534,36895,2024-10-04 19:22:25,0,0,0,0,0,0
1,201392386,2170660915,57029,36895,2024-10-04 19:22:26,0,0,0,0,0,0
1,201392386,2170660915,41653,36895,2024-10-04 19:22:26,0,0,0,0,0,0
1,201392386,1145490689,3745,47873,2024-10-04 19:22:26,0,0,0,0,0,0
1,201392386,2170660915,0,0,2024-10-04 19:22:26,128,0,128,1,0,1
1,201392386,2170660915,37534,36895,2024-10-04 19:22:26,0,0,0,0,0,0
1,201392386,2170660915,57029,36895,2024-10-04 19:22:27,0,0,0,0,0,0
1,201392386,2170660915,41653,36895,2024-10-04 19:22:27,0,0,0,0,0,0
1,201392386,1145490689,3745,47873,2024-10-04 19:22:27,0,0,0,0,0,0
1,201392386,2170660915,0,0,2024-10-04 19:22:27,128,84,212,1,1,2
1,201392386,2170660915,37534,36895,2024-10-04 19:22:27,0,0,0,0,0,0
1,201392386,2170660915,57029,36895,2024-10-04 19:22:28,0,0,0,0,0,0
1,201392386,2170660915,41653,36895,2024-10-04 19:22:28,0,0,0,0,0,0
1,201392386,1145490689,3745,47873,2024-10-04 19:22:28,0,0,0,0,0,0
1,201392386,2170660915,0,0,2024-10-04 19:22:28,128,84,212,1,1,2
1,201392386,2170660915,37534,36895,2024-10-04 19:22:28,0,0,0,0,0,0
1,201392386,2170660915,57029,36895,2024-10-04 19:22:29,0,0,0,0,0,0
1,201392386,2170660915,41653,36895,2024-10-04 19:22:29,0,0,0,0,0,0
1,201392386,1145490689,3745,47873,2024-10-04 19:22:29,0,0,0,0,0,0
1,201392386,2170660915,0,0,2024-10-04 19:22:29,128,84,212,1,1,2
1,201392386,2170660915,37534,36895,2024-10-04 19:22:29,0,0,0,0,0,0
1,201392386,2170660915,57029,36895,2024-10-04 19:22:30,0,0,0,0,0,0
1,201392386,2170660915,41653,36895,2024-10-04 19:22:30,0,0,0,0,0,0
1,201392386,1145490689,3745,47873,2024-10-04 19:22:30,0,0,0,0,0,0
1,201392386,2170660915,0,0,2024-10-04 19:22:30,128,84,212,1,1,2
1,201392386,2170660915,37534,36895,2024-10-04 19:22:30,0,0,0,0,0,0
1,201392386,2170660915,57029,36895,2024-10-04 19:22:31,0,0,0,0,0,0
1,201392386,2170660915,41653,36895,2024-10-04 19:22:31,0,0,0,0,0,0
1,201392386,1145490689,3745,47873,2024-10-04 19:22:31,0,0,0,0,0,0
1,201392386,2170660915,0,0,2024-10-04 19:22:31,128,84,212,1,1,2
1,201392386,2170660915,37534,36895,2024-10-04 19:22:31,0,0,0,0,0,0
1,201392386,2170660915,57029,36895,2024-10-04 19:22:32,0,0,0,0,0,0
1,201392386,2170660915,41653,36895,2024-10-04 19:22:32,0,0,0,0,0,0
1,201392386,1145490689,3745,47873,2024-10-04 19:22:32,0,0,0,0,0,0
1,201392386,2170660915,0,0,2024-10-04 19:22:32,128,168,296,1,2,3
1,201392386,2170660915,37534,36895,2024-10-04 19:22:32,0,0,0,0,0,0
1,201392386,2170660915,57029,36895,2024-10-04 19:22:33,0,0,0,0,0,0
1,201392386,2170660915,41653,36895,2024-10-04 19:22:33,0,0,0,0,0,0
1,201392386,1145490689,3745,47873,2024-10-04 19:22:33,0,0,0,0,0,0
1,201392386,2170660915,0,0,2024-10-04 19:22:33,128,84,212,1,1,2
1,201392386,2170660915,37534,36895,2024-10-04 19:22:33,0,0,0,0,0,0
1,201392386,2170660915,57029,36895,2024-10-04 19:22:34,0,0,0,0,0,0
1,201392386,2170660915,41653,36895,2024-10-04 19:22:34,0,0,0,0,0,0
1,201392386,1145490689,3745,47873,2024-10-04 19:22:34,0,0,0,0,0,0
1,201392386,2170660915,0,0,2024-10-04 19:22:34,128,84,212,1,1,2
1,201392386,2170660915,37534,36895,2024-10-04 19:22:34,0,0,0,0,0,0
1,201392386,2170660915,57029,36895,2024-10-04 19:22:35,0,0,0,0,0,0
1,201392386,2170660915,41653,36895,2024-10-04 19:22:35,0,0,0,0,0,0
1,201392386,1145490689,3745,47873,2024-10-04 19:22:35,0,0,0,0,0,0
1,201392386,2170660915,0,0,2024-10-04 19:22:35,128,84,212,1,1,2
1,201392386,2170660915,37534,36895,2024-10-04 19:22:35,0,0,0,0,0,0
1,201392386,2170660915,57029,36895,2024-10-04 19:22:36,0,0,0,0,0,0
1,201392386,2170660915,41653,36895,2024-10-04 19:22:36,0,0,0,0,0,0
1,201392386,2170660915,0,0,2024-10-04 19:22:36,0,0,0,0,0,0
1,201392386,2170660915,33966,36895,2024-10-04 19:22:36,666,507,1173,6,6,12
1,201392386,2170660915,37534,36895,2024-10-04 19:22:36,0,0,0,0,0,0
1,201392386,2170660915,57029,36895,2024-10-04 19:22:37,0,0,0,0,0,0
1,201392386,2170660915,41653,36895,2024-10-04 19:22:37,0,0,0,0,0,0
1,201392386,2170660915,0,0,2024-10-04 19:22:37,128,84,212,1,1,2
1,201392386,2170660915,33966,36895,2024-10-04 19:22:37,0,0,0,0,0,0
1,201392386,2170660915,37534,36895,2024-10-04 19:22:37,0,0,0,0,0,0
1,201392386,2170660915,57029,36895,2024-10-04 19:22:38,0,0,0,0,0,0
1,201392386,2170660915,41653,36895,2024-10-04 19:22:38,0,0,0,0,0,0
1,201392386,2170660915,0,0,2024-10-04 19:22:38,128,0,128,1,0,1
1,201392386,2170660915,33966,36895,2024-10-04 19:22:38,0,0,0,0,0,0
1,201392386,2170660915,37534,36895,2024-10-04 19:22:38,0,0,0,0,0,0
1,201392386,2170660915,57029,36895,2024-10-04 19:22:39,0,0,0,0,0,0
1,201392386,2170660915,41653,36895,2024-10-04 19:22:39,0,0,0,0,0,0
1,201392386,2170660915,0,0,2024-10-04 19:22:39,128,84,212,1,1,2
1,201392386,2170660915,33966,36895,2024-10-04 19:22:39,0,0,0,0,0,0
1,201392386,2170660915,37534,36895,2024-10-04 19:22:39,0,0,0,0,0,0
1,201392386,2170660915,57029,36895,2024-10-04 19:22:40,0,0,0,0,0,0
1,201392386,2170660915,41653,36895,2024-10-04 19:22:40,0,0,0,0,0,0
1,201392386,2170660915,0,0,2024-10-04 19:22:40,0,0,0,0,0,0
1,201392386,2170660915,33966,36895,2024-10-04 19:22:40,0,0,0,0,0,0
1,201392386,2170660915,37534,36895,2024-10-04 19:22:40,0,0,0,0,0,0
1,201392386,2170660915,57029,36895,2024-10-04 19:22:41,0,0,0,0,0,0
1,201392386,2170660915,41653,36895,2024-10-04 19:22:41,0,0,0,0,0,0
1,201392386,2170660915,0,0,2024-10-04 19:22:41,0,0,0,0,0,0
1,201392386,2170660915,33966,36895,2024-10-04 19:22:41,0,0,0,0,0,0
1,201392386,2170660915,37534,36895,2024-10-04 19:22:41,0,0,0,0,0,0
1,201392386,2170660915,57029,36895,2024-10-04 19:22:42,0,0,0,0,0,0
1,201392386,2170660915,41653,36895,2024-10-04 19:22:42,0,0,0,0,0,0
1,201392386,2170660915,0,0,2024-10-04 19:22:42,0,0,0,0,0,0
1,201392386,2170660915,33966,36895,2024-10-04 19:22:42,0,0,0,0,0,0
1,201392386,2170660915,37534,36895,2024-10-04 19:22:42,0,0,0,0,0,0
1,201392386,2170660915,57029,36895,2024-10-04 19:22:43,0,0,0,0,0,0
1,201392386,2170660915,41653,36895,2024-10-04 19:22:43,0,0,0,0,0,0
1,201392386,2170660915,0,0,2024-10-04 19:22:43,128,84,212,1,1,2
1,201392386,2170660915,33966,36895,2024-10-04 19:22:43,0,0,0,0,0,0
1,201392386,2170660915,37534,36895,2024-10-04 19:22:43,0,0,0,0,0,0
1,201392386,2170660915,57029,36895,2024-10-04 19:22:44,0,0,0,0,0,0
1,201392386,2170660915,41653,36895,2024-10-04 19:22:44,0,0,0,0,0,0
1,201392386,2170660915,0,0,2024-10-04 19:22:44,128,84,212,1,1,2
1,201392386,2170660915,33966,36895,2024-10-04 19:22:44,0,0,0,0,0,0
1,201392386,2170660915,37534,36895,2024-10-04 19:22:44,0,0,0,0,0,0
1,201392386,2170660915,57029,36895,2024-10-04 19:22:45,0,0,0,0,0,0
1,201392386,2170660915,41653,36895,2024-10-04 19:22:45,0,0,0,0,0,0
1,201392386,1145490691,39086,47873,2024-10-04 19:22:45,3748,48322,52070,28,40,68
1,201392386,2170660915,0,0,2024-10-04 19:22:45,128,168,296,1,2,3
1,201392386,2170660915,33966,36895,2024-10-04 19:22:45,0,0,0,0,0,0
1,201392386,2170660915,37534,36895,2024-10-04 19:22:45,0,0,0,0,0,0
1,201392386,2170660915,57029,36895,2024-10-04 19:22:46,0,0,0,0,0,0
1,201392386,2170660915,41653,36895,2024-10-04 19:22:46,0,0,0,0,0,0
1,201392386,1145490691,39086,47873,2024-10-04 19:22:46,936,27210,28146,9,17,26
1,201392386,2170660915,0,0,2024-10-04 19:22:46,0,0,0,0,0,0
1,201392386,2170660915,33966,36895,2024-10-04 19:22:46,0,0,0,0,0,0
1,201392386,2170660915,37534,36895,2024-10-04 19:22:46,0,0,0,0,0,0
1,201392386,2170660915,57029,36895,2024-10-04 19:22:47,0,0,0,0,0,0
1,201392386,2170660915,41653,36895,2024-10-04 19:22:47,0,0,0,0,0,0
1,201392386,1145490691,39086,47873,2024-10-04 19:22:47,1956,33888,35844,19,25,44
1,201392386,2170660915,0,0,2024-10-04 19:22:47,0,0,0,0,0,0
1,201392386,2170660915,33966,36895,2024-10-04 19:22:47,0,0,0,0,0,0
1,201392386,2170660915,37534,36895,2024-10-04 19:22:47,0,0,0,0,0,0
1,201392386,2170660915,57029,36895,2024-10-04 19:22:48,0,0,0,0,0,0
1,201392386,2170660915,41653,36895,2024-10-04 19:22:48,0,0,0,0,0,0
1,201392386,1145490691,39086,47873,2024-10-04 19:22:48,0,0,0,0,0,0
1,201392386,2170660915,0,0,2024-10-04 19:22:48,0,0,0,0,0,0
1,201392386,2170660915,33966,36895,2024-10-04 19:22:48,0,0,0,0,0,0
1,201392386,2170660915,37534,36895,2024-10-04 19:22:48,0,0,0,0,0,0
1,201392386,2170660915,57029,36895,2024-10-04 19:22:49,0,0,0,0,0,0
1,201392386,2170660915,41653,36895,2024-10-04 19:22:49,0,0,0,0,0,0
1,201392386,1145490691,39086,47873,2024-10-04 19:22:49,0,0,0,0,0,0
1,201392386,2170660915,0,0,2024-10-04 19:22:49,0,0,0,0,0,0
1,201392386,2170660915,33966,36895,2024-10-04 19:22:49,0,0,0,0,0,0
1,201392386,2170660915,37534,36895,2024-10-04 19:22:49,0,0,0,0,0,0
1,201392386,2170660915,57029,36895,2024-10-04 19:22:50,0,0,0,0,0,0
1,201392386,2170660915,41653,36895,2024-10-04 19:22:50,0,0,0,0,0,0
1,201392386,1145490691,39086,47873,2024-10-04 19:22:50,0,0,0,0,0,0
1,201392386,2170660915,0,0,2024-10-04 19:22:50,0,0,0,0,0,0
1,201392386,2170660915,33966,36895,2024-10-04 19:22:50,0,0,0,0,0,0
1,201392386,2170660915,37534,36895,2024-10-04 19:22:50,0,0,0,0,0,0
1,201392386,2170660915,57029,36895,2024-10-04 19:22:51,0,0,0,0,0,0
1,201392386,2170660915,41653,36895,2024-10-04 19:22:51,0,0,0,0,0,0
1,201392386,1145490691,39086,47873,2024-10-04 19:22:51,0,0,0,0,0,0
1,201392386,2170660915,0,0,2024-10-04 19:22:51,0,0,0,0,0,0
1,201392386,2170660915,33966,36895,2024-10-04 19:22:51,0,0,0,0,0,0
1,201392386,2170660915,37534,36895,2024-10-04 19:22:51,0,0,0,0,0,0
1,201392386,2170660915,57029,36895,2024-10-04 19:22:52,0,0,0,0,0,0
1,201392386,2170660915,41653,36895,2024-10-04 19:22:52,0,0,0,0,0,0
1,201392386,1145490691,39086,47873,2024-10-04 19:22:52,0,0,0,0,0,0
1,201392386,2170660915,0,0,2024-10-04 19:22:52,0,0,0,0,0,0
1,201392386,2170660915,33966,36895,2024-10-04 19:22:52,0,0,0,0,0,0
1,201392386,2170660915,37534,36895,2024-10-04 19:22:52,0,0,0,0,0,0
1,201392386,2170660915,57029,36895,2024-10-04 19:22:53,0,0,0,0,0,0
1,201392386,2170660915,41653,36895,2024-10-04 19:22:53,0,0,0,0,0,0
1,201392386,1145490691,39086,47873,2024-10-04 19:22:53,0,0,0,0,0,0
1,201392386,2170660915,0,0,2024-10-04 19:22:53,0,0,0,0,0,0
1,201392386,2170660915,33966,36895,2024-10-04 19:22:53,0,0,0,0,0,0
1,201392386,2170660915,37534,36895,2024-10-04 19:22:53,0,0,0,0,0,0
1,201392386,2170660915,57029,36895,2024-10-04 19:22:54,0,0,0,0,0,0
1,201392386,2170660915,41653,36895,2024-10-04 19:22:54,0,0,0,0,0,0
1,201392386,1145490691,39086,47873,2024-10-04 19:22:54,0,0,0,0,0,0
1,201392386,2170660915,0,0,2024-10-04 19:22:54,0,0,0,0,0,0
1,201392386,2170660915,33966,36895,2024-10-04 19:22:54,0,0,0,0,0,0
1,201392386,2170660915,37534,36895,2024-10-04 19:22:54,0,0,0,0,0,0
1,201392386,2170660915,57029,36895,2024-10-04 19:22:55,0,0,0,0,0,0
1,201392386,2170660915,41653,36895,2024-10-04 19:22:55,0,0,0,0,0,0
1,201392386,1145490691,39086,47873,2024-10-04 19:22:55,0,0,0,0,0,0
1,201392386,2170660915,0,0,2024-10-04 19:22:55,0,0,0,0,0,0
1,201392386,2170660915,33966,36895,2024-10-04 19:22:55,0,0,0,0,0,0
1,201392386,2170660915,37534,36895,2024-10-04 19:22:55,0,0,0,0,0,0
1,201392386,2170660915,57029,36895,2024-10-04 19:22:56,0,0,0,0,0,0
1,201392386,2170660915,41653,36895,2024-10-04 19:22:56,0,0,0,0,0,0
1,201392386,1145490691,39086,47873,2024-10-04 19:22:56,0,0,0,0,0,0
1,201392386,2170660915,0,0,2024-10-04 19:22:56,0,0,0,0,0,0
1,201392386,2170660915,33966,36895,2024-10-04 19:22:56,0,0,0,0,0,0
1,201392386,2170660915,37534,36895,2024-10-04 19:22:56,0,0,0,0,0,0
1,201392386,2170660915,57029,36895,2024-10-04 19:22:57,0,0,0,0,0,0
1,201392386,2170660915,41653,36895,2024-10-04 19:22:57,0,0,0,0,0,0
1,201392386,1145490691,39086,47873,2024-10-04 19:22:57,0,0,0,0,0,0
1,201392386,2170660915,0,0,2024-10-04 19:22:57,128,84,212,1,1,2
1,201392386,2170660915,33966,36895,2024-10-04 19:22:57,0,0,0,0,0,0
1,201392386,2170660915,37534,36895,2024-10-04 19:22:57,0,0,0,0,0,0
1,201392386,2170660915,57029,36895,2024-10-04 19:22:58,0,0,0,0,0,0
1,201392386,2170660915,41653,36895,2024-10-04 19:22:58,0,0,0,0,0,0
1,201392386,1145490691,39086,47873,2024-10-04 19:22:58,0,0,0,0,0,0
1,201392386,2170660915,0,0,2024-10-04 19:22:58,128,84,212,1,1,2
1,201392386,2170660915,33966,36895,2024-10-04 19:22:58,0,0,0,0,0,0
1,201392386,2170660915,37534,36895,2024-10-04 19:22:58,0,0,0,0,0,0
1,201392386,2170660915,57029,36895,2024-10-04 19:22:59,0,0,0,0,0,0
1,201392386,2170660915,41653,36895,2024-10-04 19:22:59,0,0,0,0,0,0
1,201392386,1145490691,39086,47873,2024-10-04 19:22:59,0,0,0,0,0,0
1,201392386,2170660915,0,0,2024-10-04 19:22:59,128,84,212,1,1,2
1,201392386,2170660915,33966,36895,2024-10-04 19:22:59,0,0,0,0,0,0
1,201392386,2170660915,37534,36895,2024-10-04 19:22:59,0,0,0,0,0,0
1,201392386,2170660915,57029,36895,2024-10-04 19:23:00,0,0,0,0,0,0
1,201392386,2170660915,41653,36895,2024-10-04 19:23:00,0,0,0,0,0,0
1,201392386,1145490691,39086,47873,2024-10-04 19:23:00,0,0,0,0,0,0
1,201392386,2170660915,0,0,2024-10-04 19:23:00,128,84,212,1,1,2
1,201392386,2170660915,33966,36895,2024-10-04 19:23:00,0,0,0,0,0,0
1,201392386,2170660915,37534,36895,2024-10-04 19:23:00,0,0,0,0,0,0
1,201392386,2170660915,57029,36895,2024-10-04 19:23:01,0,0,0,0,0,0
1,201392386,2170660915,41653,36895,2024-10-04 19:23:01,0,0,0,0,0,0
1,201392386,1145490691,39086,47873,2024-10-04 19:23:01,0,0,0,0,0,0
1,201392386,2170660915,0,0,2024-10-04 19:23:01,128,84,212,1,1,2
1,201392386,2170660915,33966,36895,2024-10-04 19:23:01,0,0,0,0,0,0
1,201392386,2170660915,37534,36895,2024-10-04 19:23:01,0,0,0,0,0,0
1,201392386,2170660915,57029,36895,2024-10-04 19:23:02,0,0,0,0,0,0
1,201392386,2170660915,41653,36895,2024-10-04 19:23:02,0,0,0,0,0,0
1,201392386,1145490691,39086,47873,2024-10-04 19:23:02,0,0,0,0,0,0
1,201392386,2170660915,0,0,2024-10-04 19:23:02,128,84,212,1,1,2
1,201392386,2170660915,33966,36895,2024-10-04 19:23:02,0,0,0,0,0,0
1,201392386,2170660915,37534,36895,2024-10-04 19:23:02,0,0,0,0,0,0
1,201392386,2170660915,57029,36895,2024-10-04 19:23:03,0,0,0,0,0,0
1,201392386,2170660915,41653,36895,2024-10-04 19:23:03,0,0,0,0,0,0
1,201392386,1145490691,39086,47873,2024-10-04 19:23:03,0,0,0,0,0,0
1,201392386,2170660915,0,0,2024-10-04 19:23:03,128,84,212,1,1,2
1,201392386,2170660915,33966,36895,2024-10-04 19:23:03,0,0,0,0,0,0
1,201392386,2170660915,37534,36895,2024-10-04 19:23:03,0,0,0,0,0,0
1,201392386,2170660915,57029,36895,2024-10-04 19:23:04,0,0,0,0,0,0
1,201392386,2170660915,41653,36895,2024-10-04 19:23:04,0,0,0,0,0,0
1,201392386,1145490691,39086,47873,2024-10-04 19:23:04,0,0,0,0,0,0
1,201392386,2170660915,0,0,2024-10-04 19:23:04,128,84,212,1,1,2
1,201392386,2170660915,33966,36895,2024-10-04 19:23:04,0,0,0,0,0,0
1,201392386,2170660915,37534,36895,2024-10-04 19:23:04,0,0,0,0,0,0
1,201392386,2170660915,57029,36895,2024-10-04 19:23:05,0,0,0,0,0,0
1,201392386,2170660915,41653,36895,2024-10-04 19:23:05,0,0,0,0,0,0
1,201392386,1145490691,39086,47873,2024-10-04 19:23:05,0,0,0,0,0,0
1,201392386,2170660915,0,0,2024-10-04 19:23:05,128,84,212,1,1,2
1,201392386,2170660915,33966,36895,2024-10-04 19:23:05,0,0,0,0,0,0
1,201392386,2170660915,37534,36895,2024-10-04 19:23:05,0,0,0,0,0,0
1,201392386,2170660915,57029,36895,2024-10-04 19:23:06,0,0,0,0,0,0
1,201392386,2170660915,41653,36895,2024-10-04 19:23:06,0,0,0,0,0,0
1,201392386,1145490691,39086,47873,2024-10-04 19:23:06,0,0,0,0,0,0
1,201392386,2170660915,0,0,2024-10-04 19:23:06,128,84,212,1,1,2
1,201392386,2170660915,33966,36895,2024-10-04 19:23:06,0,0,0,0,0,0
1,201392386,2170660915,37534,36895,2024-10-04 19:23:06,0,0,0,0,0,0
1,201392386,2170660915,57029,36895,2024-10-04 19:23:07,0,0,0,0,0,0
1,201392386,2170660915,41653,36895,2024-10-04 19:23:07,0,0,0,0,0,0
1,201392386,2170660915,0,0,2024-10-04 19:23:07,0,0,0,0,0,0
1,201392386,2170660915,33966,36895,2024-10-04 19:23:07,0,0,0,0,0,0
1,201392386,2170660915,37534,36895,2024-10-04 19:23:07,0,0,0,0,0,0
1,201392386,2170660915,57029,36895,2024-10-04 19:23:08,0,0,0,0,0,0
1,201392386,2170660915,41653,36895,2024-10-04 19:23:08,0,0,0,0,0,0
1,201392386,2170660915,33511,36895,2024-10-04 19:23:08,570,455,1025,5,5,10
1,201392386,2170660915,0,0,2024-10-04 19:23:08,128,0,128,1,0,1
1,201392386,2170660915,37534,36895,2024-10-04 19:23:08,0,0,0,0,0,0
1,201392386,2170660915,57029,36895,2024-10-04 19:23:09,0,0,0,0,0,0
1,201392386,2170660915,33511,36895,2024-10-04 19:23:09,0,0,0,0,0,0
1,201392386,2170660915,0,0,2024-10-04 19:23:09,128,84,212,1,1,2
1,201392386,2170660915,37534,36895,2024-10-04 19:23:09,0,0,0,0,0,0
1,201392386,2170660915,57029,36895,2024-10-04 19:23:10,0,0,0,0,0,0
1,201392386,2170660915,33511,36895,2024-10-04 19:23:10,0,0,0,0,0,0
1,201392386,2170660915,0,0,2024-10-04 19:23:10,128,84,212,1,1,2
1,201392386,2170660915,37534,36895,2024-10-04 19:23:10,0,0,0,0,0,0
1,201392386,2170660915,57029,36895,2024-10-04 19:23:11,0,0,0,0,0,0
1,201392386,2170660915,33511,36895,2024-10-04 19:23:11,0,0,0,0,0,0
1,201392386,2170660915,0,0,2024-10-04 19:23:11,0,0,0,0,0,0
1,201392386,2170660915,37534,36895,2024-10-04 19:23:11,0,0,0,0,0,0
1,201392386,2170660915,57029,36895,2024-10-04 19:23:12,0,0,0,0,0,0
1,201392386,2170660915,33511,36895,2024-10-04 19:23:12,0,0,0,0,0,0
1,201392386,2170660915,0,0,2024-10-04 19:23:12,0,0,0,0,0,0
1,201392386,2170660915,37534,36895,2024-10-04 19:23:12,0,0,0,0,0,0
1,201392386,2170660915,57029,36895,2024-10-04 19:23:13,0,0,0,0,0,0
1,201392386,2170660915,33511,36895,2024-10-04 19:23:13,0,0,0,0,0,0
1,201392386,2170660915,0,0,2024-10-04 19:23:13,0,84,84,0,1,1
1,201392386,2170660915,37534,36895,2024-10-04 19:23:13,0,0,0,0,0,0
1,201392386,2170660915,57029,36895,2024-10-04 19:23:14,0,0,0,0,0,0
1,201392386,2170660915,33511,36895,2024-10-04 19:23:14,0,0,0,0,0,0
1,201392386,2170660915,0,0,2024-10-04 19:23:14,128,84,212,1,1,2
1,201392386,2170660915,37534,36895,2024-10-04 19:23:14,0,0,0,0,0,0
1,201392386,2170660915,57029,36895,2024-10-04 19:23:15,0,0,0,0,0,0
1,201392386,2170660915,33511,36895,2024-10-04 19:23:15,0,0,0,0,0,0
1,201392386,2170660915,0,0,2024-10-04 19:23:15,128,84,212,1,1,2
1,201392386,2170660915,37534,36895,2024-10-04 19:23:15,0,0,0,0,0,0
1,201392386,2170660915,57029,36895,2024-10-04 19:23:16,0,0,0,0,0,0
1,201392386,2170660915,33511,36895,2024-10-04 19:23:16,0,0,0,0,0,0
1,201392386,1145490692,691,47873,2024-10-04 19:23:16,2292,11861,14153,15,18,33
1,201392386,2170660915,0,0,2024-10-04 19:23:16,128,84,212,1,1,2
1,201392386,2170660915,37534,36895,2024-10-04 19:23:16,0,0,0,0,0,0
1,201392386,2170660915,57029,36895,2024-10-04 19:23:17,0,0,0,0,0,0
1,201392386,2170660915,33511,36895,2024-10-04 19:23:17,0,0,0,0,0,0
1,201392386,1145490692,691,47873,2024-10-04 19:23:17,3384,86082,89466,32,55,87
1,201392386,2170660915,0,0,2024-10-04 19:23:17,0,0,0,0,0,0
1,201392386,2170660915,37534,36895,2024-10-04 19:23:17,0,0,0,0,0,0
1,201392386,2170660915,57029,36895,2024-10-04 19:23:18,0,0,0,0,0,0
1,201392386,2170660915,33511,36895,2024-10-04 19:23:18,0,0,0,0,0,0
1,201392386,1145490692,691,47873,2024-10-04 19:23:18,0,0,0,0,0,0
1,201392386,2170660915,0,0,2024-10-04 19:23:18,0,0,0,0,0,0
1,201392386,2170660915,37534,36895,2024-10-04 19:23:18,0,0,0,0,0,0
1,201392386,2170660915,57029,36895,2024-10-04 19:23:19,0,0,0,0,0,0
1,201392386,2170660915,33511,36895,2024-10-04 19:23:19,0,0,0,0,0,0
1,201392386,1145490692,691,47873,2024-10-04 19:23:19,0,0,0,0,0,0
1,201392386,2170660915,0,0,2024-10-04 19:23:19,0,0,0,0,0,0
1,201392386,2170660915,37534,36895,2024-10-04 19:23:19,0,0,0,0,0,0
1,201392386,2170660915,57029,36895,2024-10-04 19:23:20,0,0,0,0,0,0
1,201392386,2170660915,33511,36895,2024-10-04 19:23:20,0,0,0,0,0,0
1,201392386,1145490692,691,47873,2024-10-04 19:23:20,0,0,0,0,0,0
1,201392386,2170660915,0,0,2024-10-04 19:23:20,0,0,0,0,0,0
1,201392386,2170660915,37534,36895,2024-10-04 19:23:20,0,0,0,0,0,0
1,201392386,2170660915,57029,36895,2024-10-04 19:23:21,0,0,0,0,0,0
1,201392386,2170660915,33511,36895,2024-10-04 19:23:21,0,0,0,0,0,0
1,201392386,1145490692,691,47873,2024-10-04 19:23:21,0,0,0,0,0,0
1,201392386,2170660915,0,0,2024-10-04 19:23:21,0,0,0,0,0,0
1,201392386,2170660915,37534,36895,2024-10-04 19:23:21,0,0,0,0,0,0
1,201392386,2170660915,57029,36895,2024-10-04 19:23:22,0,0,0,0,0,0
1,201392386,2170660915,33511,36895,2024-10-04 19:23:22,0,0,0,0,0,0
1,201392386,1145490692,691,47873,2024-10-04 19:23:22,0,0,0,0,0,0
1,201392386,2170660915,0,0,2024-10-04 19:23:22,0,0,0,0,0,0
1,201392386,2170660915,37534,36895,2024-10-04 19:23:22,0,0,0,0,0,0
1,201392386,2170660915,57029,36895,2024-10-04 19:23:23,0,0,0,0,0,0
1,201392386,2170660915,33511,36895,2024-10-04 19:23:23,0,0,0,0,0,0
1,201392386,1145490692,691,47873,2024-10-04 19:23:23,0,0,0,0,0,0
1,201392386,2170660915,0,0,2024-10-04 19:23:23,0,0,0,0,0,0
1,201392386,2170660915,37534,36895,2024-10-04 19:23:23,0,0,0,0,0,0
1,201392386,2170660915,57029,36895,2024-10-04 19:23:24,0,0,0,0,0,0
1,201392386,2170660915,33511,36895,2024-10-04 19:23:24,0,0,0,0,0,0
1,201392386,1145490692,691,47873,2024-10-04 19:23:24,0,0,0,0,0,0
1,201392386,2170660915,0,0,2024-10-04 19:23:24,0,0,0,0,0,0
1,201392386,2170660915,37534,36895,2024-10-04 19:23:24,0,0,0,0,0,0
1,201392386,2170660915,57029,36895,2024-10-04 19:23:25,0,0,0,0,0,0
1,201392386,2170660915,33511,36895,2024-10-04 19:23:25,0,0,0,0,0,0
1,201392386,1145490692,691,47873,2024-10-04 19:23:25,0,0,0,0,0,0
1,201392386,2170660915,0,0,2024-10-04 19:23:25,0,0,0,0,0,0
1,201392386,2170660915,37534,36895,2024-10-04 19:23:25,0,0,0,0,0,0
1,201392386,2170660915,57029,36895,2024-10-04 19:23:26,0,0,0,0,0,0
1,201392386,2170660915,33511,36895,2024-10-04 19:23:26,0,0,0,0,0,0
1,201392386,1145490692,691,47873,2024-10-04 19:23:26,720,5397,6117,7,6,13
1,201392386,2170660915,0,0,2024-10-04 19:23:26,0,0,0,0,0,0
1,201392386,2170660915,37534,36895,2024-10-04 19:23:26,0,0,0,0,0,0
1,201392386,2170660915,57029,36895,2024-10-04 19:23:27,0,0,0,0,0,0
1,201392386,2170660915,33511,36895,2024-10-04 19:23:27,0,0,0,0,0,0
1,201392386,1145490692,691,47873,2024-10-04 19:23:27,0,0,0,0,0,0
1,201392386,2170660915,0,0,2024-10-04 19:23:27,128,0,128,1,0,1
1,201392386,2170660915,37534,36895,2024-10-04 19:23:27,0,0,0,0,0,0
1,201392386,2170660915,57029,36895,2024-10-04 19:23:28,0,0,0,0,0,0
1,201392386,2170660915,33511,36895,2024-10-04 19:23:28,0,0,0,0,0,0
1,201392386,1145490692,691,47873,2024-10-04 19:23:28,0,0,0,0,0,0
1,201392386,2170660915,0,0,2024-10-04 19:23:28,128,84,212,1,1,2
1,201392386,2170660915,37534,36895,2024-10-04 19:23:28,0,0,0,0,0,0
1,201392386,2170660915,57029,36895,2024-10-04 19:23:29,0,0,0,0,0,0
1,201392386,2170660915,33511,36895,2024-10-04 19:23:29,0,0,0,0,0,0
1,201392386,1145490692,691,47873,2024-10-04 19:23:29,0,0,0,0,0,0
1,201392386,2170660915,0,0,2024-10-04 19:23:29,128,84,212,1,1,2
1,201392386,2170660915,37534,36895,2024-10-04 19:23:29,0,0,0,0,0,0
1,201392386,2170660915,57029,36895,2024-10-04 19:23:30,0,0,0,0,0,0
1,201392386,2170660915,33511,36895,2024-10-04 19:23:30,0,0,0,0,0,0
1,201392386,1145490692,691,47873,2024-10-04 19:23:30,0,0,0,0,0,0
1,201392386,2170660915,0,0,2024-10-04 19:23:30,128,84,212,1,1,2
1,201392386,2170660915,37534,36895,2024-10-04 19:23:30,0,0,0,0,0,0
1,201392386,2170660915,57029,36895,2024-10-04 19:23:31,0,0,0,0,0,0
1,201392386,2170660915,33511,36895,2024-10-04 19:23:31,0,0,0,0,0,0
1,201392386,1145490692,691,47873,2024-10-04 19:23:31,0,0,0,0,0,0
1,201392386,2170660915,0,0,2024-10-04 19:23:31,128,84,212,1,1,2
1,201392386,2170660915,37534,36895,2024-10-04 19:23:31,0,0,0,0,0,0
1,201392386,2170660915,57029,36895,2024-10-04 19:23:32,0,0,0,0,0,0
1,201392386,2170660915,33511,36895,2024-10-04 19:23:32,0,0,0,0,0,0
1,201392386,1145490692,691,47873,2024-10-04 19:23:32,0,0,0,0,0,0
1,201392386,2170660915,0,0,2024-10-04 19:23:32,128,84,212,1,1,2
1,201392386,2170660915,37534,36895,2024-10-04 19:23:32,0,0,0,0,0,0
1,201392386,2170660915,57029,36895,2024-10-04 19:23:33,0,0,0,0,0,0
1,201392386,2170660915,33511,36895,2024-10-04 19:23:33,0,0,0,0,0,0
1,201392386,1145490692,691,47873,2024-10-04 19:23:33,0,0,0,0,0,0
1,201392386,2170660915,0,0,2024-10-04 19:23:33,128,84,212,1,1,2
1,201392386,2170660915,37534,36895,2024-10-04 19:23:33,0,0,0,0,0,0
1,201392386,2170660915,57029,36895,2024-10-04 19:23:34,0,0,0,0,0,0
1,201392386,2170660915,33511,36895,2024-10-04 19:23:34,0,0,0,0,0,0
1,201392386,1145490692,691,47873,2024-10-04 19:23:34,0,0,0,0,0,0
1,201392386,2170660915,0,0,2024-10-04 19:23:34,128,84,212,1,1,2
1,201392386,2170660915,37534,36895,2024-10-04 19:23:34,0,0,0,0,0,0
1,201392386,2170660915,57029,36895,2024-10-04 19:23:35,0,0,0,0,0,0
1,201392386,2170660915,33511,36895,2024-10-04 19:23:35,0,0,0,0,0,0
1,201392386,1145490692,691,47873,2024-10-04 19:23:35,0,0,0,0,0,0
1,201392386,2170660915,0,0,2024-10-04 19:23:35,128,84,212,1,1,2
1,201392386,2170660915,37534,36895,2024-10-04 19:23:35,0,0,0,0,0,0
1,201392386,2170660915,57029,36895,2024-10-04 19:23:36,0,0,0,0,0,0
1,201392386,2170660915,33511,36895,2024-10-04 19:23:36,0,0,0,0,0,0
1,201392386,1145490692,691,47873,2024-10-04 19:23:36,0,0,0,0,0,0
1,201392386,2170660915,0,0,2024-10-04 19:23:36,128,84,212,1,1,2
1,201392386,2170660915,37534,36895,2024-10-04 19:23:36,0,0,0,0,0,0
1,201392386,2170660915,57029,36895,2024-10-04 19:23:37,0,0,0,0,0,0
1,201392386,2170660915,33511,36895,2024-10-04 19:23:37,0,0,0,0,0,0
1,201392386,1145490692,691,47873,2024-10-04 19:23:37,0,0,0,0,0,0
1,201392386,2170660915,0,0,2024-10-04 19:23:37,0,84,84,0,1,1
1,201392386,2170660915,37534,36895,2024-10-04 19:23:37,0,0,0,0,0,0
1,201392386,2170660915,57029,36895,2024-10-04 19:23:38,0,0,0,0,0,0
1,201392386,2170660915,43715,36895,2024-10-04 19:23:38,666,507,1173,6,6,12
1,201392386,2170660915,0,0,2024-10-04 19:23:38,0,0,0,0,0,0
1,201392386,2170660915,37534,36895,2024-10-04 19:23:38,0,0,0,0,0,0
1,201392386,2170660915,57029,36895,2024-10-04 19:23:39,0,0,0,0,0,0
1,201392386,2170660915,43715,36895,2024-10-04 19:23:39,0,0,0,0,0,0
1,201392386,2170660915,0,0,2024-10-04 19:23:39,128,84,212,1,1,2
1,201392386,2170660915,37534,36895,2024-10-04 19:23:39,0,0,0,0,0,0
1,201392386,2170660915,57029,36895,2024-10-04 19:23:40,0,0,0,0,0,0
1,201392386,2170660915,43715,36895,2024-10-04 19:23:40,0,0,0,0,0,0
1,201392386,2170660915,0,0,2024-10-04 19:23:40,128,84,212,1,1,2
1,201392386,2170660915,37534,36895,2024-10-04 19:23:40,0,0,0,0,0,0
1,201392386,2170660915,57029,36895,2024-10-04 19:23:41,0,0,0,0,0,0
1,201392386,2170660915,43715,36895,2024-10-04 19:23:41,0,0,0,0,0,0
1,201392386,2170660915,0,0,2024-10-04 19:23:41,128,84,212,1,1,2
1,201392386,2170660915,37534,36895,2024-10-04 19:23:41,0,0,0,0,0,0
1,201392386,2170660915,57029,36895,2024-10-04 19:23:42,0,0,0,0,0,0
1,201392386,2170660915,43715,36895,2024-10-04 19:23:42,0,0,0,0,0,0
1,201392386,2170660915,0,0,2024-10-04 19:23:42,0,0,0,0,0,0
1,201392386,2170660915,37534,36895,2024-10-04 19:23:42,0,0,0,0,0,0
1,201392386,2170660915,57029,36895,2024-10-04 19:23:43,0,0,0,0,0,0
1,201392386,2170660915,43715,36895,2024-10-04 19:23:43,0,0,0,0,0,0
1,201392386,2170660915,0,0,2024-10-04 19:23:43,0,0,0,0,0,0
1,201392386,2170660915,37534,36895,2024-10-04 19:23:43,0,0,0,0,0,0
1,201392386,2170660915,57029,36895,2024-10-04 19:23:44,0,0,0,0,0,0
1,201392386,2170660915,43715,36895,2024-10-04 19:23:44,0,0,0,0,0,0
1,201392386,2170660915,0,0,2024-10-04 19:23:44,0,0,0,0,0,0
1,201392386,2170660915,37534,36895,2024-10-04 19:23:44,0,0,0,0,0,0
1,201392386,2170660915,57029,36895,2024-10-04 19:23:45,0,0,0,0,0,0
1,201392386,2170660915,43715,36895,2024-10-04 19:23:45,0,0,0,0,0,0
1,201392386,2170660915,0,0,2024-10-04 19:23:45,128,84,212,1,1,2
1,201392386,2170660915,37534,36895,2024-10-04 19:23:45,0,0,0,0,0,0
1,201392386,2170660915,57029,36895,2024-10-04 19:23:46,0,0,0,0,0,0
1,201392386,2170660915,43715,36895,2024-10-04 19:23:46,0,0,0,0,0,0
1,201392386,2170660915,0,0,2024-10-04 19:23:46,128,84,212,1,1,2
1,201392386,2170660915,37534,36895,2024-10-04 19:23:46,0,0,0,0,0,0
1,201392386,2170660915,57029,36895,2024-10-04 19:23:47,0,0,0,0,0,0
1,201392386,1145490690,20193,47873,2024-10-04 19:23:47,2932,31283,34215,21,29,50
1,201392386,2170660915,0,0,2024-10-04 19:23:47,128,84,212,1,1,2
1,201392386,2170660915,37534,36895,2024-10-04 19:23:47,0,0,0,0,0,0
1,201392386,2170660915,57029,36895,2024-10-04 19:23:48,0,0,0,0,0,0
1,201392386,1145490690,20193,47873,2024-10-04 19:23:48,3072,63324,66396,31,42,73
1,201392386,2170660915,0,0,2024-10-04 19:23:48,0,0,0,0,0,0
1,201392386,2170660915,37534,36895,2024-10-04 19:23:48,0,0,0,0,0,0
1,201392386,2170660915,57029,36895,2024-10-04 19:23:49,0,0,0,0,0,0
1,201392386,1145490690,20193,47873,2024-10-04 19:23:49,0,0,0,0,0,0
1,201392386,2170660915,0,0,2024-10-04 19:23:49,0,0,0,0,0,0
1,201392386,2170660915,37534,36895,2024-10-04 19:23:49,0,0,0,0,0,0
1,201392386,2170660915,57029,36895,2024-10-04 19:23:50,0,0,0,0,0,0
1,201392386,1145490690,20193,47873,2024-10-04 19:23:50,0,0,0,0,0,0
1,201392386,2170660915,0,0,2024-10-04 19:23:50,0,0,0,0,0,0
1,201392386,2170660915,37534,36895,2024-10-04 19:23:50,0,0,0,0,0,0
1,201392386,2170660915,57029,36895,2024-10-04 19:23:51,0,0,0,0,0,0
1,201392386,1145490690,20193,47873,2024-10-04 19:23:51,0,0,0,0,0,0
1,201392386,2170660915,0,0,2024-10-04 19:23:51,0,0,0,0,0,0
1,201392386,2170660915,37534,36895,2024-10-04 19:23:51,0,0,0,0,0,0
1,201392386,2170660915,57029,36895,2024-10-04 19:23:52,0,0,0,0,0,0
1,201392386,1145490690,20193,47873,2024-10-04 19:23:52,0,0,0,0,0,0
1,201392386,2170660915,0,0,2024-10-04 19:23:52,0,0,0,0,0,0
1,201392386,2170660915,37534,36895,2024-10-04 19:23:52,0,0,0,0,0,0
1,201392386,2170660915,57029,36895,2024-10-04 19:23:53,0,0,0,0,0,0
1,201392386,1145490690,20193,47873,2024-10-04 19:23:53,0,0,0,0,0,0
1,201392386,2170660915,0,0,2024-10-04 19:23:53,0,0,0,0,0,0
1,201392386,2170660915,37534,36895,2024-10-04 19:23:53,0,0,0,0,0,0
1,201392386,2170660915,57029,36895,2024-10-04 19:23:54,0,0,0,0,0,0
1,201392386,1145490690,20193,47873,2024-10-04 19:23:54,0,0,0,0,0,0
1,201392386,2170660915,0,0,2024-10-04 19:23:54,0,0,0,0,0,0
1,201392386,2170660915,37534,36895,2024-10-04 19:23:54,0,0,0,0,0,0
1,201392386,2170660915,57029,36895,2024-10-04 19:23:55,0,0,0,0,0,0
1,201392386,1145490690,20193,47873,2024-10-04 19:23:55,0,0,0,0,0,0
1,201392386,2170660915,0,0,2024-10-04 19:23:55,0,0,0,0,0,0
1,201392386,2170660915,37534,36895,2024-10-04 19:23:55,0,0,0,0,0,0
1,201392386,2170660915,57029,36895,2024-10-04 19:23:56,0,0,0,0,0,0
1,201392386,1145490690,20193,47873,2024-10-04 19:23:56,0,0,0,0,0,0
1,201392386,2170660915,0,0,2024-10-04 19:23:56,0,0,0,0,0,0
1,201392386,2170660915,37534,36895,2024-10-04 19:23:56,0,0,0,0,0,0
1,201392386,2170660915,57029,36895,2024-10-04 19:23:57,0,0,0,0,0,0
1,201392386,1145490690,20193,47873,2024-10-04 19:23:57,720,2609,3329,7,5,12
1,201392386,2170660915,0,0,2024-10-04 19:23:57,0,0,0,0,0,0
1,201392386,2170660915,37534,36895,2024-10-04 19:23:57,0,0,0,0,0,0
1,201392386,2170660915,57029,36895,2024-10-04 19:23:58,0,0,0,0,0,0
1,201392386,1145490690,20193,47873,2024-10-04 19:23:58,0,0,0,0,0,0
1,201392386,2170660915,0,0,2024-10-04 19:23:58,128,0,128,1,0,1
1,201392386,2170660915,37534,36895,2024-10-04 19:23:58,0,0,0,0,0,0
1,201392386,2170660915,57029,36895,2024-10-04 19:23:59,0,0,0,0,0,0
1,201392386,1145490690,20193,47873,2024-10-04 19:23:59,0,0,0,0,0,0
1,201392386,2170660915,0,0,2024-10-04 19:23:59,128,84,212,1,1,2
1,201392386,2170660915,37534,36895,2024-10-04 19:23:59,0,0,0,0,0,0
1,201392386,2170660915,57029,36895,2024-10-04 19:24:00,0,0,0,0,0,0
1,201392386,1145490690,20193,47873,2024-10-04 19:24:00,0,0,0,0,0,0
1,201392386,2170660915,0,0,2024-10-04 19:24:00,0,84,84,0,1,1
1,201392386,2170660915,37534,36895,2024-10-04 19:24:00,0,0,0,0,0,0
1,201392386,2170660915,57029,36895,2024-10-04 19:24:01,0,0,0,0,0,0
1,201392386,1145490690,20193,47873,2024-10-04 19:24:01,0,0,0,0,0,0
1,201392386,2170660915,0,0,2024-10-04 19:24:01,128,84,212,1,1,2
1,201392386,2170660915,37534,36895,2024-10-04 19:24:01,0,0,0,0,0,0
1,201392386,2170660915,57029,36895,2024-10-04 19:24:02,0,0,0,0,0,0
1,201392386,1145490690,20193,47873,2024-10-04 19:24:02,0,0,0,0,0,0
1,201392386,2170660915,0,0,2024-10-04 19:24:02,128,84,212,1,1,2
1,201392386,2170660915,37534,36895,2024-10-04 19:24:02,0,0,0,0,0,0
1,201392386,2170660915,57029,36895,2024-10-04 19:24:03,0,0,0,0,0,0
1,201392386,1145490690,20193,47873,2024-10-04 19:24:03,0,0,0,0,0,0
1,201392386,2170660915,0,0,2024-10-04 19:24:03,128,84,212,1,1,2
1,201392386,2170660915,37534,36895,2024-10-04 19:24:03,0,0,0,0,0,0
1,201392386,2170660915,57029,36895,2024-10-04 19:24:04,0,0,0,0,0,0
1,201392386,1145490690,20193,47873,2024-10-04 19:24:04,0,0,0,0,0,0
1,201392386,2170660915,0,0,2024-10-04 19:24:04,128,84,212,1,1,2
1,201392386,2170660915,37534,36895,2024-10-04 19:24:04,0,0,0,0,0,0
1,201392386,2170660915,57029,36895,2024-10-04 19:24:05,0,0,0,0,0,0
1,201392386,1145490690,20193,47873,2024-10-04 19:24:05,0,0,0,0,0,0
1,201392386,2170660915,0,0,2024-10-04 19:24:05,128,84,212,1,1,2
1,201392386,2170660915,37534,36895,2024-10-04 19:24:05,0,0,0,0,0,0
1,201392386,2170660915,57029,36895,2024-10-04 19:24:06,0,0,0,0,0,0
1,201392386,1145490690,20193,47873,2024-10-04 19:24:06,0,0,0,0,0,0
1,201392386,2170660915,0,0,2024-10-04 19:24:06,128,84,212,1,1,2
1,201392386,2170660915,37534,36895,2024-10-04 19:24:06,0,0,0,0,0,0
1,201392386,2170660915,57029,36895,2024-10-04 19:24:07,0,0,0,0,0,0
1,201392386,1145490690,20193,47873,2024-10-04 19:24:07,0,0,0,0,0,0
1,201392386,2170660915,0,0,2024-10-04 19:24:07,128,84,212,1,1,2
1,201392386,2170660915,37534,36895,2024-10-04 19:24:07,0,0,0,0,0,0
1,201392386,2170660915,57029,36895,2024-10-04 19:24:08,0,0,0,0,0,0
1,201392386,2170660915,0,0,2024-10-04 19:24:08,128,84,212,1,1,2
1,201392386,2170660915,37534,36895,2024-10-04 19:24:08,0,0,0,0,0,0
1,201392386,2170660915,57029,36895,2024-10-04 19:24:09,0,0,0,0,0,0
1,201392386,2170660915,0,0,2024-10-04 19:24:09,0,0,0,0,0,0
1,201392386,2170660915,37534,36895,2024-10-04 19:24:09,0,0,0,0,0,0
1,201392386,2170660915,57029,36895,2024-10-04 19:24:10,0,0,0,0,0,0
1,201392386,2170660915,0,0,2024-10-04 19:24:10,0,0,0,0,0,0
1,201392386,2170660915,37534,36895,2024-10-04 19:24:10,0,0,0,0,0,0
1,201392386,2170660915,60087,36895,2024-10-04 19:24:10,666,507,1173,6,6,12
1,201392386,2170660915,57029,36895,2024-10-04 19:24:11,0,0,0,0,0,0
1,201392386,2170660915,0,0,2024-10-04 19:24:11,128,84,212,1,1,2
1,201392386,2170660915,37534,36895,2024-10-04 19:24:11,0,0,0,0,0,0
1,201392386,2170660915,60087,36895,2024-10-04 19:24:11,0,0,0,0,0,0
1,201392386,2170660915,57029,36895,2024-10-04 19:24:12,0,0,0,0,0,0
1,201392386,2170660915,0,0,2024-10-04 19:24:12,128,84,212,1,1,2
1,201392386,2170660915,37534,36895,2024-10-04 19:24:12,0,0,0,0,0,0
1,201392386,2170660915,60087,36895,2024-10-04 19:24:12,0,0,0,0,0,0
1,201392386,2170660915,57029,36895,2024-10-04 19:24:13,0,0,0,0,0,0
1,201392386,2170660915,0,0,2024-10-04 19:24:13,0,0,0,0,0,0
1,201392386,2170660915,37534,36895,2024-10-04 19:24:13,0,0,0,0,0,0
1,201392386,2170660915,60087,36895,2024-10-04 19:24:13,0,0,0,0,0,0
1,201392386,2170660915,57029,36895,2024-10-04 19:24:14,0,0,0,0,0,0
1,201392386,2170660915,0,0,2024-10-04 19:24:14,0,0,0,0,0,0
1,201392386,2170660915,37534,36895,2024-10-04 19:24:14,0,0,0,0,0,0
1,201392386,2170660915,60087,36895,2024-10-04 19:24:14,0,0,0,0,0,0
1,201392386,2170660915,57029,36895,2024-10-04 19:24:15,0,0,0,0,0,0
1,201392386,2170660915,0,0,2024-10-04 19:24:15,128,84,212,1,1,2
1,201392386,2170660915,37534,36895,2024-10-04 19:24:15,0,0,0,0,0,0
1,201392386,2170660915,60087,36895,2024-10-04 19:24:15,0,0,0,0,0,0
1,201392386,2170660915,57029,36895,2024-10-04 19:24:16,0,0,0,0,0,0
1,201392386,2170660915,0,0,2024-10-04 19:24:16,0,0,0,0,0,0
1,201392386,2170660915,37534,36895,2024-10-04 19:24:16,0,0,0,0,0,0
1,201392386,2170660915,60087,36895,2024-10-04 19:24:16,0,0,0,0,0,0
1,201392386,2170660915,57029,36895,2024-10-04 19:24:17,0,0,0,0,0,0
1,201392386,2170660915,0,0,2024-10-04 19:24:17,256,168,424,2,2,4
1,201392386,2170660915,37534,36895,2024-10-04 19:24:17,0,0,0,0,0,0
1,201392386,2170660915,60087,36895,2024-10-04 19:24:17,0,0,0,0,0,0
1,201392386,1145490691,40107,47873,2024-10-04 19:24:18,200,60,260,2,1,3
1,201392386,2170660915,57029,36895,2024-10-04 19:24:18,0,0,0,0,0,0
1,201392386,2170660915,0,0,2024-10-04 19:24:18,128,84,212,1,1,2
1,201392386,2170660915,37534,36895,2024-10-04 19:24:18,0,0,0,0,0,0
1,201392386,2170660915,60087,36895,2024-10-04 19:24:18,0,0,0,0,0,0
1,201392386,1145490691,40107,47873,2024-10-04 19:24:19,0,0,0,0,0,0
1,201392386,2170660915,57029,36895,2024-10-04 19:24:19,0,0,0,0,0,0
1,201392386,2170660915,0,0,2024-10-04 19:24:19,0,0,0,0,0,0
1,201392386,2170660915,37534,36895,2024-10-04 19:24:19,0,0,0,0,0,0
1,201392386,2170660915,60087,36895,2024-10-04 19:24:19,0,0,0,0,0,0
1,201392386,1145490691,40107,47873,2024-10-04 19:24:20,0,0,0,0,0,0
1,201392386,2170660915,57029,36895,2024-10-04 19:24:20,0,0,0,0,0,0
1,201392386,2170660915,0,0,2024-10-04 19:24:20,0,0,0,0,0,0
1,201392386,2170660915,37534,36895,2024-10-04 19:24:20,0,0,0,0,0,0
1,201392386,2170660915,60087,36895,2024-10-04 19:24:20,0,0,0,0,0,0
1,201392386,1145490691,40107,47873,2024-10-04 19:24:21,0,0,0,0,0,0
1,201392386,2170660915,57029,36895,2024-10-04 19:24:21,0,0,0,0,0,0
1,201392386,2170660915,0,0,2024-10-04 19:24:21,0,0,0,0,0,0
1,201392386,2170660915,37534,36895,2024-10-04 19:24:21,0,0,0,0,0,0
1,201392386,2170660915,60087,36895,2024-10-04 19:24:21,0,0,0,0,0,0
1,201392386,1145490691,40107,47873,2024-10-04 19:24:22,0,0,0,0,0,0
1,201392386,2170660915,57029,36895,2024-10-04 19:24:22,0,0,0,0,0,0
1,201392386,2170660915,0,0,2024-10-04 19:24:22,0,0,0,0,0,0
1,201392386,2170660915,37534,36895,2024-10-04 19:24:22,0,0,0,0,0,0
1,201392386,2170660915,60087,36895,2024-10-04 19:24:22,0,0,0,0,0,0
1,201392386,1145490691,40107,47873,2024-10-04 19:24:23,0,0,0,0,0,0
1,201392386,2170660915,57029,36895,2024-10-04 19:24:23,0,0,0,0,0,0
1,201392386,2170660915,0,0,2024-10-04 19:24:23,0,0,0,0,0,0
1,201392386,2170660915,37534,36895,2024-10-04 19:24:23,0,0,0,0,0,0
1,201392386,2170660915,60087,36895,2024-10-04 19:24:23,0,0,0,0,0,0
1,201392386,1145490691,40107,47873,2024-10-04 19:24:24,0,0,0,0,0,0
1,201392386,2170660915,57029,36895,2024-10-04 19:24:24,0,0,0,0,0,0
1,201392386,2170660915,0,0,2024-10-04 19:24:24,0,0,0,0,0,0
1,201392386,2170660915,37534,36895,2024-10-04 19:24:24,0,0,0,0,0,0
1,201392386,2170660915,60087,36895,2024-10-04 19:24:24,0,0,0,0,0,0
1,201392386,1145490691,40107,47873,2024-10-04 19:24:25,0,0,0,0,0,0
1,201392386,2170660915,57029,36895,2024-10-04 19:24:25,0,0,0,0,0,0
1,201392386,2170660915,0,0,2024-10-04 19:24:25,0,0,0,0,0,0
1,201392386,2170660915,37534,36895,2024-10-04 19:24:25,0,0,0,0,0,0
1,201392386,2170660915,60087,36895,2024-10-04 19:24:25,0,0,0,0,0,0
1,201392386,1145490691,40107,47873,2024-10-04 19:24:26,0,0,0,0,0,0
1,201392386,2170660915,57029,36895,2024-10-04 19:24:26,0,0,0,0,0,0
1,201392386,2170660915,0,0,2024-10-04 19:24:26,0,0,0,0,0,0
1,201392386,2170660915,37534,36895,2024-10-04 19:24:26,0,0,0,0,0,0
1,201392386,2170660915,60087,36895,2024-10-04 19:24:26,0,0,0,0,0,0
1,201392386,1145490691,40107,47873,2024-10-04 19:24:27,0,0,0,0,0,0
1,201392386,2170660915,57029,36895,2024-10-04 19:24:27,0,0,0,0,0,0
1,201392386,2170660915,0,0,2024-10-04 19:24:27,0,0,0,0,0,0
1,201392386,2170660915,37534,36895,2024-10-04 19:24:27,0,0,0,0,0,0
1,201392386,2170660915,60087,36895,2024-10-04 19:24:27,0,0,0,0,0,0
1,201392386,1145490691,40107,47873,2024-10-04 19:24:28,6028,91128,97156,51,73,124
1,201392386,2170660915,57029,36895,2024-10-04 19:24:28,0,0,0,0,0,0
1,201392386,2170660915,0,0,2024-10-04 19:24:28,0,0,0,0,0,0
1,201392386,2170660915,37534,36895,2024-10-04 19:24:28,0,0,0,0,0,0
1,201392386,2170660915,60087,36895,2024-10-04 19:24:28,0,0,0,0,0,0
1,201392386,1145490691,40107,47873,2024-10-04 19:24:29,0,0,0,0,0,0
1,201392386,2170660915,57029,36895,2024-10-04 19:24:29,0,0,0,0,0,0
1,201392386,2170660915,0,0,2024-10-04 19:24:29,128,84,212,1,1,2
1,201392386,2170660915,37534,36895,2024-10-04 19:24:29,0,0,0,0,0,0
1,201392386,2170660915,60087,36895,2024-10-04 19:24:29,0,0,0,0,0,0
1,201392386,1145490691,40107,47873,2024-10-04 19:24:30,0,0,0,0,0,0
1,201392386,2170660915,57029,36895,2024-10-04 19:24:30,0,0,0,0,0,0
1,201392386,2170660915,0,0,2024-10-04 19:24:30,128,84,212,1,1,2
1,201392386,2170660915,37534,36895,2024-10-04 19:24:30,0,0,0,0,0,0
1,201392386,2170660915,60087,36895,2024-10-04 19:24:30,0,0,0,0,0,0
1,201392386,1145490691,40107,47873,2024-10-04 19:24:31,0,0,0,0,0,0
1,201392386,2170660915,57029,36895,2024-10-04 19:24:31,0,0,0,0,0,0
1,201392386,2170660915,0,0,2024-10-04 19:24:31,128,84,212,1,1,2
1,201392386,2170660915,37534,36895,2024-10-04 19:24:31,0,0,0,0,0,0
1,201392386,2170660915,60087,36895,2024-10-04 19:24:31,0,0,0,0,0,0
1,201392386,1145490691,40107,47873,2024-10-04 19:24:32,0,0,0,0,0,0
1,201392386,2170660915,57029,36895,2024-10-04 19:24:32,0,0,0,0,0,0
1,201392386,2170660915,0,0,2024-10-04 19:24:32,128,84,212,1,1,2
1,201392386,2170660915,37534,36895,2024-10-04 19:24:32,0,0,0,0,0,0
1,201392386,2170660915,60087,36895,2024-10-04 19:24:32,0,0,0,0,0,0
1,201392386,1145490691,40107,47873,2024-10-04 19:24:33,0,0,0,0,0,0
1,201392386,2170660915,57029,36895,2024-10-04 19:24:33,0,0,0,0,0,0
1,201392386,2170660915,0,0,2024-10-04 19:24:33,128,84,212,1,1,2
1,201392386,2170660915,37534,36895,2024-10-04 19:24:33,0,0,0,0,0,0
1,201392386,2170660915,60087,36895,2024-10-04 19:24:33,0,0,0,0,0,0
1,201392386,1145490691,40107,47873,2024-10-04 19:24:34,0,0,0,0,0,0
1,201392386,2170660915,57029,36895,2024-10-04 19:24:34,0,0,0,0,0,0
1,201392386,2170660915,0,0,2024-10-04 19:24:34,128,84,212,1,1,2
1,201392386,2170660915,37534,36895,2024-10-04 19:24:34,0,0,0,0,0,0
1,201392386,2170660915,60087,36895,2024-10-04 19:24:34,0,0,0,0,0,0
1,201392386,1145490691,40107,47873,2024-10-04 19:24:35,0,0,0,0,0,0
1,201392386,2170660915,57029,36895,2024-10-04 19:24:35,0,0,0,0,0,0
1,201392386,2170660915,0,0,2024-10-04 19:24:35,128,84,212,1,1,2
1,201392386,2170660915,37534,36895,2024-10-04 19:24:35,0,0,0,0,0,0
1,201392386,2170660915,60087,36895,2024-10-04 19:24:35,0,0,0,0,0,0
1,201392386,1145490691,40107,47873,2024-10-04 19:24:36,0,0,0,0,0,0
1,201392386,2170660915,57029,36895,2024-10-04 19:24:36,0,0,0,0,0,0
1,201392386,2170660915,0,0,2024-10-04 19:24:36,128,84,212,1,1,2
1,201392386,2170660915,37534,36895,2024-10-04 19:24:36,0,0,0,0,0,0
1,201392386,2170660915,60087,36895,2024-10-04 19:24:36,0,0,0,0,0,0
1,201392386,1145490691,40107,47873,2024-10-04 19:24:37,0,0,0,0,0,0
1,201392386,2170660915,57029,36895,2024-10-04 19:24:37,0,0,0,0,0,0
1,201392386,2170660915,0,0,2024-10-04 19:24:37,128,84,212,1,1,2
1,201392386,2170660915,37534,36895,2024-10-04 19:24:37,0,0,0,0,0,0
1,201392386,2170660915,60087,36895,2024-10-04 19:24:37,0,0,0,0,0,0
1,201392386,2170660915,57029,36895,2024-10-04 19:24:38,0,0,0,0,0,0
1,201392386,2170660915,0,0,2024-10-04 19:24:38,128,84,212,1,1,2
1,201392386,2170660915,37534,36895,2024-10-04 19:24:38,0,0,0,0,0,0
1,201392386,2170660915,60087,36895,2024-10-04 19:24:38,0,0,0,0,0,0
1,201392386,2170660915,57029,36895,2024-10-04 19:24:39,0,0,0,0,0,0
1,201392386,2170660915,0,0,2024-10-04 19:24:39,0,0,0,0,0,0
1,201392386,2170660915,37534,36895,2024-10-04 19:24:39,0,0,0,0,0,0
1,201392386,2170660915,57029,36895,2024-10-04 19:24:40,0,0,0,0,0,0
1,201392386,2170660915,0,0,2024-10-04 19:24:40,0,0,0,0,0,0
1,201392386,2170660915,37534,36895,2024-10-04 19:24:40,0,0,0,0,0,0
1,201392386,2170660915,57029,36895,2024-10-04 19:24:41,0,0,0,0,0,0
1,201392386,2170660915,5839,36895,2024-10-04 19:24:41,666,507,1173,6,6,12
1,201392386,2170660915,0,0,2024-10-04 19:24:41,0,0,0,0,0,0
1,201392386,2170660915,37534,36895,2024-10-04 19:24:41,0,0,0,0,0,0
1,201392386,2170660915,57029,36895,2024-10-04 19:24:42,0,0,0,0,0,0
1,201392386,2170660915,5839,36895,2024-10-04 19:24:42,0,0,0,0,0,0
1,201392386,2170660915,0,0,2024-10-04 19:24:42,128,84,212,1,1,2
1,201392386,2170660915,37534,36895,2024-10-04 19:24:42,0,0,0,0,0,0
1,201392386,2170660915,57029,36895,2024-10-04 19:24:43,0,0,0,0,0,0
1,201392386,2170660915,5839,36895,2024-10-04 19:24:43,0,0,0,0,0,0
1,201392386,2170660915,0,0,2024-10-04 19:24:43,128,84,212,1,1,2
1,201392386,2170660915,37534,36895,2024-10-04 19:24:43,0,0,0,0,0,0
1,201392386,2170660915,57029,36895,2024-10-04 19:24:44,0,0,0,0,0,0
1,201392386,2170660915,5839,36895,2024-10-04 19:24:44,0,0,0,0,0,0
1,201392386,2170660915,0,0,2024-10-04 19:24:44,0,0,0,0,0,0
1,201392386,2170660915,37534,36895,2024-10-04 19:24:44,0,0,0,0,0,0
1,201392386,2170660915,57029,36895,2024-10-04 19:24:45,0,0,0,0,0,0
1,201392386,2170660915,5839,36895,2024-10-04 19:24:45,0,0,0,0,0,0
1,201392386,2170660915,0,0,2024-10-04 19:24:45,0,0,0,0,0,0
1,201392386,2170660915,37534,36895,2024-10-04 19:24:45,0,0,0,0,0,0
1,201392386,2170660915,57029,36895,2024-10-04 19:24:46,0,0,0,0,0,0
1,201392386,2170660915,5839,36895,2024-10-04 19:24:46,0,0,0,0,0,0
1,201392386,2170660915,0,0,2024-10-04 19:24:46,128,84,212,1,1,2
1,201392386,2170660915,37534,36895,2024-10-04 19:24:46,0,0,0,0,0,0
1,201392386,2170660915,57029,36895,2024-10-04 19:24:47,0,0,0,0,0,0
1,201392386,2170660915,5839,36895,2024-10-04 19:24:47,0,0,0,0,0,0
1,201392386,2170660915,0,0,2024-10-04 19:24:47,128,84,212,1,1,2
1,201392386,2170660915,37534,36895,2024-10-04 19:24:47,0,0,0,0,0,0
1,201392386,2170660915,57029,36895,2024-10-04 19:24:48,0,0,0,0,0,0
1,201392386,2170660915,5839,36895,2024-10-04 19:24:48,0,0,0,0,0,0
1,201392386,2170660915,0,0,2024-10-04 19:24:48,128,84,212,1,1,2
1,201392386,2170660915,37534,36895,2024-10-04 19:24:48,0,0,0,0,0,0
1,201392386,2170660915,57029,36895,2024-10-04 19:24:49,0,0,0,0,0,0
1,201392386,2170660915,5839,36895,2024-10-04 19:24:49,0,0,0,0,0,0
1,201392386,2170660915,0,0,2024-10-04 19:24:49,0,0,0,0,0,0
1,201392386,2170660915,37534,36895,2024-10-04 19:24:49,0,0,0,0,0,0
1,201392386,2170660915,57029,36895,2024-10-04 19:24:50,0,0,0,0,0,0
1,201392386,2170660915,5839,36895,2024-10-04 19:24:50,0,0,0,0,0,0
1,201392386,2170660915,0,0,2024-10-04 19:24:50,0,0,0,0,0,0
1,201392386,2170660915,37534,36895,2024-10-04 19:24:50,0,0,0,0,0,0
1,201392386,2170660915,57029,36895,2024-10-04 19:24:51,0,0,0,0,0,0
1,201392386,2170660915,5839,36895,2024-10-04 19:24:51,0,0,0,0,0,0
1,201392386,2170660915,0,0,2024-10-04 19:24:51,0,0,0,0,0,0
1,201392386,2170660915,37534,36895,2024-10-04 19:24:51,0,0,0,0,0,0
1,201392386,2170660915,57029,36895,2024-10-04 19:24:52,0,0,0,0,0,0
1,201392386,2170660915,5839,36895,2024-10-04 19:24:52,0,0,0,0,0,0
1,201392386,2170660915,0,0,2024-10-04 19:24:52,0,0,0,0,0,0
1,201392386,2170660915,37534,36895,2024-10-04 19:24:52,0,0,0,0,0,0
1,201392386,2170660915,57029,36895,2024-10-04 19:24:53,0,0,0,0,0,0
1,201392386,2170660915,5839,36895,2024-10-04 19:24:53,0,0,0,0,0,0
1,201392386,2170660915,0,0,2024-10-04 19:24:53,0,0,0,0,0,0
1,201392386,2170660915,37534,36895,2024-10-04 19:24:53,0,0,0,0,0,0
1,201392386,2170660915,57029,36895,2024-10-04 19:24:54,0,0,0,0,0,0
1,201392386,2170660915,5839,36895,2024-10-04 19:24:54,0,0,0,0,0,0
1,201392386,2170660915,0,0,2024-10-04 19:24:54,0,0,0,0,0,0
1,201392386,2170660915,37534,36895,2024-10-04 19:24:54,0,0,0,0,0,0
1,201392386,2170660915,57029,36895,2024-10-04 19:24:55,0,0,0,0,0,0
1,201392386,2170660915,5839,36895,2024-10-04 19:24:55,0,0,0,0,0,0
1,201392386,2170660915,0,0,2024-10-04 19:24:55,0,0,0,0,0,0
1,201392386,2170660915,37534,36895,2024-10-04 19:24:55,0,0,0,0,0,0
1,201392386,2170660915,57029,36895,2024-10-04 19:24:56,0,0,0,0,0,0
1,201392386,2170660915,5839,36895,2024-10-04 19:24:56,0,0,0,0,0,0
1,201392386,2170660915,0,0,2024-10-04 19:24:56,0,0,0,0,0,0
1,201392386,2170660915,37534,36895,2024-10-04 19:24:56,0,0,0,0,0,0
1,201392386,2170660915,57029,36895,2024-10-04 19:24:57,0,0,0,0,0,0
1,201392386,2170660915,5839,36895,2024-10-04 19:24:57,0,0,0,0,0,0
1,201392386,2170660915,0,0,2024-10-04 19:24:57,0,0,0,0,0,0
1,201392386,2170660915,37534,36895,2024-10-04 19:24:57,0,0,0,0,0,0
1,201392386,2170660915,57029,36895,2024-10-04 19:24:58,0,0,0,0,0,0
1,201392386,2170660915,5839,36895,2024-10-04 19:24:58,0,0,0,0,0,0
1,201392386,2170660915,0,0,2024-10-04 19:24:58,0,0,0,0,0,0
1,201392386,2170660915,37534,36895,2024-10-04 19:24:58,0,0,0,0,0,0
1,201392386,2170660915,57029,36895,2024-10-04 19:24:59,0,0,0,0,0,0
1,201392386,2170660915,5839,36895,2024-10-04 19:24:59,0,0,0,0,0,0
1,201392386,2170660915,0,0,2024-10-04 19:24:59,128,84,212,1,1,2
1,201392386,2170660915,37534,36895,2024-10-04 19:24:59,0,0,0,0,0,0
1,201392386,1145490691,36498,47873,2024-10-04 19:24:59,5784,89028,94812,49,71,120
1,201392386,2170660915,57029,36895,2024-10-04 19:25:00,0,0,0,0,0,0
1,201392386,2170660915,5839,36895,2024-10-04 19:25:00,0,0,0,0,0,0
1,201392386,2170660915,0,0,2024-10-04 19:25:00,128,84,212,1,1,2
1,201392386,2170660915,37534,36895,2024-10-04 19:25:00,0,0,0,0,0,0
1,201392386,1145490691,36498,47873,2024-10-04 19:25:00,0,0,0,0,0,0
1,201392386,2170660915,57029,36895,2024-10-04 19:25:01,0,0,0,0,0,0
1,201392386,2170660915,5839,36895,2024-10-04 19:25:01,0,0,0,0,0,0
1,201392386,2170660915,0,0,2024-10-04 19:25:01,128,84,212,1,1,2
1,201392386,2170660915,37534,36895,2024-10-04 19:25:01,0,0,0,0,0,0
1,201392386,1145490691,36498,47873,2024-10-04 19:25:01,0,0,0,0,0,0
1,201392386,2170660915,57029,36895,2024-10-04 19:25:02,0,0,0,0,0,0
1,201392386,2170660915,5839,36895,2024-10-04 19:25:02,0,0,0,0,0,0
1,201392386,2170660915,0,0,2024-10-04 19:25:02,128,84,212,1,1,2
1,201392386,2170660915,37534,36895,2024-10-04 19:25:02,0,0,0,0,0,0
1,201392386,1145490691,36498,47873,2024-10-04 19:25:02,0,0,0,0,0,0
1,201392386,2170660915,57029,36895,2024-10-04 19:25:03,0,0,0,0,0,0
1,201392386,2170660915,5839,36895,2024-10-04 19:25:03,0,0,0,0,0,0
1,201392386,2170660915,0,0,2024-10-04 19:25:03,128,84,212,1,1,2
1,201392386,2170660915,37534,36895,2024-10-04 19:25:03,0,0,0,0,0,0
1,201392386,1145490691,36498,47873,2024-10-04 19:25:03,0,0,0,0,0,0
1,201392386,2170660915,57029,36895,2024-10-04 19:25:04,0,0,0,0,0,0
1,201392386,2170660915,5839,36895,2024-10-04 19:25:04,0,0,0,0,0,0
1,201392386,2170660915,0,0,2024-10-04 19:25:04,128,84,212,1,1,2
1,201392386,2170660915,37534,36895,2024-10-04 19:25:04,0,0,0,0,0,0
1,201392386,1145490691,36498,47873,2024-10-04 19:25:04,0,0,0,0,0,0
1,201392386,2170660915,57029,36895,2024-10-04 19:25:05,0,0,0,0,0,0
1,201392386,2170660915,5839,36895,2024-10-04 19:25:05,0,0,0,0,0,0
1,201392386,2170660915,0,0,2024-10-04 19:25:05,128,84,212,1,1,2
1,201392386,2170660915,37534,36895,2024-10-04 19:25:05,0,0,0,0,0,0
1,201392386,1145490691,36498,47873,2024-10-04 19:25:05,0,0,0,0,0,0
1,201392386,2170660915,57029,36895,2024-10-04 19:25:06,0,0,0,0,0,0
1,201392386,2170660915,5839,36895,2024-10-04 19:25:06,0,0,0,0,0,0
1,201392386,2170660915,0,0,2024-10-04 19:25:06,128,84,212,1,1,2
1,201392386,2170660915,37534,36895,2024-10-04 19:25:06,0,0,0,0,0,0
1,201392386,1145490691,36498,47873,2024-10-04 19:25:06,0,0,0,0,0,0
1,201392386,2170660915,57029,36895,2024-10-04 19:25:07,0,0,0,0,0,0
1,201392386,2170660915,5839,36895,2024-10-04 19:25:07,0,0,0,0,0,0
1,201392386,2170660915,0,0,2024-10-04 19:25:07,128,84,212,1,1,2
1,201392386,2170660915,37534,36895,2024-10-04 19:25:07,0,0,0,0,0,0
1,201392386,1145490691,36498,47873,2024-10-04 19:25:07,0,0,0,0,0,0
1,201392386,2170660915,57029,36895,2024-10-04 19:25:08,0,0,0,0,0,0
1,201392386,2170660915,5839,36895,2024-10-04 19:25:08,0,0,0,0,0,0
1,201392386,2170660915,0,0,2024-10-04 19:25:08,128,84,212,1,1,2
1,201392386,2170660915,37534,36895,2024-10-04 19:25:08,0,0,0,0,0,0
1,201392386,1145490691,36498,47873,2024-10-04 19:25:08,0,0,0,0,0,0
1,201392386,2170660915,57029,36895,2024-10-04 19:25:09,0,0,0,0,0,0
1,201392386,2170660915,5839,36895,2024-10-04 19:25:09,0,0,0,0,0,0
1,201392386,2170660915,0,0,2024-10-04 19:25:09,128,84,212,1,1,2
1,201392386,2170660915,37534,36895,2024-10-04 19:25:09,0,0,0,0,0,0
1,201392386,2170660915,57029,36895,2024-10-04 19:25:10,0,0,0,0,0,0
1,201392386,2170660915,5839,36895,2024-10-04 19:25:10,0,0,0,0,0,0
1,201392386,2170660915,0,0,2024-10-04 19:25:10,0,0,0,0,0,0
1,201392386,2170660915,37534,36895,2024-10-04 19:25:10,0,0,0,0,0,0
1,201392386,2170660915,57029,36895,2024-10-04 19:25:11,0,0,0,0,0,0
1,201392386,2170660915,5839,36895,2024-10-04 19:25:11,0,0,0,0,0,0
1,201392386,2170660915,0,0,2024-10-04 19:25:11,128,0,128,1,0,1
1,201392386,2170660915,10978,36895,2024-10-04 19:25:11,666,507,1173,6,6,12
1,201392386,2170660915,37534,36895,2024-10-04 19:25:11,0,0,0,0,0,0
1,201392386,2170660915,57029,36895,2024-10-04 19:25:12,0,0,0,0,0,0
1,201392386,2170660915,5839,36895,2024-10-04 19:25:12,0,0,0,0,0,0
1,201392386,2170660915,0,0,2024-10-04 19:25:12,128,84,212,1,1,2
1,201392386,2170660915,10978,36895,2024-10-04 19:25:12,0,0,0,0,0,0
1,201392386,2170660915,37534,36895,2024-10-04 19:25:12,0,0,0,0,0,0
1,201392386,2170660915,57029,36895,2024-10-04 19:25:13,0,0,0,0,0,0
1,201392386,2170660915,5839,36895,2024-10-04 19:25:13,0,0,0,0,0,0
1,201392386,2170660915,0,0,2024-10-04 19:25:13,128,84,212,1,1,2
1,201392386,2170660915,10978,36895,2024-10-04 19:25:13,0,0,0,0,0,0
1,201392386,2170660915,37534,36895,2024-10-04 19:25:13,0,0,0,0,0,0
1,201392386,2170660915,57029,36895,2024-10-04 19:25:14,0,0,0,0,0,0
1,201392386,2170660915,5839,36895,2024-10-04 19:25:14,0,0,0,0,0,0
1,201392386,2170660915,0,0,2024-10-04 19:25:14,0,0,0,0,0,0
1,201392386,2170660915,10978,36895,2024-10-04 19:25:14,0,0,0,0,0,0
1,201392386,2170660915,37534,36895,2024-10-04 19:25:14,0,0,0,0,0,0
1,201392386,2170660915,57029,36895,2024-10-04 19:25:15,0,0,0,0,0,0
1,201392386,2170660915,5839,36895,2024-10-04 19:25:15,0,0,0,0,0,0
1,201392386,2170660915,0,0,2024-10-04 19:25:15,0,0,0,0,0,0
1,201392386,2170660915,10978,36895,2024-10-04 19:25:15,0,0,0,0,0,0
1,201392386,2170660915,37534,36895,2024-10-04 19:25:15,0,0,0,0,0,0
1,201392386,2170660915,57029,36895,2024-10-04 19:25:16,0,0,0,0,0,0
1,201392386,2170660915,5839,36895,2024-10-04 19:25:16,0,0,0,0,0,0
1,201392386,2170660915,0,0,2024-10-04 19:25:16,128,84,212,1,1,2
1,201392386,2170660915,10978,36895,2024-10-04 19:25:16,0,0,0,0,0,0
1,201392386,2170660915,37534,36895,2024-10-04 19:25:16,0,0,0,0,0,0
1,201392386,2170660915,57029,36895,2024-10-04 19:25:17,0,0,0,0,0,0
1,201392386,2170660915,5839,36895,2024-10-04 19:25:17,0,0,0,0,0,0
1,201392386,2170660915,0,0,2024-10-04 19:25:17,128,84,212,1,1,2
1,201392386,2170660915,10978,36895,2024-10-04 19:25:17,0,0,0,0,0,0
1,201392386,2170660915,37534,36895,2024-10-04 19:25:17,0,0,0,0,0,0
1,201392386,2170660915,57029,36895,2024-10-04 19:25:18,0,0,0,0,0,0
1,201392386,2170660915,5839,36895,2024-10-04 19:25:18,0,0,0,0,0,0
1,201392386,2170660915,0,0,2024-10-04 19:25:18,128,84,212,1,1,2
1,201392386,2170660915,10978,36895,2024-10-04 19:25:18,0,0,0,0,0,0
1,201392386,2170660915,37534,36895,2024-10-04 19:25:18,0,0,0,0,0,0
1,201392386,2170660915,57029,36895,2024-10-04 19:25:19,0,0,0,0,0,0
1,201392386,2170660915,5839,36895,2024-10-04 19:25:19,0,0,0,0,0,0
1,201392386,1145490690,16080,47873,2024-10-04 19:25:19,4056,55845,59901,32,45,77
1,201392386,2170660915,0,0,2024-10-04 19:25:19,0,84,84,0,1,1
1,201392386,2170660915,10978,36895,2024-10-04 19:25:19,0,0,0,0,0,0
1,201392386,2170660915,37534,36895,2024-10-04 19:25:19,0,0,0,0,0,0
1,201392386,2170660915,57029,36895,2024-10-04 19:25:20,0,0,0,0,0,0
1,201392386,2170660915,5839,36895,2024-10-04 19:25:20,0,0,0,0,0,0
1,201392386,1145490690,16080,47873,2024-10-04 19:25:20,0,0,0,0,0,0
1,201392386,2170660915,0,0,2024-10-04 19:25:20,0,0,0,0,0,0
1,201392386,2170660915,10978,36895,2024-10-04 19:25:20,0,0,0,0,0,0
1,201392386,2170660915,37534,36895,2024-10-04 19:25:20,0,0,0,0,0,0
1,201392386,2170660915,57029,36895,2024-10-04 19:25:21,0,0,0,0,0,0
1,201392386,2170660915,5839,36895,2024-10-04 19:25:21,0,0,0,0,0,0
1,201392386,1145490690,16080,47873,2024-10-04 19:25:21,0,0,0,0,0,0
1,201392386,2170660915,0,0,2024-10-04 19:25:21,0,0,0,0,0,0
1,201392386,2170660915,10978,36895,2024-10-04 19:25:21,0,0,0,0,0,0
1,201392386,2170660915,37534,36895,2024-10-04 19:25:21,0,0,0,0,0,0
1,201392386,2170660915,57029,36895,2024-10-04 19:25:22,0,0,0,0,0,0
1,201392386,2170660915,5839,36895,2024-10-04 19:25:22,0,0,0,0,0,0
1,201392386,1145490690,16080,47873,2024-10-04 19:25:22,0,0,0,0,0,0
1,201392386,2170660915,0,0,2024-10-04 19:25:22,0,0,0,0,0,0
1,201392386,2170660915,10978,36895,2024-10-04 19:25:22,0,0,0,0,0,0
1,201392386,2170660915,37534,36895,2024-10-04 19:25:22,0,0,0,0,0,0
1,201392386,2170660915,57029,36895,2024-10-04 19:25:23,0,0,0,0,0,0
1,201392386,2170660915,5839,36895,2024-10-04 19:25:23,0,0,0,0,0,0
1,201392386,1145490690,16080,47873,2024-10-04 19:25:23,0,0,0,0,0,0
1,201392386,2170660915,0,0,2024-10-04 19:25:23,0,0,0,0,0,0
1,201392386,2170660915,10978,36895,2024-10-04 19:25:23,0,0,0,0,0,0
1,201392386,2170660915,37534,36895,2024-10-04 19:25:23,0,0,0,0,0,0
1,201392386,2170660915,57029,36895,2024-10-04 19:25:24,0,0,0,0,0,0
1,201392386,2170660915,5839,36895,2024-10-04 19:25:24,0,0,0,0,0,0
1,201392386,1145490690,16080,47873,2024-10-04 19:25:24,0,0,0,0,0,0
1,201392386,2170660915,0,0,2024-10-04 19:25:24,0,0,0,0,0,0
1,201392386,2170660915,10978,36895,2024-10-04 19:25:24,0,0,0,0,0,0
1,201392386,2170660915,37534,36895,2024-10-04 19:25:24,0,0,0,0,0,0
1,201392386,2170660915,57029,36895,2024-10-04 19:25:25,0,0,0,0,0,0
1,201392386,2170660915,5839,36895,2024-10-04 19:25:25,0,0,0,0,0,0
1,201392386,1145490690,16080,47873,2024-10-04 19:25:25,0,0,0,0,0,0
1,201392386,2170660915,0,0,2024-10-04 19:25:25,0,0,0,0,0,0
1,201392386,2170660915,10978,36895,2024-10-04 19:25:25,0,0,0,0,0,0
1,201392386,2170660915,37534,36895,2024-10-04 19:25:25,0,0,0,0,0,0
1,201392386,2170660915,57029,36895,2024-10-04 19:25:26,0,0,0,0,0,0
1,201392386,2170660915,5839,36895,2024-10-04 19:25:26,0,0,0,0,0,0
1,201392386,1145490690,16080,47873,2024-10-04 19:25:26,0,0,0,0,0,0
1,201392386,2170660915,0,0,2024-10-04 19:25:26,0,0,0,0,0,0
1,201392386,2170660915,10978,36895,2024-10-04 19:25:26,0,0,0,0,0,0
1,201392386,2170660915,37534,36895,2024-10-04 19:25:26,0,0,0,0,0,0
1,201392386,2170660915,57029,36895,2024-10-04 19:25:27,0,0,0,0,0,0
1,201392386,2170660915,5839,36895,2024-10-04 19:25:27,0,0,0,0,0,0
1,201392386,1145490690,16080,47873,2024-10-04 19:25:27,0,0,0,0,0,0
1,201392386,2170660915,0,0,2024-10-04 19:25:27,0,0,0,0,0,0
1,201392386,2170660915,10978,36895,2024-10-04 19:25:27,0,0,0,0,0,0
1,201392386,2170660915,37534,36895,2024-10-04 19:25:27,0,0,0,0,0,0
1,201392386,2170660915,57029,36895,2024-10-04 19:25:28,0,0,0,0,0,0
1,201392386,2170660915,5839,36895,2024-10-04 19:25:28,0,0,0,0,0,0
1,201392386,1145490690,16080,47873,2024-10-04 19:25:28,0,0,0,0,0,0
1,201392386,2170660915,0,0,2024-10-04 19:25:28,0,0,0,0,0,0
1,201392386,2170660915,10978,36895,2024-10-04 19:25:28,0,0,0,0,0,0
1,201392386,2170660915,37534,36895,2024-10-04 19:25:28,0,0,0,0,0,0
1,201392386,2170660915,57029,36895,2024-10-04 19:25:29,0,0,0,0,0,0
1,201392386,2170660915,5839,36895,2024-10-04 19:25:29,0,0,0,0,0,0
1,201392386,1145490690,16080,47873,2024-10-04 19:25:29,2604,41319,43923,26,30,56
1,201392386,2170660915,0,0,2024-10-04 19:25:29,0,0,0,0,0,0
1,201392386,2170660915,10978,36895,2024-10-04 19:25:29,0,0,0,0,0,0
1,201392386,2170660915,37534,36895,2024-10-04 19:25:29,0,0,0,0,0,0
1,201392386,2170660915,57029,36895,2024-10-04 19:25:30,0,0,0,0,0,0
1,201392386,2170660915,5839,36895,2024-10-04 19:25:30,0,0,0,0,0,0
1,201392386,1145490690,16080,47873,2024-10-04 19:25:30,0,0,0,0,0,0
1,201392386,2170660915,0,0,2024-10-04 19:25:30,128,84,212,1,1,2
1,201392386,2170660915,10978,36895,2024-10-04 19:25:30,0,0,0,0,0,0
1,201392386,2170660915,37534,36895,2024-10-04 19:25:30,0,0,0,0,0,0
1,201392386,2170660915,57029,36895,2024-10-04 19:25:31,0,0,0,0,0,0
1,201392386,2170660915,5839,36895,2024-10-04 19:25:31,0,0,0,0,0,0
1,201392386,1145490690,16080,47873,2024-10-04 19:25:31,0,0,0,0,0,0
1,201392386,2170660915,0,0,2024-10-04 19:25:31,128,84,212,1,1,2
1,201392386,2170660915,10978,36895,2024-10-04 19:25:31,0,0,0,0,0,0
1,201392386,2170660915,37534,36895,2024-10-04 19:25:31,0,0,0,0,0,0
1,201392386,2170660915,57029,36895,2024-10-04 19:25:32,0,0,0,0,0,0
1,201392386,2170660915,5839,36895,2024-10-04 19:25:32,0,0,0,0,0,0
1,201392386,1145490690,16080,47873,2024-10-04 19:25:32,0,0,0,0,0,0
1,201392386,2170660915,0,0,2024-10-04 19:25:32,128,84,212,1,1,2
1,201392386,2170660915,10978,36895,2024-10-04 19:25:32,0,0,0,0,0,0
1,201392386,2170660915,37534,36895,2024-10-04 19:25:32,0,0,0,0,0,0
1,201392386,2170660915,57029,36895,2024-10-04 19:25:33,0,0,0,0,0,0
1,201392386,2170660915,5839,36895,2024-10-04 19:25:33,0,0,0,0,0,0
1,201392386,1145490690,16080,47873,2024-10-04 19:25:33,0,0,0,0,0,0
1,201392386,2170660915,0,0,2024-10-04 19:25:33,128,84,212,1,1,2
1,201392386,2170660915,10978,36895,2024-10-04 19:25:33,0,0,0,0,0,0
1,201392386,2170660915,37534,36895,2024-10-04 19:25:33,0,0,0,0,0,0
1,201392386,2170660915,57029,36895,2024-10-04 19:25:34,0,0,0,0,0,0
1,201392386,2170660915,5839,36895,2024-10-04 19:25:34,0,0,0,0,0,0
1,201392386,1145490690,16080,47873,2024-10-04 19:25:34,0,0,0,0,0,0
1,201392386,2170660915,0,0,2024-10-04 19:25:34,128,84,212,1,1,2
1,201392386,2170660915,10978,36895,2024-10-04 19:25:34,0,0,0,0,0,0
1,201392386,2170660915,37534,36895,2024-10-04 19:25:34,0,0,0,0,0,0
1,201392386,2170660915,57029,36895,2024-10-04 19:25:35,0,0,0,0,0,0
1,201392386,2170660915,5839,36895,2024-10-04 19:25:35,0,0,0,0,0,0
1,201392386,1145490690,16080,47873,2024-10-04 19:25:35,0,0,0,0,0,0
1,201392386,2170660915,0,0,2024-10-04 19:25:35,128,84,212,1,1,2
1,201392386,2170660915,10978,36895,2024-10-04 19:25:35,0,0,0,0,0,0
1,201392386,2170660915,37534,36895,2024-10-04 19:25:35,0,0,0,0,0,0
1,201392386,2170660915,57029,36895,2024-10-04 19:25:36,0,0,0,0,0,0
1,201392386,2170660915,5839,36895,2024-10-04 19:25:36,0,0,0,0,0,0
1,201392386,1145490690,16080,47873,2024-10-04 19:25:36,0,0,0,0,0,0
1,201392386,2170660915,0,0,2024-10-04 19:25:36,128,84,212,1,1,2
1,201392386,2170660915,10978,36895,2024-10-04 19:25:36,0,0,0,0,0,0
1,201392386,2170660915,37534,36895,2024-10-04 19:25:36,0,0,0,0,0,0
1,201392386,2170660915,57029,36895,2024-10-04 19:25:37,0,0,0,0,0,0
1,201392386,2170660915,5839,36895,2024-10-04 19:25:37,0,0,0,0,0,0
1,201392386,1145490690,16080,47873,2024-10-04 19:25:37,0,0,0,0,0,0
1,201392386,2170660915,0,0,2024-10-04 19:25:37,128,84,212,1,1,2
1,201392386,2170660915,10978,36895,2024-10-04 19:25:37,0,0,0,0,0,0
1,201392386,2170660915,37534,36895,2024-10-04 19:25:37,0,0,0,0,0,0
1,201392386,2170660915,57029,36895,2024-10-04 19:25:38,0,0,0,0,0,0
1,201392386,2170660915,5839,36895,2024-10-04 19:25:38,0,0,0,0,0,0
1,201392386,1145490690,16080,47873,2024-10-04 19:25:38,0,0,0,0,0,0
1,201392386,2170660915,0,0,2024-10-04 19:25:38,128,84,212,1,1,2
1,201392386,2170660915,10978,36895,2024-10-04 19:25:38,0,0,0,0,0,0
1,201392386,2170660915,37534,36895,2024-10-04 19:25:38,0,0,0,0,0,0
1,201392386,2170660915,57029,36895,2024-10-04 19:25:39,0,0,0,0,0,0
1,201392386,2170660915,5839,36895,2024-10-04 19:25:39,0,0,0,0,0,0
1,201392386,2170660915,0,0,2024-10-04 19:25:39,128,84,212,1,1,2
1,201392386,2170660915,10978,36895,2024-10-04 19:25:39,0,0,0,0,0,0
1,201392386,2170660915,37534,36895,2024-10-04 19:25:39,0,0,0,0,0,0
1,201392386,2170660915,57029,36895,2024-10-04 19:25:40,0,0,0,0,0,0
1,201392386,2170660915,5839,36895,2024-10-04 19:25:40,0,0,0,0,0,0
1,201392386,2170660915,0,0,2024-10-04 19:25:40,0,0,0,0,0,0
1,201392386,2170660915,37534,36895,2024-10-04 19:25:40,0,0,0,0,0,0
1,201392386,2170660915,57029,36895,2024-10-04 19:25:41,0,0,0,0,0,0
1,201392386,2170660915,5839,36895,2024-10-04 19:25:41,0,0,0,0,0,0
1,201392386,2170660915,0,0,2024-10-04 19:25:41,0,0,0,0,0,0
1,201392386,2170660915,37534,36895,2024-10-04 19:25:41,0,0,0,0,0,0
1,201392386,2170660915,57029,36895,2024-10-04 19:25:42,0,0,0,0,0,0
1,201392386,2170660915,6350,36895,2024-10-04 19:25:42,666,507,1173,6,6,12
1,201392386,2170660915,5839,36895,2024-10-04 19:25:42,0,0,0,0,0,0
1,201392386,2170660915,0,0,2024-10-04 19:25:42,128,0,128,1,0,1
1,201392386,2170660915,37534,36895,2024-10-04 19:25:42,0,0,0,0,0,0
1,201392386,2170660915,57029,36895,2024-10-04 19:25:43,0,0,0,0,0,0
1,201392386,2170660915,6350,36895,2024-10-04 19:25:43,0,0,0,0,0,0
1,201392386,2170660915,5839,36895,2024-10-04 19:25:43,0,0,0,0,0,0
1,201392386,2170660915,0,0,2024-10-04 19:25:43,128,84,212,1,1,2
1,201392386,2170660915,37534,36895,2024-10-04 19:25:43,0,0,0,0,0,0
1,201392386,2170660915,57029,36895,2024-10-04 19:25:44,0,0,0,0,0,0
1,201392386,2170660915,6350,36895,2024-10-04 19:25:44,0,0,0,0,0,0
1,201392386,2170660915,5839,36895,2024-10-04 19:25:44,0,0,0,0,0,0
1,201392386,2170660915,0,0,2024-10-04 19:25:44,128,84,212,1,1,2
1,201392386,2170660915,37534,36895,2024-10-04 19:25:44,0,0,0,0,0,0
1,201392386,2170660915,57029,36895,2024-10-04 19:25:45,0,0,0,0,0,0
1,201392386,2170660915,6350,36895,2024-10-04 19:25:45,0,0,0,0,0,0
1,201392386,2170660915,5839,36895,2024-10-04 19:25:45,0,0,0,0,0,0
1,201392386,2170660915,0,0,2024-10-04 19:25:45,0,0,0,0,0,0
1,201392386,2170660915,37534,36895,2024-10-04 19:25:45,0,0,0,0,0,0
1,201392386,2170660915,57029,36895,2024-10-04 19:25:46,0,0,0,0,0,0
1,201392386,2170660915,6350,36895,2024-10-04 19:25:46,0,0,0,0,0,0
1,201392386,2170660915,5839,36895,2024-10-04 19:25:46,0,0,0,0,0,0
1,201392386,2170660915,0,0,2024-10-04 19:25:46,0,84,84,0,1,1
1,201392386,2170660915,37534,36895,2024-10-04 19:25:46,0,0,0,0,0,0
1,201392386,2170660915,57029,36895,2024-10-04 19:25:47,0,0,0,0,0,0
1,201392386,2170660915,6350,36895,2024-10-04 19:25:47,0,0,0,0,0,0
1,201392386,2170660915,5839,36895,2024-10-04 19:25:47,0,0,0,0,0,0
1,201392386,2170660915,0,0,2024-10-04 19:25:47,128,0,128,1,0,1
1,201392386,2170660915,37534,36895,2024-10-04 19:25:47,0,0,0,0,0,0
1,201392386,2170660915,57029,36895,2024-10-04 19:25:48,0,0,0,0,0,0
1,201392386,2170660915,6350,36895,2024-10-04 19:25:48,0,0,0,0,0,0
1,201392386,2170660915,5839,36895,2024-10-04 19:25:48,0,0,0,0,0,0
1,201392386,2170660915,0,0,2024-10-04 19:25:48,128,84,212,1,1,2
1,201392386,2170660915,37534,36895,2024-10-04 19:25:48,0,0,0,0,0,0
1,201392386,2170660915,57029,36895,2024-10-04 19:25:49,0,0,0,0,0,0
1,201392386,2170660915,6350,36895,2024-10-04 19:25:49,0,0,0,0,0,0
1,201392386,2170660915,5839,36895,2024-10-04 19:25:49,0,0,0,0,0,0
1,201392386,2170660915,0,0,2024-10-04 19:25:49,128,84,212,1,1,2
1,201392386,2170660915,37534,36895,2024-10-04 19:25:49,0,0,0,0,0,0
1,201392386,2170660915,57029,36895,2024-10-04 19:25:50,0,0,0,0,0,0
1,201392386,1145490691,30942,47873,2024-10-04 19:25:50,4420,68751,73171,35,50,85
1,201392386,2170660915,6350,36895,2024-10-04 19:25:50,0,0,0,0,0,0
1,201392386,2170660915,5839,36895,2024-10-04 19:25:50,0,0,0,0,0,0
1,201392386,2170660915,0,0,2024-10-04 19:25:50,0,84,84,0,1,1
1,201392386,2170660915,37534,36895,2024-10-04 19:25:50,0,0,0,0,0,0
1,201392386,2170660915,57029,36895,2024-10-04 19:25:51,0,0,0,0,0,0
1,201392386,1145490691,30942,47873,2024-10-04 19:25:51,0,0,0,0,0,0
1,201392386,2170660915,6350,36895,2024-10-04 19:25:51,0,0,0,0,0,0
1,201392386,2170660915,5839,36895,2024-10-04 19:25:51,0,0,0,0,0,0
1,201392386,2170660915,0,0,2024-10-04 19:25:51,0,0,0,0,0,0
1,201392386,2170660915,37534,36895,2024-10-04 19:25:51,0,0,0,0,0,0
1,201392386,2170660915,57029,36895,2024-10-04 19:25:52,0,0,0,0,0,0
1,201392386,1145490691,30942,47873,2024-10-04 19:25:52,0,0,0,0,0,0
1,201392386,2170660915,6350,36895,2024-10-04 19:25:52,0,0,0,0,0,0
1,201392386,2170660915,5839,36895,2024-10-04 19:25:52,0,0,0,0,0,0
1,201392386,2170660915,0,0,2024-10-04 19:25:52,0,0,0,0,0,0
1,201392386,2170660915,37534,36895,2024-10-04 19:25:52,0,0,0,0,0,0
1,201392386,2170660915,57029,36895,2024-10-04 19:25:53,0,0,0,0,0,0
1,201392386,1145490691,30942,47873,2024-10-04 19:25:53,0,0,0,0,0,0
1,201392386,2170660915,6350,36895,2024-10-04 19:25:53,0,0,0,0,0,0
1,201392386,2170660915,5839,36895,2024-10-04 19:25:53,0,0,0,0,0,0
1,201392386,2170660915,0,0,2024-10-04 19:25:53,0,0,0,0,0,0
1,201392386,2170660915,37534,36895,2024-10-04 19:25:53,0,0,0,0,0,0
1,201392386,2170660915,57029,36895,2024-10-04 19:25:54,0,0,0,0,0,0
1,201392386,1145490691,30942,47873,2024-10-04 19:25:54,0,0,0,0,0,0
1,201392386,2170660915,6350,36895,2024-10-04 19:25:54,0,0,0,0,0,0
1,201392386,2170660915,5839,36895,2024-10-04 19:25:54,0,0,0,0,0,0
1,201392386,2170660915,0,0,2024-10-04 19:25:54,0,0,0,0,0,0
1,201392386,2170660915,37534,36895,2024-10-04 19:25:54,0,0,0,0,0,0
1,201392386,2170660915,57029,36895,2024-10-04 19:25:55,0,0,0,0,0,0
1,201392386,1145490691,30942,47873,2024-10-04 19:25:55,0,0,0,0,0,0
1,201392386,2170660915,6350,36895,2024-10-04 19:25:55,0,0,0,0,0,0
1,201392386,2170660915,5839,36895,2024-10-04 19:25:55,0,0,0,0,0,0
1,201392386,2170660915,0,0,2024-10-04 19:25:55,0,0,0,0,0,0
1,201392386,2170660915,37534,36895,2024-10-04 19:25:55,0,0,0,0,0,0
1,201392386,2170660915,57029,36895,2024-10-04 19:25:56,0,0,0,0,0,0
1,201392386,1145490691,30942,47873,2024-10-04 19:25:56,0,0,0,0,0,0
1,201392386,2170660915,6350,36895,2024-10-04 19:25:56,0,0,0,0,0,0
1,201392386,2170660915,5839,36895,2024-10-04 19:25:56,0,0,0,0,0,0
1,201392386,2170660915,0,0,2024-10-04 19:25:56,0,0,0,0,0,0
1,201392386,2170660915,37534,36895,2024-10-04 19:25:56,0,0,0,0,0,0
1,201392386,2170660915,57029,36895,2024-10-04 19:25:57,0,0,0,0,0,0
1,201392386,1145490691,30942,47873,2024-10-04 19:25:57,0,0,0,0,0,0
1,201392386,2170660915,6350,36895,2024-10-04 19:25:57,0,0,0,0,0,0
1,201392386,2170660915,5839,36895,2024-10-04 19:25:57,0,0,0,0,0,0
1,201392386,2170660915,0,0,2024-10-04 19:25:57,0,0,0,0,0,0
1,201392386,2170660915,37534,36895,2024-10-04 19:25:57,0,0,0,0,0,0
1,201392386,2170660915,57029,36895,2024-10-04 19:25:58,0,0,0,0,0,0
1,201392386,1145490691,30942,47873,2024-10-04 19:25:58,0,0,0,0,0,0
1,201392386,2170660915,6350,36895,2024-10-04 19:25:58,0,0,0,0,0,0
1,201392386,2170660915,5839,36895,2024-10-04 19:25:58,0,0,0,0,0,0
1,201392386,2170660915,0,0,2024-10-04 19:25:58,0,0,0,0,0,0
1,201392386,2170660915,37534,36895,2024-10-04 19:25:58,0,0,0,0,0,0
1,201392386,2170660915,57029,36895,2024-10-04 19:25:59,0,0,0,0,0,0
1,201392386,1145490691,30942,47873,2024-10-04 19:25:59,2544,42599,45143,25,31,56
1,201392386,2170660915,6350,36895,2024-10-04 19:25:59,0,0,0,0,0,0
1,201392386,2170660915,5839,36895,2024-10-04 19:25:59,0,0,0,0,0,0
1,201392386,2170660915,0,0,2024-10-04 19:25:59,0,0,0,0,0,0
1,201392386,2170660915,37534,36895,2024-10-04 19:25:59,0,0,0,0,0,0
1,201392386,2170660915,57029,36895,2024-10-04 19:26:00,0,0,0,0,0,0
1,201392386,1145490691,30942,47873,2024-10-04 19:26:00,0,0,0,0,0,0
1,201392386,2170660915,6350,36895,2024-10-04 19:26:00,0,0,0,0,0,0
1,201392386,2170660915,5839,36895,2024-10-04 19:26:00,0,0,0,0,0,0
1,201392386,2170660915,0,0,2024-10-04 19:26:00,0,0,0,0,0,0
1,201392386,2170660915,37534,36895,2024-10-04 19:26:00,0,0,0,0,0,0
1,201392386,2170660915,57029,36895,2024-10-04 19:26:01,0,0,0,0,0,0
1,201392386,1145490691,30942,47873,2024-10-04 19:26:01,0,0,0,0,0,0
1,201392386,2170660915,6350,36895,2024-10-04 19:26:01,0,0,0,0,0,0
1,201392386,2170660915,5839,36895,2024-10-04 19:26:01,0,0,0,0,0,0
1,201392386,2170660915,0,0,2024-10-04 19:26:01,128,84,212,1,1,2
1,201392386,2170660915,37534,36895,2024-10-04 19:26:01,0,0,0,0,0,0
1,201392386,2170660915,57029,36895,2024-10-04 19:26:02,0,0,0,0,0,0
1,201392386,1145490691,30942,47873,2024-10-04 19:26:02,0,0,0,0,0,0
1,201392386,2170660915,6350,36895,2024-10-04 19:26:02,0,0,0,0,0,0
1,201392386,2170660915,5839,36895,2024-10-04 19:26:02,0,0,0,0,0,0
1,201392386,2170660915,0,0,2024-10-04 19:26:02,128,84,212,1,1,2
1,201392386,2170660915,37534,36895,2024-10-04 19:26:02,0,0,0,0,0,0
1,201392386,2170660915,57029,36895,2024-10-04 19:26:03,0,0,0,0,0,0
1,201392386,1145490691,30942,47873,2024-10-04 19:26:03,0,0,0,0,0,0
1,201392386,2170660915,6350,36895,2024-10-04 19:26:03,0,0,0,0,0,0
1,201392386,2170660915,5839,36895,2024-10-04 19:26:03,0,0,0,0,0,0
1,201392386,2170660915,0,0,2024-10-04 19:26:03,128,84,212,1,1,2
1,201392386,2170660915,37534,36895,2024-10-04 19:26:03,0,0,0,0,0,0
1,201392386,2170660915,57029,36895,2024-10-04 19:26:04,0,0,0,0,0,0
1,201392386,1145490691,30942,47873,2024-10-04 19:26:04,0,0,0,0,0,0
1,201392386,2170660915,6350,36895,2024-10-04 19:26:04,0,0,0,0,0,0
1,201392386,2170660915,5839,36895,2024-10-04 19:26:04,0,0,0,0,0,0
1,201392386,2170660915,0,0,2024-10-04 19:26:04,128,84,212,1,1,2
1,201392386,2170660915,37534,36895,2024-10-04 19:26:04,0,0,0,0,0,0
1,201392386,2170660915,57029,36895,2024-10-04 19:26:05,0,0,0,0,0,0
1,201392386,1145490691,30942,47873,2024-10-04 19:26:05,0,0,0,0,0,0
1,201392386,2170660915,6350,36895,2024-10-04 19:26:05,0,0,0,0,0,0
1,201392386,2170660915,5839,36895,2024-10-04 19:26:05,0,0,0,0,0,0
1,201392386,2170660915,0,0,2024-10-04 19:26:05,128,84,212,1,1,2
1,201392386,2170660915,37534,36895,2024-10-04 19:26:05,0,0,0,0,0,0
1,201392386,2170660915,57029,36895,2024-10-04 19:26:06,0,0,0,0,0,0
1,201392386,1145490691,30942,47873,2024-10-04 19:26:06,0,0,0,0,0,0
1,201392386,2170660915,6350,36895,2024-10-04 19:26:06,0,0,0,0,0,0
1,201392386,2170660915,5839,36895,2024-10-04 19:26:06,0,0,0,0,0,0
1,201392386,2170660915,0,0,2024-10-04 19:26:06,128,84,212,1,1,2
1,201392386,2170660915,37534,36895,2024-10-04 19:26:06,0,0,0,0,0,0
1,201392386,2170660915,57029,36895,2024-10-04 19:26:07,0,0,0,0,0,0
1,201392386,1145490691,30942,47873,2024-10-04 19:26:07,0,0,0,0,0,0
1,201392386,2170660915,6350,36895,2024-10-04 19:26:07,0,0,0,0,0,0
1,201392386,2170660915,5839,36895,2024-10-04 19:26:07,0,0,0,0,0,0
1,201392386,2170660915,0,0,2024-10-04 19:26:07,128,84,212,1,1,2
1,201392386,2170660915,37534,36895,2024-10-04 19:26:07,0,0,0,0,0,0
1,201392386,2170660915,57029,36895,2024-10-04 19:26:08,0,0,0,0,0,0
1,201392386,1145490691,30942,47873,2024-10-04 19:26:08,0,0,0,0,0,0
1,201392386,2170660915,6350,36895,2024-10-04 19:26:08,0,0,0,0,0,0
1,201392386,2170660915,5839,36895,2024-10-04 19:26:08,0,0,0,0,0,0
1,201392386,2170660915,0,0,2024-10-04 19:26:08,128,84,212,1,1,2
1,201392386,2170660915,37534,36895,2024-10-04 19:26:08,0,0,0,0,0,0
1,201392386,2170660915,57029,36895,2024-10-04 19:26:09,0,0,0,0,0,0
1,201392386,2170660915,6350,36895,2024-10-04 19:26:09,0,0,0,0,0,0
1,201392386,2170660915,5839,36895,2024-10-04 19:26:09,0,0,0,0,0,0
1,201392386,2170660915,0,0,2024-10-04 19:26:09,128,84,212,1,1,2
1,201392386,2170660915,37534,36895,2024-10-04 19:26:09,0,0,0,0,0,0
1,201392386,2170660915,57029,36895,2024-10-04 19:26:10,0,0,0,0,0,0
1,201392386,2170660915,5839,36895,2024-10-04 19:26:10,0,0,0,0,0,0
1,201392386,2170660915,0,0,2024-10-04 19:26:10,128,0,128,1,0,1
1,201392386,2170660915,37534,36895,2024-10-04 19:26:10,0,0,0,0,0,0
1,201392386,2170660915,57029,36895,2024-10-04 19:26:11,0,0,0,0,0,0
1,201392386,2170660915,5839,36895,2024-10-04 19:26:11,0,0,0,0,0,0
1,201392386,2170660915,0,0,2024-10-04 19:26:11,0,84,84,0,1,1
1,201392386,2170660915,37534,36895,2024-10-04 19:26:11,0,0,0,0,0,0
1,201392386,2170660915,57029,36895,2024-10-04 19:26:12,0,0,0,0,0,0
1,201392386,2170660915,5839,36895,2024-10-04 19:26:12,0,0,0,0,0,0
1,201392386,2170660915,0,0,2024-10-04 19:26:12,0,0,0,0,0,0
1,201392386,2170660915,37534,36895,2024-10-04 19:26:12,0,0,0,0,0,0
1,201392386,2170660915,33987,36895,2024-10-04 19:26:12,666,507,1173,6,6,12
1,201392386,2170660915,57029,36895,2024-10-04 19:26:13,0,0,0,0,0,0
1,201392386,2170660915,5839,36895,2024-10-04 19:26:13,0,0,0,0,0,0
1,201392386,2170660915,0,0,2024-10-04 19:26:13,0,0,0,0,0,0
1,201392386,2170660915,37534,36895,2024-10-04 19:26:13,0,0,0,0,0,0
1,201392386,2170660915,33987,36895,2024-10-04 19:26:13,0,0,0,0,0,0
1,201392386,2170660915,57029,36895,2024-10-04 19:26:14,0,0,0,0,0,0
1,201392386,2170660915,5839,36895,2024-10-04 19:26:14,0,0,0,0,0,0
1,201392386,2170660915,0,0,2024-10-04 19:26:14,256,84,340,2,1,3
1,201392386,2170660915,37534,36895,2024-10-04 19:26:14,0,0,0,0,0,0
1,201392386,2170660915,33987,36895,2024-10-04 19:26:14,0,0,0,0,0,0
1,201392386,2170660915,57029,36895,2024-10-04 19:26:15,0,0,0,0,0,0
1,201392386,2170660915,5839,36895,2024-10-04 19:26:15,0,0,0,0,0,0
1,201392386,2170660915,0,0,2024-10-04 19:26:15,128,84,212,1,1,2
1,201392386,2170660915,37534,36895,2024-10-04 19:26:15,0,0,0,0,0,0
1,201392386,2170660915,33987,36895,2024-10-04 19:26:15,0,0,0,0,0,0
1,201392386,2170660915,57029,36895,2024-10-04 19:26:16,0,0,0,0,0,0
1,201392386,2170660915,5839,36895,2024-10-04 19:26:16,0,0,0,0,0,0
1,201392386,2170660915,0,0,2024-10-04 19:26:16,0,84,84,0,1,1
1,201392386,2170660915,37534,36895,2024-10-04 19:26:16,0,0,0,0,0,0
1,201392386,2170660915,33987,36895,2024-10-04 19:26:16,0,0,0,0,0,0
1,201392386,2170660915,57029,36895,2024-10-04 19:26:17,0,0,0,0,0,0
1,201392386,2170660915,5839,36895,2024-10-04 19:26:17,0,0,0,0,0,0
1,201392386,2170660915,0,0,2024-10-04 19:26:17,0,0,0,0,0,0
1,201392386,2170660915,37534,36895,2024-10-04 19:26:17,0,0,0,0,0,0
1,201392386,2170660915,33987,36895,2024-10-04 19:26:17,0,0,0,0,0,0
1,201392386,2170660915,57029,36895,2024-10-04 19:26:18,0,0,0,0,0,0
1,201392386,2170660915,5839,36895,2024-10-04 19:26:18,0,0,0,0,0,0
1,201392386,2170660915,0,0,2024-10-04 19:26:18,0,0,0,0,0,0
1,201392386,2170660915,37534,36895,2024-10-04 19:26:18,0,0,0,0,0,0
1,201392386,2170660915,33987,36895,2024-10-04 19:26:18,0,0,0,0,0,0
1,201392386,2170660915,57029,36895,2024-10-04 19:26:19,0,0,0,0,0,0
1,201392386,2170660915,5839,36895,2024-10-04 19:26:19,0,0,0,0,0,0
1,201392386,2170660915,0,0,2024-10-04 19:26:19,256,84,340,2,1,3
1,201392386,2170660915,37534,36895,2024-10-04 19:26:19,0,0,0,0,0,0
1,201392386,2170660915,33987,36895,2024-10-04 19:26:19,0,0,0,0,0,0
1,201392386,2170660915,57029,36895,2024-10-04 19:26:20,0,0,0,0,0,0
1,201392386,2170660915,5839,36895,2024-10-04 19:26:20,0,0,0,0,0,0
1,201392386,2170660915,0,0,2024-10-04 19:26:20,0,84,84,0,1,1
1,201392386,2170660915,37534,36895,2024-10-04 19:26:20,0,0,0,0,0,0
1,201392386,2170660915,33987,36895,2024-10-04 19:26:20,0,0,0,0,0,0
1,201392386,2170660915,57029,36895,2024-10-04 19:26:21,0,0,0,0,0,0
1,201392386,1145490689,42682,47873,2024-10-04 19:26:21,4104,55231,59335,32,45,77
1,201392386,2170660915,5839,36895,2024-10-04 19:26:21,0,0,0,0,0,0
1,201392386,2170660915,0,0,2024-10-04 19:26:21,128,84,212,1,1,2
1,201392386,2170660915,37534,36895,2024-10-04 19:26:21,0,0,0,0,0,0
1,201392386,2170660915,33987,36895,2024-10-04 19:26:21,0,0,0,0,0,0
1,201392386,2170660915,57029,36895,2024-10-04 19:26:22,0,0,0,0,0,0
1,201392386,1145490689,42682,47873,2024-10-04 19:26:22,0,0,0,0,0,0
1,201392386,2170660915,5839,36895,2024-10-04 19:26:22,0,0,0,0,0,0
1,201392386,2170660915,0,0,2024-10-04 19:26:22,0,0,0,0,0,0
1,201392386,2170660915,37534,36895,2024-10-04 19:26:22,0,0,0,0,0,0
1,201392386,2170660915,33987,36895,2024-10-04 19:26:22,0,0,0,0,0,0
1,201392386,2170660915,57029,36895,2024-10-04 19:26:23,0,0,0,0,0,0
1,201392386,1145490689,42682,47873,2024-10-04 19:26:23,0,0,0,0,0,0
1,201392386,2170660915,5839,36895,2024-10-04 19:26:23,0,0,0,0,0,0
1,201392386,2170660915,0,0,2024-10-04 19:26:23,0,0,0,0,0,0
1,201392386,2170660915,37534,36895,2024-10-04 19:26:23,0,0,0,0,0,0
1,201392386,2170660915,33987,36895,2024-10-04 19:26:23,0,0,0,0,0,0
1,201392386,2170660915,57029,36895,2024-10-04 19:26:24,0,0,0,0,0,0
1,201392386,1145490689,42682,47873,2024-10-04 19:26:24,0,0,0,0,0,0
1,201392386,2170660915,5839,36895,2024-10-04 19:26:24,0,0,0,0,0,0
1,201392386,2170660915,0,0,2024-10-04 19:26:24,0,0,0,0,0,0
1,201392386,2170660915,37534,36895,2024-10-04 19:26:24,0,0,0,0,0,0
1,201392386,2170660915,33987,36895,2024-10-04 19:26:24,0,0,0,0,0,0
1,201392386,2170660915,57029,36895,2024-10-04 19:26:25,0,0,0,0,0,0
1,201392386,1145490689,42682,47873,2024-10-04 19:26:25,0,0,0,0,0,0
1,201392386,2170660915,5839,36895,2024-10-04 19:26:25,0,0,0,0,0,0
1,201392386,2170660915,0,0,2024-10-04 19:26:25,0,0,0,0,0,0
1,201392386,2170660915,37534,36895,2024-10-04 19:26:25,0,0,0,0,0,0
1,201392386,2170660915,33987,36895,2024-10-04 19:26:25,0,0,0,0,0,0
1,201392386,2170660915,57029,36895,2024-10-04 19:26:26,0,0,0,0,0,0
1,201392386,1145490689,42682,47873,2024-10-04 19:26:26,0,0,0,0,0,0
1,201392386,2170660915,5839,36895,2024-10-04 19:26:26,0,0,0,0,0,0
1,201392386,2170660915,0,0,2024-10-04 19:26:26,0,0,0,0,0,0
1,201392386,2170660915,37534,36895,2024-10-04 19:26:26,0,0,0,0,0,0
1,201392386,2170660915,33987,36895,2024-10-04 19:26:26,0,0,0,0,0,0
1,201392386,2170660915,57029,36895,2024-10-04 19:26:27,0,0,0,0,0,0
1,201392386,1145490689,42682,47873,2024-10-04 19:26:27,0,0,0,0,0,0
1,201392386,2170660915,5839,36895,2024-10-04 19:26:27,0,0,0,0,0,0
1,201392386,2170660915,0,0,2024-10-04 19:26:27,0,0,0,0,0,0
1,201392386,2170660915,37534,36895,2024-10-04 19:26:27,0,0,0,0,0,0
1,201392386,2170660915,33987,36895,2024-10-04 19:26:27,0,0,0,0,0,0
1,201392386,2170660915,57029,36895,2024-10-04 19:26:28,0,0,0,0,0,0
1,201392386,1145490689,42682,47873,2024-10-04 19:26:28,0,0,0,0,0,0
1,201392386,2170660915,5839,36895,2024-10-04 19:26:28,0,0,0,0,0,0
1,201392386,2170660915,0,0,2024-10-04 19:26:28,0,0,0,0,0,0
1,201392386,2170660915,37534,36895,2024-10-04 19:26:28,0,0,0,0,0,0
1,201392386,2170660915,33987,36895,2024-10-04 19:26:28,0,0,0,0,0,0
1,201392386,2170660915,57029,36895,2024-10-04 19:26:29,0,0,0,0,0,0
1,201392386,1145490689,42682,47873,2024-10-04 19:26:29,0,0,0,0,0,0
1,201392386,2170660915,5839,36895,2024-10-04 19:26:29,0,0,0,0,0,0
1,201392386,2170660915,0,0,2024-10-04 19:26:29,0,0,0,0,0,0
1,201392386,2170660915,37534,36895,2024-10-04 19:26:29,0,0,0,0,0,0
1,201392386,2170660915,33987,36895,2024-10-04 19:26:29,0,0,0,0,0,0
1,201392386,2170660915,57029,36895,2024-10-04 19:26:30,0,0,0,0,0,0
1,201392386,1145490689,42682,47873,2024-10-04 19:26:30,2448,43967,46415,24,31,55
1,201392386,2170660915,5839,36895,2024-10-04 19:26:30,0,0,0,0,0,0
1,201392386,2170660915,0,0,2024-10-04 19:26:30,0,0,0,0,0,0
1,201392386,2170660915,37534,36895,2024-10-04 19:26:30,0,0,0,0,0,0
1,201392386,2170660915,33987,36895,2024-10-04 19:26:30,0,0,0,0,0,0
1,201392386,2170660915,57029,36895,2024-10-04 19:26:31,0,0,0,0,0,0
1,201392386,1145490689,42682,47873,2024-10-04 19:26:31,0,0,0,0,0,0
1,201392386,2170660915,5839,36895,2024-10-04 19:26:31,0,0,0,0,0,0
1,201392386,2170660915,0,0,2024-10-04 19:26:31,0,0,0,0,0,0
1,201392386,2170660915,37534,36895,2024-10-04 19:26:31,0,0,0,0,0,0
1,201392386,2170660915,33987,36895,2024-10-04 19:26:31,0,0,0,0,0,0
1,201392386,2170660915,57029,36895,2024-10-04 19:26:32,0,0,0,0,0,0
1,201392386,1145490689,42682,47873,2024-10-04 19:26:32,0,0,0,0,0,0
1,201392386,2170660915,5839,36895,2024-10-04 19:26:32,0,0,0,0,0,0
1,201392386,2170660915,0,0,2024-10-04 19:26:32,128,0,128,1,0,1
1,201392386,2170660915,37534,36895,2024-10-04 19:26:32,0,0,0,0,0,0
1,201392386,2170660915,33987,36895,2024-10-04 19:26:32,0,0,0,0,0,0
1,201392386,2170660915,57029,36895,2024-10-04 19:26:33,0,0,0,0,0,0
1,201392386,1145490689,42682,47873,2024-10-04 19:26:33,0,0,0,0,0,0
1,201392386,2170660915,5839,36895,2024-10-04 19:26:33,0,0,0,0,0,0
1,201392386,2170660915,0,0,2024-10-04 19:26:33,128,84,212,1,1,2
1,201392386,2170660915,37534,36895,2024-10-04 19:26:33,0,0,0,0,0,0
1,201392386,2170660915,33987,36895,2024-10-04 19:26:33,0,0,0,0,0,0
1,201392386,2170660915,57029,36895,2024-10-04 19:26:34,0,0,0,0,0,0
1,201392386,1145490689,42682,47873,2024-10-04 19:26:34,0,0,0,0,0,0
1,201392386,2170660915,5839,36895,2024-10-04 19:26:34,0,0,0,0,0,0
1,201392386,2170660915,0,0,2024-10-04 19:26:34,128,84,212,1,1,2
1,201392386,2170660915,37534,36895,2024-10-04 19:26:34,0,0,0,0,0,0
1,201392386,2170660915,33987,36895,2024-10-04 19:26:34,0,0,0,0,0,0
1,201392386,2170660915,57029,36895,2024-10-04 19:26:35,0,0,0,0,0,0
1,201392386,1145490689,42682,47873,2024-10-04 19:26:35,0,0,0,0,0,0
1,201392386,2170660915,5839,36895,2024-10-04 19:26:35,0,0,0,0,0,0
1,201392386,2170660915,0,0,2024-10-04 19:26:35,128,84,212,1,1,2
1,201392386,2170660915,37534,36895,2024-10-04 19:26:35,0,0,0,0,0,0
1,201392386,2170660915,33987,36895,2024-10-04 19:26:35,0,0,0,0,0,0
1,201392386,2170660915,57029,36895,2024-10-04 19:26:36,0,0,0,0,0,0
1,201392386,1145490689,42682,47873,2024-10-04 19:26:36,0,0,0,0,0,0
1,201392386,2170660915,5839,36895,2024-10-04 19:26:36,0,0,0,0,0,0
1,201392386,2170660915,0,0,2024-10-04 19:26:36,128,84,212,1,1,2
1,201392386,2170660915,37534,36895,2024-10-04 19:26:36,0,0,0,0,0,0
1,201392386,2170660915,33987,36895,2024-10-04 19:26:36,0,0,0,0,0,0
1,201392386,2170660915,57029,36895,2024-10-04 19:26:37,0,0,0,0,0,0
1,201392386,1145490689,42682,47873,2024-10-04 19:26:37,0,0,0,0,0,0
1,201392386,2170660915,5839,36895,2024-10-04 19:26:37,0,0,0,0,0,0
1,201392386,2170660915,0,0,2024-10-04 19:26:37,128,84,212,1,1,2
1,201392386,2170660915,37534,36895,2024-10-04 19:26:37,0,0,0,0,0,0
1,201392386,2170660915,33987,36895,2024-10-04 19:26:37,0,0,0,0,0,0
1,201392386,2170660915,57029,36895,2024-10-04 19:26:38,0,0,0,0,0,0
1,201392386,1145490689,42682,47873,2024-10-04 19:26:38,0,0,0,0,0,0
1,201392386,2170660915,5839,36895,2024-10-04 19:26:38,0,0,0,0,0,0
1,201392386,2170660915,0,0,2024-10-04 19:26:38,128,84,212,1,1,2
1,201392386,2170660915,37534,36895,2024-10-04 19:26:38,0,0,0,0,0,0
1,201392386,2170660915,33987,36895,2024-10-04 19:26:38,0,0,0,0,0,0
1,201392386,2170660915,57029,36895,2024-10-04 19:26:39,0,0,0,0,0,0
1,201392386,1145490689,42682,47873,2024-10-04 19:26:39,0,0,0,0,0,0
1,201392386,2170660915,5839,36895,2024-10-04 19:26:39,0,0,0,0,0,0
1,201392386,2170660915,0,0,2024-10-04 19:26:39,128,84,212,1,1,2
1,201392386,2170660915,37534,36895,2024-10-04 19:26:39,0,0,0,0,0,0
1,201392386,2170660915,33987,36895,2024-10-04 19:26:39,0,0,0,0,0,0
1,201392386,2170660915,57029,36895,2024-10-04 19:26:40,0,0,0,0,0,0
1,201392386,2170660915,5839,36895,2024-10-04 19:26:40,0,0,0,0,0,0
1,201392386,2170660915,0,0,2024-10-04 19:26:40,128,168,296,1,2,3
1,201392386,2170660915,37534,36895,2024-10-04 19:26:40,0,0,0,0,0,0
1,201392386,2170660915,33987,36895,2024-10-04 19:26:40,0,0,0,0,0,0
1,201392386,2170660915,57029,36895,2024-10-04 19:26:41,0,0,0,0,0,0
1,201392386,2170660915,5839,36895,2024-10-04 19:26:41,0,0,0,0,0,0
1,201392386,2170660915,0,0,2024-10-04 19:26:41,128,84,212,1,1,2
1,201392386,2170660915,37534,36895,2024-10-04 19:26:41,0,0,0,0,0,0
1,201392386,2170660915,33987,36895,2024-10-04 19:26:41,0,0,0,0,0,0
1,201392386,2170660915,57029,36895,2024-10-04 19:26:42,0,0,0,0,0,0
1,201392386,2170660915,5839,36895,2024-10-04 19:26:42,0,0,0,0,0,0
1,201392386,2170660915,0,0,2024-10-04 19:26:42,0,0,0,0,0,0
1,201392386,2170660915,37534,36895,2024-10-04 19:26:42,0,0,0,0,0,0
1,201392386,2170660915,57029,36895,2024-10-04 19:26:43,0,0,0,0,0,0
1,201392386,2170660915,5839,36895,2024-10-04 19:26:43,0,0,0,0,0,0
1,201392386,2170660915,0,0,2024-10-04 19:26:43,0,0,0,0,0,0
1,201392386,2170660915,32418,36895,2024-10-04 19:26:43,678,507,1185,6,6,12
1,201392386,2170660915,37534,36895,2024-10-04 19:26:43,0,0,0,0,0,0
1,201392386,2170660915,57029,36895,2024-10-04 19:26:44,0,0,0,0,0,0
1,201392386,2170660915,5839,36895,2024-10-04 19:26:44,0,0,0,0,0,0
1,201392386,2170660915,0,0,2024-10-04 19:26:44,0,0,0,0,0,0
1,201392386,2170660915,32418,36895,2024-10-04 19:26:44,0,0,0,0,0,0
1,201392386,2170660915,37534,36895,2024-10-04 19:26:44,0,0,0,0,0,0
1,201392386,2170660915,57029,36895,2024-10-04 19:26:45,0,0,0,0,0,0
1,201392386,2170660915,5839,36895,2024-10-04 19:26:45,0,0,0,0,0,0
1,201392386,2170660915,0,0,2024-10-04 19:26:45,256,84,340,2,1,3
1,201392386,2170660915,32418,36895,2024-10-04 19:26:45,0,0,0,0,0,0
1,201392386,2170660915,37534,36895,2024-10-04 19:26:45,0,0,0,0,0,0
1,201392386,2170660915,57029,36895,2024-10-04 19:26:46,0,0,0,0,0,0
1,201392386,2170660915,5839,36895,2024-10-04 19:26:46,0,0,0,0,0,0
1,201392386,2170660915,0,0,2024-10-04 19:26:46,128,84,212,1,1,2
1,201392386,2170660915,32418,36895,2024-10-04 19:26:46,0,0,0,0,0,0
1,201392386,2170660915,37534,36895,2024-10-04 19:26:46,0,0,0,0,0,0
1,201392386,2170660915,57029,36895,2024-10-04 19:26:47,0,0,0,0,0,0
1,201392386,2170660915,5839,36895,2024-10-04 19:26:47,0,0,0,0,0,0
1,201392386,2170660915,0,0,2024-10-04 19:26:47,0,84,84,0,1,1
1,201392386,2170660915,32418,36895,2024-10-04 19:26:47,0,0,0,0,0,0
1,201392386,2170660915,37534,36895,2024-10-04 19:26:47,0,0,0,0,0,0
1,201392386,2170660915,57029,36895,2024-10-04 19:26:48,0,0,0,0,0,0
1,201392386,2170660915,5839,36895,2024-10-04 19:26:48,0,0,0,0,0,0
1,201392386,2170660915,0,0,2024-10-04 19:26:48,0,0,0,0,0,0
1,201392386,2170660915,32418,36895,2024-10-04 19:26:48,0,0,0,0,0,0
1,201392386,2170660915,37534,36895,2024-10-04 19:26:48,0,0,0,0,0,0
1,201392386,2170660915,57029,36895,2024-10-04 19:26:49,0,0,0,0,0,0
1,201392386,2170660915,5839,36895,2024-10-04 19:26:49,0,0,0,0,0,0
1,201392386,2170660915,0,0,2024-10-04 19:26:49,128,84,212,1,1,2
1,201392386,2170660915,32418,36895,2024-10-04 19:26:49,0,0,0,0,0,0
1,201392386,2170660915,37534,36895,2024-10-04 19:26:49,0,0,0,0,0,0
1,201392386,2170660915,57029,36895,2024-10-04 19:26:50,0,0,0,0,0,0
1,201392386,2170660915,5839,36895,2024-10-04 19:26:50,0,0,0,0,0,0
1,201392386,2170660915,0,0,2024-10-04 19:26:50,128,84,212,1,1,2
1,201392386,2170660915,32418,36895,2024-10-04 19:26:50,0,0,0,0,0,0
1,201392386,2170660915,37534,36895,2024-10-04 19:26:50,0,0,0,0,0,0
1,201392386,2170660915,57029,36895,2024-10-04 19:26:51,0,0,0,0,0,0
1,201392386,2170660915,5839,36895,2024-10-04 19:26:51,0,0,0,0,0,0
1,201392386,2170660915,0,0,2024-10-04 19:26:51,128,84,212,1,1,2
1,201392386,1145490689,18657,47873,2024-10-04 19:26:51,104,0,104,1,0,1
1,201392386,2170660915,37534,36895,2024-10-04 19:26:51,0,0,0,0,0,0
1,201392386,2170660915,57029,36895,2024-10-04 19:26:52,0,0,0,0,0,0
1,201392386,2170660915,5839,36895,2024-10-04 19:26:52,0,0,0,0,0,0
1,201392386,2170660915,0,0,2024-10-04 19:26:52,0,0,0,0,0,0
1,201392386,1145490689,18657,47873,2024-10-04 19:26:52,3232,45979,49211,24,39,63
1,201392386,2170660915,37534,36895,2024-10-04 19:26:52,0,0,0,0,0,0
1,201392386,2170660915,57029,36895,2024-10-04 19:26:53,0,0,0,0,0,0
1,201392386,2170660915,5839,36895,2024-10-04 19:26:53,0,0,0,0,0,0
1,201392386,2170660915,0,0,2024-10-04 19:26:53,0,0,0,0,0,0
1,201392386,1145490689,18657,47873,2024-10-04 19:26:53,0,0,0,0,0,0
1,201392386,2170660915,37534,36895,2024-10-04 19:26:53,0,0,0,0,0,0
1,201392386,2170660915,57029,36895,2024-10-04 19:26:54,0,0,0,0,0,0
1,201392386,2170660915,5839,36895,2024-10-04 19:26:54,0,0,0,0,0,0
1,201392386,2170660915,0,0,2024-10-04 19:26:54,0,0,0,0,0,0
1,201392386,1145490689,18657,47873,2024-10-04 19:26:54,0,0,0,0,0,0
1,201392386,2170660915,37534,36895,2024-10-04 19:26:54,0,0,0,0,0,0
1,201392386,2170660915,57029,36895,2024-10-04 19:26:55,0,0,0,0,0,0
1,201392386,2170660915,5839,36895,2024-10-04 19:26:55,0,0,0,0,0,0
1,201392386,2170660915,0,0,2024-10-04 19:26:55,0,0,0,0,0,0
1,201392386,1145490689,18657,47873,2024-10-04 19:26:55,0,0,0,0,0,0
1,201392386,2170660915,37534,36895,2024-10-04 19:26:55,0,0,0,0,0,0
1,201392386,2170660915,57029,36895,2024-10-04 19:26:56,0,0,0,0,0,0
1,201392386,2170660915,5839,36895,2024-10-04 19:26:56,0,0,0,0,0,0
1,201392386,2170660915,0,0,2024-10-04 19:26:56,0,0,0,0,0,0
1,201392386,1145490689,18657,47873,2024-10-04 19:26:56,0,0,0,0,0,0
1,201392386,2170660915,37534,36895,2024-10-04 19:26:56,0,0,0,0,0,0
1,201392386,2170660915,57029,36895,2024-10-04 19:26:57,0,0,0,0,0,0
1,201392386,2170660915,5839,36895,2024-10-04 19:26:57,0,0,0,0,0,0
1,201392386,2170660915,0,0,2024-10-04 19:26:57,0,0,0,0,0,0
1,201392386,1145490689,18657,47873,2024-10-04 19:26:57,0,0,0,0,0,0
1,201392386,2170660915,37534,36895,2024-10-04 19:26:57,0,0,0,0,0,0
1,201392386,2170660915,57029,36895,2024-10-04 19:26:58,0,0,0,0,0,0
1,201392386,2170660915,5839,36895,2024-10-04 19:26:58,0,0,0,0,0,0
1,201392386,2170660915,0,0,2024-10-04 19:26:58,0,0,0,0,0,0
1,201392386,1145490689,18657,47873,2024-10-04 19:26:58,0,0,0,0,0,0
1,201392386,2170660915,37534,36895,2024-10-04 19:26:58,0,0,0,0,0,0
1,201392386,2170660915,57029,36895,2024-10-04 19:26:59,0,0,0,0,0,0
1,201392386,2170660915,5839,36895,2024-10-04 19:26:59,0,0,0,0,0,0
1,201392386,2170660915,0,0,2024-10-04 19:26:59,0,0,0,0,0,0
1,201392386,1145490689,18657,47873,2024-10-04 19:26:59,0,0,0,0,0,0
1,201392386,2170660915,37534,36895,2024-10-04 19:26:59,0,0,0,0,0,0
1,201392386,2170660915,57029,36895,2024-10-04 19:27:00,0,0,0,0,0,0
1,201392386,2170660915,5839,36895,2024-10-04 19:27:00,0,0,0,0,0,0
1,201392386,2170660915,0,0,2024-10-04 19:27:00,0,0,0,0,0,0
1,201392386,1145490689,18657,47873,2024-10-04 19:27:00,0,0,0,0,0,0
1,201392386,2170660915,37534,36895,2024-10-04 19:27:00,0,0,0,0,0,0
1,201392386,2170660915,57029,36895,2024-10-04 19:27:01,0,0,0,0,0,0
1,201392386,2170660915,5839,36895,2024-10-04 19:27:01,0,0,0,0,0,0
1,201392386,2170660915,0,0,2024-10-04 19:27:01,0,0,0,0,0,0
1,201392386,1145490689,18657,47873,2024-10-04 19:27:01,2856,57413,60269,28,41,69
1,201392386,2170660915,37534,36895,2024-10-04 19:27:01,0,0,0,0,0,0
1,201392386,2170660915,57029,36895,2024-10-04 19:27:02,0,0,0,0,0,0
1,201392386,2170660915,5839,36895,2024-10-04 19:27:02,0,0,0,0,0,0
1,201392386,2170660915,0,0,2024-10-04 19:27:02,0,0,0,0,0,0
1,201392386,1145490689,18657,47873,2024-10-04 19:27:02,0,0,0,0,0,0
1,201392386,2170660915,37534,36895,2024-10-04 19:27:02,0,0,0,0,0,0
1,201392386,2170660915,57029,36895,2024-10-04 19:27:03,0,0,0,0,0,0
1,201392386,2170660915,5839,36895,2024-10-04 19:27:03,0,0,0,0,0,0
1,201392386,2170660915,0,0,2024-10-04 19:27:03,0,0,0,0,0,0
1,201392386,1145490689,18657,47873,2024-10-04 19:27:03,0,0,0,0,0,0
1,201392386,2170660915,37534,36895,2024-10-04 19:27:03,0,0,0,0,0,0
1,201392386,2170660915,57029,36895,2024-10-04 19:27:04,0,0,0,0,0,0
1,201392386,2170660915,5839,36895,2024-10-04 19:27:04,0,0,0,0,0,0
1,201392386,2170660915,0,0,2024-10-04 19:27:04,128,84,212,1,1,2
1,201392386,1145490689,18657,47873,2024-10-04 19:27:04,0,0,0,0,0,0
1,201392386,2170660915,37534,36895,2024-10-04 19:27:04,0,0,0,0,0,0
1,201392386,2170660915,57029,36895,2024-10-04 19:27:05,0,0,0,0,0,0
1,201392386,2170660915,5839,36895,2024-10-04 19:27:05,0,0,0,0,0,0
1,201392386,2170660915,0,0,2024-10-04 19:27:05,128,84,212,1,1,2
1,201392386,1145490689,18657,47873,2024-10-04 19:27:05,0,0,0,0,0,0
1,201392386,2170660915,37534,36895,2024-10-04 19:27:05,0,0,0,0,0,0
1,201392386,2170660915,57029,36895,2024-10-04 19:27:06,0,0,0,0,0,0
1,201392386,2170660915,5839,36895,2024-10-04 19:27:06,0,0,0,0,0,0
1,201392386,2170660915,0,0,2024-10-04 19:27:06,128,84,212,1,1,2
1,201392386,1145490689,18657,47873,2024-10-04 19:27:06,0,0,0,0,0,0
1,201392386,2170660915,37534,36895,2024-10-04 19:27:06,0,0,0,0,0,0
1,201392386,2170660915,57029,36895,2024-10-04 19:27:07,0,0,0,0,0,0
1,201392386,2170660915,5839,36895,2024-10-04 19:27:07,0,0,0,0,0,0
1,201392386,2170660915,0,0,2024-10-04 19:27:07,128,84,212,1,1,2
1,201392386,1145490689,18657,47873,2024-10-04 19:27:07,0,0,0,0,0,0
1,201392386,2170660915,37534,36895,2024-10-04 19:27:07,0,0,0,0,0,0
1,201392386,2170660915,57029,36895,2024-10-04 19:27:08,0,0,0,0,0,0
1,201392386,2170660915,5839,36895,2024-10-04 19:27:08,0,0,0,0,0,0
1,201392386,2170660915,0,0,2024-10-04 19:27:08,128,84,212,1,1,2
1,201392386,1145490689,18657,47873,2024-10-04 19:27:08,0,0,0,0,0,0
1,201392386,2170660915,37534,36895,2024-10-04 19:27:08,0,0,0,0,0,0
1,201392386,2170660915,57029,36895,2024-10-04 19:27:09,0,0,0,0,0,0
1,201392386,2170660915,5839,36895,2024-10-04 19:27:09,0,0,0,0,0,0
1,201392386,2170660915,0,0,2024-10-04 19:27:09,128,84,212,1,1,2
1,201392386,1145490689,18657,47873,2024-10-04 19:27:09,0,0,0,0,0,0
1,201392386,2170660915,37534,36895,2024-10-04 19:27:09,0,0,0,0,0,0
1,201392386,2170660915,57029,36895,2024-10-04 19:27:10,0,0,0,0,0,0
1,201392386,2170660915,5839,36895,2024-10-04 19:27:10,0,0,0,0,0,0
1,201392386,2170660915,0,0,2024-10-04 19:27:10,128,84,212,1,1,2
1,201392386,1145490689,18657,47873,2024-10-04 19:27:10,0,0,0,0,0,0
1,201392386,2170660915,37534,36895,2024-10-04 19:27:10,0,0,0,0,0,0
1,201392386,2170660915,57029,36895,2024-10-04 19:27:11,0,0,0,0,0,0
1,201392386,2170660915,5839,36895,2024-10-04 19:27:11,0,0,0,0,0,0
1,201392386,2170660915,0,0,2024-10-04 19:27:11,256,168,424,2,2,4
1,201392386,2170660915,37534,36895,2024-10-04 19:27:11,0,0,0,0,0,0
1,201392386,2170660915,57029,36895,2024-10-04 19:27:12,0,0,0,0,0,0
1,201392386,2170660915,5839,36895,2024-10-04 19:27:12,0,0,0,0,0,0
1,201392386,2170660915,0,0,2024-10-04 19:27:12,128,0,128,1,0,1
1,201392386,2170660915,37534,36895,2024-10-04 19:27:12,0,0,0,0,0,0
1,201392386,2170660915,57029,36895,2024-10-04 19:27:13,0,0,0,0,0,0
1,201392386,2170660915,5839,36895,2024-10-04 19:27:13,0,0,0,0,0,0
1,201392386,2170660915,0,0,2024-10-04 19:27:13,0,84,84,0,1,1
1,201392386,2170660915,37534,36895,2024-10-04 19:27:13,0,0,0,0,0,0
1,201392386,2170660915,57029,36895,2024-10-04 19:27:14,0,0,0,0,0,0
1,201392386,2170660915,5839,36895,2024-10-04 19:27:14,0,0,0,0,0,0
1,201392386,2170660915,0,0,2024-10-04 19:27:14,0,0,0,0,0,0
1,201392386,2170660915,37534,36895,2024-10-04 19:27:14,0,0,0,0,0,0
1,201392386,2170660915,57029,36895,2024-10-04 19:27:15,0,0,0,0,0,0
1,201392386,2170660915,5839,36895,2024-10-04 19:27:15,0,0,0,0,0,0
1,201392386,2170660915,17052,36895,2024-10-04 19:27:15,666,507,1173,6,6,12
1,201392386,2170660915,0,0,2024-10-04 19:27:15,128,0,128,1,0,1
1,201392386,2170660915,37534,36895,2024-10-04 19:27:15,0,0,0,0,0,0
1,201392386,2170660915,57029,36895,2024-10-04 19:27:16,0,0,0,0,0,0
1,201392386,2170660915,5839,36895,2024-10-04 19:27:16,0,0,0,0,0,0
1,201392386,2170660915,17052,36895,2024-10-04 19:27:16,0,0,0,0,0,0
1,201392386,2170660915,0,0,2024-10-04 19:27:16,128,84,212,1,1,2
1,201392386,2170660915,37534,36895,2024-10-04 19:27:16,0,0,0,0,0,0
1,201392386,2170660915,57029,36895,2024-10-04 19:27:17,0,0,0,0,0,0
1,201392386,2170660915,5839,36895,2024-10-04 19:27:17,0,0,0,0,0,0
1,201392386,2170660915,17052,36895,2024-10-04 19:27:17,0,0,0,0,0,0
1,201392386,2170660915,0,0,2024-10-04 19:27:17,128,84,212,1,1,2
1,201392386,2170660915,37534,36895,2024-10-04 19:27:17,0,0,0,0,0,0
1,201392386,2170660915,57029,36895,2024-10-04 19:27:18,0,0,0,0,0,0
1,201392386,2170660915,5839,36895,2024-10-04 19:27:18,0,0,0,0,0,0
1,201392386,2170660915,17052,36895,2024-10-04 19:27:18,0,0,0,0,0,0
1,201392386,2170660915,0,0,2024-10-04 19:27:18,0,84,84,0,1,1
1,201392386,2170660915,37534,36895,2024-10-04 19:27:18,0,0,0,0,0,0
1,201392386,2170660915,57029,36895,2024-10-04 19:27:19,0,0,0,0,0,0
1,201392386,2170660915,5839,36895,2024-10-04 19:27:19,0,0,0,0,0,0
1,201392386,2170660915,17052,36895,2024-10-04 19:27:19,0,0,0,0,0,0
1,201392386,2170660915,0,0,2024-10-04 19:27:19,0,0,0,0,0,0
1,201392386,2170660915,37534,36895,2024-10-04 19:27:19,0,0,0,0,0,0
1,201392386,2170660915,57029,36895,2024-10-04 19:27:20,0,0,0,0,0,0
1,201392386,2170660915,5839,36895,2024-10-04 19:27:20,0,0,0,0,0,0
1,201392386,2170660915,17052,36895,2024-10-04 19:27:20,0,0,0,0,0,0
1,201392386,2170660915,0,0,2024-10-04 19:27:20,128,0,128,1,0,1
1,201392386,2170660915,37534,36895,2024-10-04 19:27:20,0,0,0,0,0,0
1,201392386,2170660915,57029,36895,2024-10-04 19:27:21,0,0,0,0,0,0
1,201392386,2170660915,5839,36895,2024-10-04 19:27:21,0,0,0,0,0,0
1,201392386,2170660915,17052,36895,2024-10-04 19:27:21,0,0,0,0,0,0
1,201392386,2170660915,0,0,2024-10-04 19:27:21,128,84,212,1,1,2
1,201392386,2170660915,37534,36895,2024-10-04 19:27:21,0,0,0,0,0,0
1,201392386,2170660915,57029,36895,2024-10-04 19:27:22,0,0,0,0,0,0
1,201392386,2170660915,5839,36895,2024-10-04 19:27:22,0,0,0,0,0,0
1,201392386,2170660915,17052,36895,2024-10-04 19:27:22,0,0,0,0,0,0
1,201392386,2170660915,0,0,2024-10-04 19:27:22,128,84,212,1,1,2
1,201392386,2170660915,37534,36895,2024-10-04 19:27:22,0,0,0,0,0,0
1,201392386,2170660915,57029,36895,2024-10-04 19:27:23,0,0,0,0,0,0
1,201392386,2170660915,5839,36895,2024-10-04 19:27:23,0,0,0,0,0,0
1,201392386,1145490692,16066,47873,2024-10-04 19:27:23,5880,91396,97276,50,70,120
1,201392386,2170660915,0,0,2024-10-04 19:27:23,0,84,84,0,1,1
1,201392386,2170660915,37534,36895,2024-10-04 19:27:23,0,0,0,0,0,0
1,201392386,2170660915,57029,36895,2024-10-04 19:27:24,0,0,0,0,0,0
1,201392386,2170660915,5839,36895,2024-10-04 19:27:24,0,0,0,0,0,0
1,201392386,1145490692,16066,47873,2024-10-04 19:27:24,0,0,0,0,0,0
1,201392386,2170660915,0,0,2024-10-04 19:27:24,0,0,0,0,0,0
1,201392386,2170660915,37534,36895,2024-10-04 19:27:24,0,0,0,0,0,0
1,201392386,2170660915,57029,36895,2024-10-04 19:27:25,0,0,0,0,0,0
1,201392386,2170660915,5839,36895,2024-10-04 19:27:25,0,0,0,0,0,0
1,201392386,1145490692,16066,47873,2024-10-04 19:27:25,0,0,0,0,0,0
1,201392386,2170660915,0,0,2024-10-04 19:27:25,0,0,0,0,0,0
1,201392386,2170660915,37534,36895,2024-10-04 19:27:25,0,0,0,0,0,0
1,201392386,2170660915,57029,36895,2024-10-04 19:27:26,0,0,0,0,0,0
1,201392386,2170660915,5839,36895,2024-10-04 19:27:26,0,0,0,0,0,0
1,201392386,1145490692,16066,47873,2024-10-04 19:27:26,0,0,0,0,0,0
1,201392386,2170660915,0,0,2024-10-04 19:27:26,0,0,0,0,0,0
1,201392386,2170660915,37534,36895,2024-10-04 19:27:26,0,0,0,0,0,0
1,201392386,2170660915,57029,36895,2024-10-04 19:27:27,0,0,0,0,0,0
1,201392386,2170660915,5839,36895,2024-10-04 19:27:27,0,0,0,0,0,0
1,201392386,1145490692,16066,47873,2024-10-04 19:27:27,0,0,0,0,0,0
1,201392386,2170660915,0,0,2024-10-04 19:27:27,0,0,0,0,0,0
1,201392386,2170660915,37534,36895,2024-10-04 19:27:27,0,0,0,0,0,0
1,201392386,2170660915,57029,36895,2024-10-04 19:27:28,0,0,0,0,0,0
1,201392386,2170660915,5839,36895,2024-10-04 19:27:28,0,0,0,0,0,0
1,201392386,1145490692,16066,47873,2024-10-04 19:27:28,0,0,0,0,0,0
1,201392386,2170660915,0,0,2024-10-04 19:27:28,0,0,0,0,0,0
1,201392386,2170660915,37534,36895,2024-10-04 19:27:28,0,0,0,0,0,0
1,201392386,2170660915,57029,36895,2024-10-04 19:27:29,0,0,0,0,0,0
1,201392386,2170660915,5839,36895,2024-10-04 19:27:29,0,0,0,0,0,0
1,201392386,1145490692,16066,47873,2024-10-04 19:27:29,0,0,0,0,0,0
1,201392386,2170660915,0,0,2024-10-04 19:27:29,0,0,0,0,0,0
1,201392386,2170660915,37534,36895,2024-10-04 19:27:29,0,0,0,0,0,0
1,201392386,2170660915,57029,36895,2024-10-04 19:27:30,0,0,0,0,0,0
1,201392386,2170660915,5839,36895,2024-10-04 19:27:30,0,0,0,0,0,0
1,201392386,1145490692,16066,47873,2024-10-04 19:27:30,0,0,0,0,0,0
1,201392386,2170660915,0,0,2024-10-04 19:27:30,0,0,0,0,0,0
1,201392386,2170660915,37534,36895,2024-10-04 19:27:30,0,0,0,0,0,0
1,201392386,2170660915,57029,36895,2024-10-04 19:27:31,0,0,0,0,0,0
1,201392386,2170660915,5839,36895,2024-10-04 19:27:31,0,0,0,0,0,0
1,201392386,1145490692,16066,47873,2024-10-04 19:27:31,840,5924,6764,8,8,16
1,201392386,2170660915,0,0,2024-10-04 19:27:31,0,0,0,0,0,0
1,201392386,2170660915,37534,36895,2024-10-04 19:27:31,0,0,0,0,0,0
1,201392386,2170660915,57029,36895,2024-10-04 19:27:32,0,0,0,0,0,0
1,201392386,2170660915,5839,36895,2024-10-04 19:27:32,0,0,0,0,0,0
1,201392386,1145490692,16066,47873,2024-10-04 19:27:32,0,0,0,0,0,0
1,201392386,2170660915,0,0,2024-10-04 19:27:32,0,0,0,0,0,0
1,201392386,2170660915,37534,36895,2024-10-04 19:27:32,0,0,0,0,0,0
1,201392386,2170660915,57029,36895,2024-10-04 19:27:33,0,0,0,0,0,0
1,201392386,2170660915,5839,36895,2024-10-04 19:27:33,0,0,0,0,0,0
1,201392386,1145490692,16066,47873,2024-10-04 19:27:33,0,0,0,0,0,0
1,201392386,2170660915,0,0,2024-10-04 19:27:33,128,0,128,1,0,1
1,201392386,2170660915,37534,36895,2024-10-04 19:27:33,0,0,0,0,0,0
1,201392386,2170660915,57029,36895,2024-10-04 19:27:34,0,0,0,0,0,0
1,201392386,2170660915,5839,36895,2024-10-04 19:27:34,0,0,0,0,0,0
1,201392386,1145490692,16066,47873,2024-10-04 19:27:34,0,0,0,0,0,0
1,201392386,2170660915,0,0,2024-10-04 19:27:34,128,84,212,1,1,2
1,201392386,2170660915,37534,36895,2024-10-04 19:27:34,0,0,0,0,0,0
1,201392386,2170660915,57029,36895,2024-10-04 19:27:35,0,0,0,0,0,0
1,201392386,2170660915,5839,36895,2024-10-04 19:27:35,0,0,0,0,0,0
1,201392386,1145490692,16066,47873,2024-10-04 19:27:35,0,0,0,0,0,0
1,201392386,2170660915,0,0,2024-10-04 19:27:35,128,84,212,1,1,2
1,201392386,2170660915,37534,36895,2024-10-04 19:27:35,0,0,0,0,0,0
1,201392386,2170660915,57029,36895,2024-10-04 19:27:36,0,0,0,0,0,0
1,201392386,2170660915,5839,36895,2024-10-04 19:27:36,0,0,0,0,0,0
1,201392386,1145490692,16066,47873,2024-10-04 19:27:36,0,0,0,0,0,0
1,201392386,2170660915,0,0,2024-10-04 19:27:36,128,84,212,1,1,2
1,201392386,2170660915,37534,36895,2024-10-04 19:27:36,0,0,0,0,0,0
1,201392386,2170660915,57029,36895,2024-10-04 19:27:37,0,0,0,0,0,0
1,201392386,2170660915,5839,36895,2024-10-04 19:27:37,0,0,0,0,0,0
1,201392386,1145490692,16066,47873,2024-10-04 19:27:37,0,0,0,0,0,0
1,201392386,2170660915,0,0,2024-10-04 19:27:37,128,84,212,1,1,2
1,201392386,2170660915,37534,36895,2024-10-04 19:27:37,0,0,0,0,0,0
1,201392386,2170660915,57029,36895,2024-10-04 19:27:38,0,0,0,0,0,0
1,201392386,2170660915,5839,36895,2024-10-04 19:27:38,0,0,0,0,0,0
1,201392386,1145490692,16066,47873,2024-10-04 19:27:38,0,0,0,0,0,0
1,201392386,2170660915,0,0,2024-10-04 19:27:38,128,84,212,1,1,2
1,201392386,2170660915,37534,36895,2024-10-04 19:27:38,0,0,0,0,0,0
1,201392386,2170660915,57029,36895,2024-10-04 19:27:39,0,0,0,0,0,0
1,201392386,2170660915,5839,36895,2024-10-04 19:27:39,0,0,0,0,0,0
1,201392386,1145490692,16066,47873,2024-10-04 19:27:39,0,0,0,0,0,0
1,201392386,2170660915,0,0,2024-10-04 19:27:39,128,84,212,1,1,2
1,201392386,2170660915,37534,36895,2024-10-04 19:27:39,0,0,0,0,0,0
1,201392386,2170660915,57029,36895,2024-10-04 19:27:40,0,0,0,0,0,0
1,201392386,2170660915,5839,36895,2024-10-04 19:27:40,0,0,0,0,0,0
1,201392386,1145490692,16066,47873,2024-10-04 19:27:40,0,0,0,0,0,0
1,201392386,2170660915,0,0,2024-10-04 19:27:40,128,84,212,1,1,2
1,201392386,2170660915,37534,36895,2024-10-04 19:27:40,0,0,0,0,0,0
1,201392386,2170660915,57029,36895,2024-10-04 19:27:41,0,0,0,0,0,0
1,201392386,2170660915,5839,36895,2024-10-04 19:27:41,0,0,0,0,0,0
1,201392386,1145490692,16066,47873,2024-10-04 19:27:41,0,0,0,0,0,0
1,201392386,2170660915,0,0,2024-10-04 19:27:41,0,84,84,0,1,1
1,201392386,2170660915,37534,36895,2024-10-04 19:27:41,0,0,0,0,0,0
1,201392386,2170660915,57029,36895,2024-10-04 19:27:42,0,0,0,0,0,0
1,201392386,2170660915,5839,36895,2024-10-04 19:27:42,0,0,0,0,0,0
1,201392386,2170660915,0,0,2024-10-04 19:27:42,128,84,212,1,1,2
1,201392386,2170660915,37534,36895,2024-10-04 19:27:42,0,0,0,0,0,0
1,201392386,2170660915,57029,36895,2024-10-04 19:27:43,0,0,0,0,0,0
1,201392386,2170660915,5839,36895,2024-10-04 19:27:43,0,0,0,0,0,0
1,201392386,2170660915,0,0,2024-10-04 19:27:43,128,84,212,1,1,2
1,201392386,2170660915,37534,36895,2024-10-04 19:27:43,0,0,0,0,0,0
1,201392386,2170660915,57029,36895,2024-10-04 19:27:44,0,0,0,0,0,0
1,201392386,2170660915,5839,36895,2024-10-04 19:27:44,0,0,0,0,0,0
1,201392386,2170660915,42686,36895,2024-10-04 19:27:44,666,507,1173,6,6,12
1,201392386,2170660915,0,0,2024-10-04 19:27:44,0,0,0,0,0,0
1,201392386,2170660915,37534,36895,2024-10-04 19:27:44,0,0,0,0,0,0
1,201392386,2170660915,57029,36895,2024-10-04 19:27:45,0,0,0,0,0,0
1,201392386,2170660915,5839,36895,2024-10-04 19:27:45,0,0,0,0,0,0
1,201392386,2170660915,42686,36895,2024-10-04 19:27:45,0,0,0,0,0,0
1,201392386,2170660915,0,0,2024-10-04 19:27:45,0,0,0,0,0,0
1,201392386,2170660915,37534,36895,2024-10-04 19:27:45,0,0,0,0,0,0
1,201392386,2170660915,57029,36895,2024-10-04 19:27:46,0,0,0,0,0,0
1,201392386,2170660915,5839,36895,2024-10-04 19:27:46,0,0,0,0,0,0
1,201392386,2170660915,42686,36895,2024-10-04 19:27:46,0,0,0,0,0,0
1,201392386,2170660915,0,0,2024-10-04 19:27:46,256,84,340,2,1,3
1,201392386,2170660915,37534,36895,2024-10-04 19:27:46,0,0,0,0,0,0
1,201392386,2170660915,57029,36895,2024-10-04 19:27:47,0,0,0,0,0,0
1,201392386,2170660915,5839,36895,2024-10-04 19:27:47,0,0,0,0,0,0
1,201392386,2170660915,42686,36895,2024-10-04 19:27:47,0,0,0,0,0,0
1,201392386,2170660915,0,0,2024-10-04 19:27:47,128,84,212,1,1,2
1,201392386,2170660915,37534,36895,2024-10-04 19:27:47,0,0,0,0,0,0
1,201392386,2170660915,57029,36895,2024-10-04 19:27:48,0,0,0,0,0,0
1,201392386,2170660915,5839,36895,2024-10-04 19:27:48,0,0,0,0,0,0
1,201392386,2170660915,42686,36895,2024-10-04 19:27:48,0,0,0,0,0,0
1,201392386,2170660915,0,0,2024-10-04 19:27:48,0,84,84,0,1,1
1,201392386,2170660915,37534,36895,2024-10-04 19:27:48,0,0,0,0,0,0
1,201392386,2170660915,57029,36895,2024-10-04 19:27:49,0,0,0,0,0,0
1,201392386,2170660915,5839,36895,2024-10-04 19:27:49,0,0,0,0,0,0
1,201392386,2170660915,42686,36895,2024-10-04 19:27:49,0,0,0,0,0,0
1,201392386,2170660915,0,0,2024-10-04 19:27:49,0,0,0,0,0,0
1,201392386,2170660915,37534,36895,2024-10-04 19:27:49,0,0,0,0,0,0
1,201392386,2170660915,57029,36895,2024-10-04 19:27:50,0,0,0,0,0,0
1,201392386,2170660915,5839,36895,2024-10-04 19:27:50,0,0,0,0,0,0
1,201392386,2170660915,42686,36895,2024-10-04 19:27:50,0,0,0,0,0,0
1,201392386,2170660915,0,0,2024-10-04 19:27:50,0,0,0,0,0,0
1,201392386,2170660915,37534,36895,2024-10-04 19:27:50,0,0,0,0,0,0
1,201392386,2170660915,57029,36895,2024-10-04 19:27:51,0,0,0,0,0,0
1,201392386,2170660915,5839,36895,2024-10-04 19:27:51,0,0,0,0,0,0
1,201392386,2170660915,42686,36895,2024-10-04 19:27:51,0,0,0,0,0,0
1,201392386,2170660915,0,0,2024-10-04 19:27:51,256,84,340,2,1,3
1,201392386,2170660915,37534,36895,2024-10-04 19:27:51,0,0,0,0,0,0
1,201392386,2170660915,57029,36895,2024-10-04 19:27:52,0,0,0,0,0,0
1,201392386,2170660915,5839,36895,2024-10-04 19:27:52,0,0,0,0,0,0
1,201392386,2170660915,42686,36895,2024-10-04 19:27:52,0,0,0,0,0,0
1,201392386,2170660915,0,0,2024-10-04 19:27:52,128,84,212,1,1,2
1,201392386,2170660915,37534,36895,2024-10-04 19:27:52,0,0,0,0,0,0
1,201392386,2170660915,57029,36895,2024-10-04 19:27:53,0,0,0,0,0,0
1,201392386,1145490690,2205,47873,2024-10-04 19:27:53,4388,67945,72333,35,55,90
1,201392386,2170660915,5839,36895,2024-10-04 19:27:53,0,0,0,0,0,0
1,201392386,2170660915,42686,36895,2024-10-04 19:27:53,0,0,0,0,0,0
1,201392386,2170660915,0,0,2024-10-04 19:27:53,0,84,84,0,1,1
1,201392386,2170660915,37534,36895,2024-10-04 19:27:53,0,0,0,0,0,0
1,201392386,2170660915,57029,36895,2024-10-04 19:27:54,0,0,0,0,0,0
1,201392386,1145490690,2205,47873,2024-10-04 19:27:54,1836,31431,33267,18,24,42
1,201392386,2170660915,5839,36895,2024-10-04 19:27:54,0,0,0,0,0,0
1,201392386,2170660915,42686,36895,2024-10-04 19:27:54,0,0,0,0,0,0
1,201392386,2170660915,0,0,2024-10-04 19:27:54,0,0,0,0,0,0
1,201392386,2170660915,37534,36895,2024-10-04 19:27:54,0,0,0,0,0,0
1,201392386,2170660915,57029,36895,2024-10-04 19:27:55,0,0,0,0,0,0
1,201392386,1145490690,2205,47873,2024-10-04 19:27:55,0,0,0,0,0,0
1,201392386,2170660915,5839,36895,2024-10-04 19:27:55,0,0,0,0,0,0
1,201392386,2170660915,42686,36895,2024-10-04 19:27:55,0,0,0,0,0,0
1,201392386,2170660915,0,0,2024-10-04 19:27:55,0,0,0,0,0,0
1,201392386,2170660915,37534,36895,2024-10-04 19:27:55,0,0,0,0,0,0
1,201392386,2170660915,57029,36895,2024-10-04 19:27:56,0,0,0,0,0,0
1,201392386,1145490690,2205,47873,2024-10-04 19:27:56,0,0,0,0,0,0
1,201392386,2170660915,5839,36895,2024-10-04 19:27:56,0,0,0,0,0,0
1,201392386,2170660915,42686,36895,2024-10-04 19:27:56,0,0,0,0,0,0
1,201392386,2170660915,0,0,2024-10-04 19:27:56,0,0,0,0,0,0
1,201392386,2170660915,37534,36895,2024-10-04 19:27:56,0,0,0,0,0,0
1,201392386,2170660915,57029,36895,2024-10-04 19:27:57,0,0,0,0,0,0
1,201392386,1145490690,2205,47873,2024-10-04 19:27:57,0,0,0,0,0,0
1,201392386,2170660915,5839,36895,2024-10-04 19:27:57,0,0,0,0,0,0
1,201392386,2170660915,42686,36895,2024-10-04 19:27:57,0,0,0,0,0,0
1,201392386,2170660915,0,0,2024-10-04 19:27:57,0,0,0,0,0,0
1,201392386,2170660915,37534,36895,2024-10-04 19:27:57,0,0,0,0,0,0
1,201392386,2170660915,57029,36895,2024-10-04 19:27:58,0,0,0,0,0,0
1,201392386,1145490690,2205,47873,2024-10-04 19:27:58,0,0,0,0,0,0
1,201392386,2170660915,5839,36895,2024-10-04 19:27:58,0,0,0,0,0,0
1,201392386,2170660915,42686,36895,2024-10-04 19:27:58,0,0,0,0,0,0
1,201392386,2170660915,0,0,2024-10-04 19:27:58,0,0,0,0,0,0
1,201392386,2170660915,37534,36895,2024-10-04 19:27:58,0,0,0,0,0,0
1,201392386,2170660915,57029,36895,2024-10-04 19:27:59,0,0,0,0,0,0
1,201392386,1145490690,2205,47873,2024-10-04 19:27:59,0,0,0,0,0,0
1,201392386,2170660915,5839,36895,2024-10-04 19:27:59,0,0,0,0,0,0
1,201392386,2170660915,42686,36895,2024-10-04 19:27:59,0,0,0,0,0,0
1,201392386,2170660915,0,0,2024-10-04 19:27:59,0,0,0,0,0,0
1,201392386,2170660915,37534,36895,2024-10-04 19:27:59,0,0,0,0,0,0
1,201392386,2170660915,57029,36895,2024-10-04 19:28:00,0,0,0,0,0,0
1,201392386,1145490690,2205,47873,2024-10-04 19:28:00,0,0,0,0,0,0
1,201392386,2170660915,5839,36895,2024-10-04 19:28:00,0,0,0,0,0,0
1,201392386,2170660915,42686,36895,2024-10-04 19:28:00,0,0,0,0,0,0
1,201392386,2170660915,0,0,2024-10-04 19:28:00,0,0,0,0,0,0
1,201392386,2170660915,37534,36895,2024-10-04 19:28:00,0,0,0,0,0,0
1,201392386,2170660915,57029,36895,2024-10-04 19:28:01,0,0,0,0,0,0
1,201392386,1145490690,2205,47873,2024-10-04 19:28:01,0,0,0,0,0,0
1,201392386,2170660915,5839,36895,2024-10-04 19:28:01,0,0,0,0,0,0
1,201392386,2170660915,42686,36895,2024-10-04 19:28:01,0,0,0,0,0,0
1,201392386,2170660915,0,0,2024-10-04 19:28:01,0,0,0,0,0,0
1,201392386,2170660915,37534,36895,2024-10-04 19:28:01,0,0,0,0,0,0
1,201392386,2170660915,57029,36895,2024-10-04 19:28:02,0,0,0,0,0,0
1,201392386,1145490690,2205,47873,2024-10-04 19:28:02,0,0,0,0,0,0
1,201392386,2170660915,5839,36895,2024-10-04 19:28:02,0,0,0,0,0,0
1,201392386,2170660915,42686,36895,2024-10-04 19:28:02,0,0,0,0,0,0
1,201392386,2170660915,0,0,2024-10-04 19:28:02,0,0,0,0,0,0
1,201392386,2170660915,37534,36895,2024-10-04 19:28:02,0,0,0,0,0,0
1,201392386,2170660915,57029,36895,2024-10-04 19:28:03,0,0,0,0,0,0
1,201392386,1145490690,2205,47873,2024-10-04 19:28:03,0,0,0,0,0,0
1,201392386,2170660915,5839,36895,2024-10-04 19:28:03,0,0,0,0,0,0
1,201392386,2170660915,42686,36895,2024-10-04 19:28:03,0,0,0,0,0,0
1,201392386,2170660915,0,0,2024-10-04 19:28:03,0,0,0,0,0,0
1,201392386,2170660915,37534,36895,2024-10-04 19:28:03,0,0,0,0,0,0
1,201392386,2170660915,57029,36895,2024-10-04 19:28:04,0,0,0,0,0,0
1,201392386,1145490690,2205,47873,2024-10-04 19:28:04,0,0,0,0,0,0
1,201392386,2170660915,5839,36895,2024-10-04 19:28:04,0,0,0,0,0,0
1,201392386,2170660915,42686,36895,2024-10-04 19:28:04,0,0,0,0,0,0
1,201392386,2170660915,0,0,2024-10-04 19:28:04,0,0,0,0,0,0
1,201392386,2170660915,37534,36895,2024-10-04 19:28:04,0,0,0,0,0,0
1,201392386,2170660915,57029,36895,2024-10-04 19:28:05,0,0,0,0,0,0
1,201392386,1145490690,2205,47873,2024-10-04 19:28:05,0,0,0,0,0,0
1,201392386,2170660915,5839,36895,2024-10-04 19:28:05,0,0,0,0,0,0
1,201392386,2170660915,42686,36895,2024-10-04 19:28:05,0,0,0,0,0,0
1,201392386,2170660915,0,0,2024-10-04 19:28:05,128,84,212,1,1,2
1,201392386,2170660915,37534,36895,2024-10-04 19:28:05,0,0,0,0,0,0
1,201392386,2170660915,57029,36895,2024-10-04 19:28:06,0,0,0,0,0,0
1,201392386,1145490690,2205,47873,2024-10-04 19:28:06,0,0,0,0,0,0
1,201392386,2170660915,5839,36895,2024-10-04 19:28:06,0,0,0,0,0,0
1,201392386,2170660915,42686,36895,2024-10-04 19:28:06,0,0,0,0,0,0
1,201392386,2170660915,0,0,2024-10-04 19:28:06,128,84,212,1,1,2
1,201392386,2170660915,37534,36895,2024-10-04 19:28:06,0,0,0,0,0,0
1,201392386,2170660915,57029,36895,2024-10-04 19:28:07,0,0,0,0,0,0
1,201392386,1145490690,2205,47873,2024-10-04 19:28:07,0,0,0,0,0,0
1,201392386,2170660915,5839,36895,2024-10-04 19:28:07,0,0,0,0,0,0
1,201392386,2170660915,42686,36895,2024-10-04 19:28:07,0,0,0,0,0,0
1,201392386,2170660915,0,0,2024-10-04 19:28:07,128,84,212,1,1,2
1,201392386,2170660915,37534,36895,2024-10-04 19:28:07,0,0,0,0,0,0
1,201392386,2170660915,57029,36895,2024-10-04 19:28:08,0,0,0,0,0,0
1,201392386,1145490690,2205,47873,2024-10-04 19:28:08,0,0,0,0,0,0
1,201392386,2170660915,5839,36895,2024-10-04 19:28:08,0,0,0,0,0,0
1,201392386,2170660915,42686,36895,2024-10-04 19:28:08,0,0,0,0,0,0
1,201392386,2170660915,0,0,2024-10-04 19:28:08,128,84,212,1,1,2
1,201392386,2170660915,37534,36895,2024-10-04 19:28:08,0,0,0,0,0,0
1,201392386,2170660915,57029,36895,2024-10-04 19:28:09,0,0,0,0,0,0
1,201392386,1145490690,2205,47873,2024-10-04 19:28:09,0,0,0,0,0,0
1,201392386,2170660915,5839,36895,2024-10-04 19:28:09,0,0,0,0,0,0
1,201392386,2170660915,42686,36895,2024-10-04 19:28:09,0,0,0,0,0,0
1,201392386,2170660915,0,0,2024-10-04 19:28:09,128,84,212,1,1,2
1,201392386,2170660915,37534,36895,2024-10-04 19:28:09,0,0,0,0,0,0
1,201392386,2170660915,57029,36895,2024-10-04 19:28:10,0,0,0,0,0,0
1,201392386,1145490690,2205,47873,2024-10-04 19:28:10,0,0,0,0,0,0
1,201392386,2170660915,5839,36895,2024-10-04 19:28:10,0,0,0,0,0,0
1,201392386,2170660915,42686,36895,2024-10-04 19:28:10,0,0,0,0,0,0
1,201392386,2170660915,0,0,2024-10-04 19:28:10,128,84,212,1,1,2
1,201392386,2170660915,37534,36895,2024-10-04 19:28:10,0,0,0,0,0,0
1,201392386,2170660915,57029,36895,2024-10-04 19:28:11,0,0,0,0,0,0
1,201392386,1145490690,2205,47873,2024-10-04 19:28:11,0,0,0,0,0,0
1,201392386,2170660915,5839,36895,2024-10-04 19:28:11,0,0,0,0,0,0
1,201392386,2170660915,42686,36895,2024-10-04 19:28:11,0,0,0,0,0,0
1,201392386,2170660915,0,0,2024-10-04 19:28:11,256,168,424,2,2,4
1,201392386,2170660915,37534,36895,2024-10-04 19:28:11,0,0,0,0,0,0
1,201392386,2170660915,57029,36895,2024-10-04 19:28:12,0,0,0,0,0,0
1,201392386,1145490690,2205,47873,2024-10-04 19:28:12,0,0,0,0,0,0
1,201392386,2170660915,5839,36895,2024-10-04 19:28:12,0,0,0,0,0,0
1,201392386,2170660915,42686,36895,2024-10-04 19:28:12,0,0,0,0,0,0
1,201392386,2170660915,0,0,2024-10-04 19:28:12,0,0,0,0,0,0
1,201392386,2170660915,37534,36895,2024-10-04 19:28:12,0,0,0,0,0,0
1,201392386,2170660915,57029,36895,2024-10-04 19:28:13,0,0,0,0,0,0
1,201392386,2170660915,5839,36895,2024-10-04 19:28:13,0,0,0,0,0,0
1,201392386,2170660915,42686,36895,2024-10-04 19:28:13,0,0,0,0,0,0
1,201392386,2170660915,0,0,2024-10-04 19:28:13,256,168,424,2,2,4
1,201392386,2170660915,37534,36895,2024-10-04 19:28:13,0,0,0,0,0,0
1,201392386,2170660915,57029,36895,2024-10-04 19:28:14,0,0,0,0,0,0
1,201392386,2170660915,5839,36895,2024-10-04 19:28:14,0,0,0,0,0,0
1,201392386,2170660915,42686,36895,2024-10-04 19:28:14,0,0,0,0,0,0
1,201392386,2170660915,0,0,2024-10-04 19:28:14,0,0,0,0,0,0
1,201392386,2170660915,37534,36895,2024-10-04 19:28:14,0,0,0,0,0,0
1,201392386,2170660915,57029,36895,2024-10-04 19:28:15,0,0,0,0,0,0
1,201392386,2170660915,22703,36895,2024-10-04 19:28:15,666,507,1173,6,6,12
1,201392386,2170660915,5839,36895,2024-10-04 19:28:15,0,0,0,0,0,0
1,201392386,2170660915,0,0,2024-10-04 19:28:15,0,0,0,0,0,0
1,201392386,2170660915,37534,36895,2024-10-04 19:28:15,0,0,0,0,0,0
1,201392386,2170660915,57029,36895,2024-10-04 19:28:16,0,0,0,0,0,0
1,201392386,2170660915,22703,36895,2024-10-04 19:28:16,0,0,0,0,0,0
1,201392386,2170660915,5839,36895,2024-10-04 19:28:16,0,0,0,0,0,0
1,201392386,2170660915,0,0,2024-10-04 19:28:16,0,0,0,0,0,0
1,201392386,2170660915,37534,36895,2024-10-04 19:28:16,0,0,0,0,0,0
1,201392386,2170660915,57029,36895,2024-10-04 19:28:17,0,0,0,0,0,0
1,201392386,2170660915,22703,36895,2024-10-04 19:28:17,0,0,0,0,0,0
1,201392386,2170660915,5839,36895,2024-10-04 19:28:17,0,0,0,0,0,0
1,201392386,2170660915,0,0,2024-10-04 19:28:17,256,84,340,2,1,3
1,201392386,2170660915,37534,36895,2024-10-04 19:28:17,0,0,0,0,0,0
1,201392386,2170660915,57029,36895,2024-10-04 19:28:18,0,0,0,0,0,0
1,201392386,2170660915,22703,36895,2024-10-04 19:28:18,0,0,0,0,0,0
1,201392386,2170660915,5839,36895,2024-10-04 19:28:18,0,0,0,0,0,0
1,201392386,2170660915,0,0,2024-10-04 19:28:18,128,168,296,1,2,3
1,201392386,2170660915,37534,36895,2024-10-04 19:28:18,0,0,0,0,0,0
1,201392386,2170660915,57029,36895,2024-10-04 19:28:19,0,0,0,0,0,0
1,201392386,2170660915,22703,36895,2024-10-04 19:28:19,0,0,0,0,0,0
1,201392386,2170660915,5839,36895,2024-10-04 19:28:19,0,0,0,0,0,0
1,201392386,2170660915,0,0,2024-10-04 19:28:19,0,0,0,0,0,0
1,201392386,2170660915,37534,36895,2024-10-04 19:28:19,0,0,0,0,0,0
1,201392386,2170660915,57029,36895,2024-10-04 19:28:20,0,0,0,0,0,0
1,201392386,2170660915,22703,36895,2024-10-04 19:28:20,0,0,0,0,0,0
1,201392386,2170660915,5839,36895,2024-10-04 19:28:20,0,0,0,0,0,0
1,201392386,2170660915,0,0,2024-10-04 19:28:20,0,0,0,0,0,0
1,201392386,2170660915,37534,36895,2024-10-04 19:28:20,0,0,0,0,0,0
1,201392386,2170660915,57029,36895,2024-10-04 19:28:21,0,0,0,0,0,0
1,201392386,2170660915,22703,36895,2024-10-04 19:28:21,0,0,0,0,0,0
1,201392386,2170660915,5839,36895,2024-10-04 19:28:21,0,0,0,0,0,0
1,201392386,2170660915,0,0,2024-10-04 19:28:21,128,0,128,1,0,1
1,201392386,2170660915,37534,36895,2024-10-04 19:28:21,0,0,0,0,0,0
1,201392386,2170660915,57029,36895,2024-10-04 19:28:22,0,0,0,0,0,0
1,201392386,2170660915,22703,36895,2024-10-04 19:28:22,0,0,0,0,0,0
1,201392386,2170660915,5839,36895,2024-10-04 19:28:22,0,0,0,0,0,0
1,201392386,2170660915,0,0,2024-10-04 19:28:22,128,84,212,1,1,2
1,201392386,2170660915,37534,36895,2024-10-04 19:28:22,0,0,0,0,0,0
1,201392386,2170660915,57029,36895,2024-10-04 19:28:23,0,0,0,0,0,0
1,201392386,2170660915,22703,36895,2024-10-04 19:28:23,0,0,0,0,0,0
1,201392386,2170660915,5839,36895,2024-10-04 19:28:23,0,0,0,0,0,0
1,201392386,2170660915,0,0,2024-10-04 19:28:23,128,84,212,1,1,2
1,201392386,2170660915,37534,36895,2024-10-04 19:28:23,0,0,0,0,0,0
1,201392386,2170660915,57029,36895,2024-10-04 19:28:24,0,0,0,0,0,0
1,201392386,2170660915,22703,36895,2024-10-04 19:28:24,0,0,0,0,0,0
1,201392386,2170660915,5839,36895,2024-10-04 19:28:24,0,0,0,0,0,0
1,201392386,2170660915,0,0,2024-10-04 19:28:24,0,84,84,0,1,1
1,201392386,2170660915,37534,36895,2024-10-04 19:28:24,0,0,0,0,0,0
1,201392386,1145490691,24290,47873,2024-10-04 19:28:24,4416,61459,65875,36,50,86
1,201392386,2170660915,57029,36895,2024-10-04 19:28:25,0,0,0,0,0,0
1,201392386,2170660915,22703,36895,2024-10-04 19:28:25,0,0,0,0,0,0
1,201392386,2170660915,5839,36895,2024-10-04 19:28:25,0,0,0,0,0,0
1,201392386,2170660915,0,0,2024-10-04 19:28:25,0,0,0,0,0,0
1,201392386,2170660915,37534,36895,2024-10-04 19:28:25,0,0,0,0,0,0
1,201392386,1145490691,24290,47873,2024-10-04 19:28:25,2544,41985,44529,25,31,56
1,201392386,2170660915,57029,36895,2024-10-04 19:28:26,0,0,0,0,0,0
1,201392386,2170660915,22703,36895,2024-10-04 19:28:26,0,0,0,0,0,0
1,201392386,2170660915,5839,36895,2024-10-04 19:28:26,0,0,0,0,0,0
1,201392386,2170660915,0,0,2024-10-04 19:28:26,0,0,0,0,0,0
1,201392386,2170660915,37534,36895,2024-10-04 19:28:26,0,0,0,0,0,0
1,201392386,1145490691,24290,47873,2024-10-04 19:28:26,0,0,0,0,0,0
1,201392386,2170660915,57029,36895,2024-10-04 19:28:27,0,0,0,0,0,0
1,201392386,2170660915,22703,36895,2024-10-04 19:28:27,0,0,0,0,0,0
1,201392386,2170660915,5839,36895,2024-10-04 19:28:27,0,0,0,0,0,0
1,201392386,2170660915,0,0,2024-10-04 19:28:27,0,0,0,0,0,0
1,201392386,2170660915,37534,36895,2024-10-04 19:28:27,0,0,0,0,0,0
1,201392386,1145490691,24290,47873,2024-10-04 19:28:27,0,0,0,0,0,0
1,201392386,2170660915,57029,36895,2024-10-04 19:28:28,0,0,0,0,0,0
1,201392386,2170660915,22703,36895,2024-10-04 19:28:28,0,0,0,0,0,0
1,201392386,2170660915,5839,36895,2024-10-04 19:28:28,0,0,0,0,0,0
1,201392386,2170660915,0,0,2024-10-04 19:28:28,0,0,0,0,0,0
1,201392386,2170660915,37534,36895,2024-10-04 19:28:28,0,0,0,0,0,0
1,201392386,1145490691,24290,47873,2024-10-04 19:28:28,0,0,0,0,0,0
1,201392386,2170660915,57029,36895,2024-10-04 19:28:29,0,0,0,0,0,0
1,201392386,2170660915,22703,36895,2024-10-04 19:28:29,0,0,0,0,0,0
1,201392386,2170660915,5839,36895,2024-10-04 19:28:29,0,0,0,0,0,0
1,201392386,2170660915,0,0,2024-10-04 19:28:29,0,0,0,0,0,0
1,201392386,2170660915,37534,36895,2024-10-04 19:28:29,0,0,0,0,0,0
1,201392386,1145490691,24290,47873,2024-10-04 19:28:29,0,0,0,0,0,0
1,201392386,2170660915,57029,36895,2024-10-04 19:28:30,0,0,0,0,0,0
1,201392386,2170660915,22703,36895,2024-10-04 19:28:30,0,0,0,0,0,0
1,201392386,2170660915,5839,36895,2024-10-04 19:28:30,0,0,0,0,0,0
1,201392386,2170660915,0,0,2024-10-04 19:28:30,0,0,0,0,0,0
1,201392386,2170660915,37534,36895,2024-10-04 19:28:30,0,0,0,0,0,0
1,201392386,1145490691,24290,47873,2024-10-04 19:28:30,0,0,0,0,0,0
1,201392386,2170660915,57029,36895,2024-10-04 19:28:31,0,0,0,0,0,0
1,201392386,2170660915,22703,36895,2024-10-04 19:28:31,0,0,0,0,0,0
1,201392386,2170660915,5839,36895,2024-10-04 19:28:31,0,0,0,0,0,0
1,201392386,2170660915,0,0,2024-10-04 19:28:31,0,0,0,0,0,0
1,201392386,2170660915,37534,36895,2024-10-04 19:28:31,0,0,0,0,0,0
1,201392386,1145490691,24290,47873,2024-10-04 19:28:31,0,0,0,0,0,0
1,201392386,2170660915,57029,36895,2024-10-04 19:28:32,0,0,0,0,0,0
1,201392386,2170660915,22703,36895,2024-10-04 19:28:32,0,0,0,0,0,0
1,201392386,2170660915,5839,36895,2024-10-04 19:28:32,0,0,0,0,0,0
1,201392386,2170660915,0,0,2024-10-04 19:28:32,0,0,0,0,0,0
1,201392386,2170660915,37534,36895,2024-10-04 19:28:32,0,0,0,0,0,0
1,201392386,1145490691,24290,47873,2024-10-04 19:28:32,0,0,0,0,0,0
1,201392386,2170660915,57029,36895,2024-10-04 19:28:33,0,0,0,0,0,0
1,201392386,2170660915,22703,36895,2024-10-04 19:28:33,0,0,0,0,0,0
1,201392386,2170660915,5839,36895,2024-10-04 19:28:33,0,0,0,0,0,0
1,201392386,2170660915,0,0,2024-10-04 19:28:33,0,0,0,0,0,0
1,201392386,2170660915,37534,36895,2024-10-04 19:28:33,0,0,0,0,0,0
1,201392386,1145490691,24290,47873,2024-10-04 19:28:33,0,0,0,0,0,0
1,201392386,2170660915,57029,36895,2024-10-04 19:28:34,0,0,0,0,0,0
1,201392386,2170660915,22703,36895,2024-10-04 19:28:34,0,0,0,0,0,0
1,201392386,2170660915,5839,36895,2024-10-04 19:28:34,0,0,0,0,0,0
1,201392386,2170660915,0,0,2024-10-04 19:28:34,0,0,0,0,0,0
1,201392386,2170660915,37534,36895,2024-10-04 19:28:34,0,0,0,0,0,0
1,201392386,1145490691,24290,47873,2024-10-04 19:28:34,0,0,0,0,0,0
1,201392386,2170660915,57029,36895,2024-10-04 19:28:35,0,0,0,0,0,0
1,201392386,2170660915,22703,36895,2024-10-04 19:28:35,0,0,0,0,0,0
1,201392386,2170660915,5839,36895,2024-10-04 19:28:35,0,0,0,0,0,0
1,201392386,2170660915,0,0,2024-10-04 19:28:35,128,0,128,1,0,1
1,201392386,2170660915,37534,36895,2024-10-04 19:28:35,0,0,0,0,0,0
1,201392386,1145490691,24290,47873,2024-10-04 19:28:35,0,0,0,0,0,0
1,201392386,2170660915,57029,36895,2024-10-04 19:28:36,0,0,0,0,0,0
1,201392386,2170660915,22703,36895,2024-10-04 19:28:36,0,0,0,0,0,0
1,201392386,2170660915,5839,36895,2024-10-04 19:28:36,0,0,0,0,0,0
1,201392386,2170660915,0,0,2024-10-04 19:28:36,0,84,84,0,1,1
1,201392386,2170660915,37534,36895,2024-10-04 19:28:36,0,0,0,0,0,0
1,201392386,1145490691,24290,47873,2024-10-04 19:28:36,0,0,0,0,0,0
1,201392386,2170660915,57029,36895,2024-10-04 19:28:37,0,0,0,0,0,0
1,201392386,2170660915,22703,36895,2024-10-04 19:28:37,0,0,0,0,0,0
1,201392386,2170660915,5839,36895,2024-10-04 19:28:37,0,0,0,0,0,0
1,201392386,2170660915,0,0,2024-10-04 19:28:37,128,84,212,1,1,2
1,201392386,2170660915,37534,36895,2024-10-04 19:28:37,0,0,0,0,0,0
1,201392386,1145490691,24290,47873,2024-10-04 19:28:37,0,0,0,0,0,0
1,201392386,2170660915,57029,36895,2024-10-04 19:28:38,0,0,0,0,0,0
1,201392386,2170660915,22703,36895,2024-10-04 19:28:38,0,0,0,0,0,0
1,201392386,2170660915,5839,36895,2024-10-04 19:28:38,0,0,0,0,0,0
1,201392386,2170660915,0,0,2024-10-04 19:28:38,128,84,212,1,1,2
1,201392386,2170660915,37534,36895,2024-10-04 19:28:38,0,0,0,0,0,0
1,201392386,1145490691,24290,47873,2024-10-04 19:28:38,0,0,0,0,0,0
1,201392386,2170660915,57029,36895,2024-10-04 19:28:39,0,0,0,0,0,0
1,201392386,2170660915,22703,36895,2024-10-04 19:28:39,0,0,0,0,0,0
1,201392386,2170660915,5839,36895,2024-10-04 19:28:39,0,0,0,0,0,0
1,201392386,2170660915,0,0,2024-10-04 19:28:39,128,84,212,1,1,2
1,201392386,2170660915,37534,36895,2024-10-04 19:28:39,0,0,0,0,0,0
1,201392386,1145490691,24290,47873,2024-10-04 19:28:39,0,0,0,0,0,0
1,201392386,2170660915,57029,36895,2024-10-04 19:28:40,0,0,0,0,0,0
1,201392386,2170660915,22703,36895,2024-10-04 19:28:40,0,0,0,0,0,0
1,201392386,2170660915,5839,36895,2024-10-04 19:28:40,0,0,0,0,0,0
1,201392386,2170660915,0,0,2024-10-04 19:28:40,256,168,424,2,2,4
1,201392386,2170660915,37534,36895,2024-10-04 19:28:40,0,0,0,0,0,0
1,201392386,1145490691,24290,47873,2024-10-04 19:28:40,0,0,0,0,0,0
1,201392386,2170660915,57029,36895,2024-10-04 19:28:41,0,0,0,0,0,0
1,201392386,2170660915,22703,36895,2024-10-04 19:28:41,0,0,0,0,0,0
1,201392386,2170660915,5839,36895,2024-10-04 19:28:41,0,0,0,0,0,0
1,201392386,2170660915,0,0,2024-10-04 19:28:41,128,84,212,1,1,2
1,201392386,2170660915,37534,36895,2024-10-04 19:28:41,0,0,0,0,0,0
1,201392386,2170660915,57029,36895,2024-10-04 19:28:42,0,0,0,0,0,0
1,201392386,2170660915,22703,36895,2024-10-04 19:28:42,0,0,0,0,0,0
1,201392386,2170660915,5839,36895,2024-10-04 19:28:42,0,0,0,0,0,0
1,201392386,2170660915,0,0,2024-10-04 19:28:42,128,84,212,1,1,2
1,201392386,2170660915,37534,36895,2024-10-04 19:28:42,0,0,0,0,0,0
1,201392386,2170660915,57029,36895,2024-10-04 19:28:43,0,0,0,0,0,0
1,201392386,2170660915,22703,36895,2024-10-04 19:28:43,0,0,0,0,0,0
1,201392386,2170660915,5839,36895,2024-10-04 19:28:43,0,0,0,0,0,0
1,201392386,2170660915,0,0,2024-10-04 19:28:43,128,84,212,1,1,2
1,201392386,2170660915,37534,36895,2024-10-04 19:28:43,0,0,0,0,0,0
1,201392386,2170660915,57029,36895,2024-10-04 19:28:44,0,0,0,0,0,0
1,201392386,2170660915,22703,36895,2024-10-04 19:28:44,0,0,0,0,0,0
1,201392386,2170660915,5839,36895,2024-10-04 19:28:44,0,0,0,0,0,0
1,201392386,2170660915,0,0,2024-10-04 19:28:44,128,84,212,1,1,2
1,201392386,2170660915,37534,36895,2024-10-04 19:28:44,0,0,0,0,0,0
1,201392386,2170660915,57029,36895,2024-10-04 19:28:45,0,0,0,0,0,0
1,201392386,2170660915,22703,36895,2024-10-04 19:28:45,0,0,0,0,0,0
1,201392386,2170660915,5839,36895,2024-10-04 19:28:45,0,0,0,0,0,0
1,201392386,2170660915,0,0,2024-10-04 19:28:45,0,0,0,0,0,0
1,201392386,2170660915,37534,36895,2024-10-04 19:28:45,0,0,0,0,0,0
1,201392386,2170660915,57029,36895,2024-10-04 19:28:46,0,0,0,0,0,0
1,201392386,2170660915,22703,36895,2024-10-04 19:28:46,0,0,0,0,0,0
1,201392386,2170660915,5839,36895,2024-10-04 19:28:46,0,0,0,0,0,0
1,201392386,2170660915,0,0,2024-10-04 19:28:46,0,0,0,0,0,0
1,201392386,2170660915,37534,36895,2024-10-04 19:28:46,0,0,0,0,0,0
1,201392386,2170660915,57029,36895,2024-10-04 19:28:47,0,0,0,0,0,0
1,201392386,2170660915,15076,36895,2024-10-04 19:28:47,666,507,1173,6,6,12
1,201392386,2170660915,5839,36895,2024-10-04 19:28:47,0,0,0,0,0,0
1,201392386,2170660915,0,0,2024-10-04 19:28:47,128,0,128,1,0,1
1,201392386,2170660915,37534,36895,2024-10-04 19:28:47,0,0,0,0,0,0
1,201392386,2170660915,57029,36895,2024-10-04 19:28:48,0,0,0,0,0,0
1,201392386,2170660915,15076,36895,2024-10-04 19:28:48,0,0,0,0,0,0
1,201392386,2170660915,5839,36895,2024-10-04 19:28:48,0,0,0,0,0,0
1,201392386,2170660915,0,0,2024-10-04 19:28:48,128,84,212,1,1,2
1,201392386,2170660915,37534,36895,2024-10-04 19:28:48,0,0,0,0,0,0
1,201392386,2170660915,57029,36895,2024-10-04 19:28:49,0,0,0,0,0,0
1,201392386,2170660915,15076,36895,2024-10-04 19:28:49,0,0,0,0,0,0
1,201392386,2170660915,5839,36895,2024-10-04 19:28:49,0,0,0,0,0,0
1,201392386,2170660915,0,0,2024-10-04 19:28:49,0,84,84,0,1,1
1,201392386,2170660915,37534,36895,2024-10-04 19:28:49,0,0,0,0,0,0
1,201392386,2170660915,57029,36895,2024-10-04 19:28:50,0,0,0,0,0,0
1,201392386,2170660915,15076,36895,2024-10-04 19:28:50,0,0,0,0,0,0
1,201392386,2170660915,5839,36895,2024-10-04 19:28:50,0,0,0,0,0,0
1,201392386,2170660915,0,0,2024-10-04 19:28:50,128,84,212,1,1,2
1,201392386,2170660915,37534,36895,2024-10-04 19:28:50,0,0,0,0,0,0
1,201392386,2170660915,57029,36895,2024-10-04 19:28:51,0,0,0,0,0,0
1,201392386,2170660915,15076,36895,2024-10-04 19:28:51,0,0,0,0,0,0
1,201392386,2170660915,5839,36895,2024-10-04 19:28:51,0,0,0,0,0,0
1,201392386,2170660915,0,0,2024-10-04 19:28:51,0,0,0,0,0,0
1,201392386,2170660915,37534,36895,2024-10-04 19:28:51,0,0,0,0,0,0
1,201392386,2170660915,57029,36895,2024-10-04 19:28:52,0,0,0,0,0,0
1,201392386,2170660915,15076,36895,2024-10-04 19:28:52,0,0,0,0,0,0
1,201392386,2170660915,5839,36895,2024-10-04 19:28:52,0,0,0,0,0,0
1,201392386,2170660915,0,0,2024-10-04 19:28:52,128,0,128,1,0,1
1,201392386,2170660915,37534,36895,2024-10-04 19:28:52,0,0,0,0,0,0
1,201392386,2170660915,57029,36895,2024-10-04 19:28:53,0,0,0,0,0,0
1,201392386,2170660915,15076,36895,2024-10-04 19:28:53,0,0,0,0,0,0
1,201392386,2170660915,5839,36895,2024-10-04 19:28:53,0,0,0,0,0,0
1,201392386,2170660915,0,0,2024-10-04 19:28:53,128,84,212,1,1,2
1,201392386,2170660915,37534,36895,2024-10-04 19:28:53,0,0,0,0,0,0
1,201392386,2170660915,57029,36895,2024-10-04 19:28:54,0,0,0,0,0,0
1,201392386,2170660915,15076,36895,2024-10-04 19:28:54,0,0,0,0,0,0
1,201392386,2170660915,5839,36895,2024-10-04 19:28:54,0,0,0,0,0,0
1,201392386,2170660915,0,0,2024-10-04 19:28:54,128,84,212,1,1,2
1,201392386,2170660915,37534,36895,2024-10-04 19:28:54,0,0,0,0,0,0
1,201392386,2170660915,57029,36895,2024-10-04 19:28:55,0,0,0,0,0,0
1,201392386,2170660915,15076,36895,2024-10-04 19:28:55,0,0,0,0,0,0
1,201392386,1145490691,36537,47873,2024-10-04 19:28:55,4080,50971,55051,32,42,74
1,201392386,2170660915,5839,36895,2024-10-04 19:28:55,0,0,0,0,0,0
1,201392386,2170660915,0,0,2024-10-04 19:28:55,0,84,84,0,1,1
1,201392386,2170660915,37534,36895,2024-10-04 19:28:55,0,0,0,0,0,0
1,201392386,2170660915,57029,36895,2024-10-04 19:28:56,0,0,0,0,0,0
1,201392386,2170660915,15076,36895,2024-10-04 19:28:56,0,0,0,0,0,0
1,201392386,1145490691,36537,47873,2024-10-04 19:28:56,0,0,0,0,0,0
1,201392386,2170660915,5839,36895,2024-10-04 19:28:56,0,0,0,0,0,0
1,201392386,2170660915,0,0,2024-10-04 19:28:56,0,0,0,0,0,0
1,201392386,2170660915,37534,36895,2024-10-04 19:28:56,0,0,0,0,0,0
1,201392386,2170660915,57029,36895,2024-10-04 19:28:57,0,0,0,0,0,0
1,201392386,2170660915,15076,36895,2024-10-04 19:28:57,0,0,0,0,0,0
1,201392386,1145490691,36537,47873,2024-10-04 19:28:57,3012,46245,49257,30,34,64
1,201392386,2170660915,5839,36895,2024-10-04 19:28:57,0,0,0,0,0,0
1,201392386,2170660915,0,0,2024-10-04 19:28:57,0,0,0,0,0,0
1,201392386,2170660915,37534,36895,2024-10-04 19:28:57,0,0,0,0,0,0
1,201392386,2170660915,57029,36895,2024-10-04 19:28:58,0,0,0,0,0,0
1,201392386,2170660915,15076,36895,2024-10-04 19:28:58,0,0,0,0,0,0
1,201392386,1145490691,36537,47873,2024-10-04 19:28:58,0,0,0,0,0,0
1,201392386,2170660915,5839,36895,2024-10-04 19:28:58,0,0,0,0,0,0
1,201392386,2170660915,0,0,2024-10-04 19:28:58,0,0,0,0,0,0
1,201392386,2170660915,37534,36895,2024-10-04 19:28:58,0,0,0,0,0,0
1,201392386,2170660915,57029,36895,2024-10-04 19:28:59,0,0,0,0,0,0
1,201392386,2170660915,15076,36895,2024-10-04 19:28:59,0,0,0,0,0,0
1,201392386,1145490691,36537,47873,2024-10-04 19:28:59,0,0,0,0,0,0
1,201392386,2170660915,5839,36895,2024-10-04 19:28:59,0,0,0,0,0,0
1,201392386,2170660915,0,0,2024-10-04 19:28:59,0,0,0,0,0,0
1,201392386,2170660915,37534,36895,2024-10-04 19:28:59,0,0,0,0,0,0
1,201392386,2170660915,57029,36895,2024-10-04 19:29:00,0,0,0,0,0,0
1,201392386,2170660915,15076,36895,2024-10-04 19:29:00,0,0,0,0,0,0
1,201392386,1145490691,36537,47873,2024-10-04 19:29:00,0,0,0,0,0,0
1,201392386,2170660915,5839,36895,2024-10-04 19:29:00,0,0,0,0,0,0
1,201392386,2170660915,0,0,2024-10-04 19:29:00,0,0,0,0,0,0
1,201392386,2170660915,37534,36895,2024-10-04 19:29:00,0,0,0,0,0,0
1,201392386,2170660915,57029,36895,2024-10-04 19:29:01,0,0,0,0,0,0
1,201392386,2170660915,15076,36895,2024-10-04 19:29:01,0,0,0,0,0,0
1,201392386,1145490691,36537,47873,2024-10-04 19:29:01,0,0,0,0,0,0
1,201392386,2170660915,5839,36895,2024-10-04 19:29:01,0,0,0,0,0,0
1,201392386,2170660915,0,0,2024-10-04 19:29:01,0,0,0,0,0,0
1,201392386,2170660915,37534,36895,2024-10-04 19:29:01,0,0,0,0,0,0
1,201392386,2170660915,57029,36895,2024-10-04 19:29:02,0,0,0,0,0,0
1,201392386,1145490691,36537,47873,2024-10-04 19:29:02,0,0,0,0,0,0
1,201392386,2170660915,5839,36895,2024-10-04 19:29:02,0,0,0,0,0,0
1,201392386,2170660915,0,0,2024-10-04 19:29:02,0,0,0,0,0,0
1,201392386,2170660915,37534,36895,2024-10-04 19:29:02,0,0,0,0,0,0
1,201392386,2170660915,57029,36895,2024-10-04 19:29:03,0,0,0,0,0,0
1,201392386,1145490691,36537,47873,2024-10-04 19:29:03,0,0,0,0,0,0
1,201392386,2170660915,5839,36895,2024-10-04 19:29:03,0,0,0,0,0,0
1,201392386,2170660915,0,0,2024-10-04 19:29:03,0,0,0,0,0,0
1,201392386,2170660915,37534,36895,2024-10-04 19:29:03,0,0,0,0,0,0
1,201392386,2170660915,57029,36895,2024-10-04 19:29:04,0,0,0,0,0,0
1,201392386,1145490691,36537,47873,2024-10-04 19:29:04,0,0,0,0,0,0
1,201392386,2170660915,5839,36895,2024-10-04 19:29:04,0,0,0,0,0,0
1,201392386,2170660915,0,0,2024-10-04 19:29:04,0,0,0,0,0,0
1,201392386,2170660915,37534,36895,2024-10-04 19:29:04,0,0,0,0,0,0
1,201392386,2170660915,57029,36895,2024-10-04 19:29:05,0,0,0,0,0,0
1,201392386,1145490691,36537,47873,2024-10-04 19:29:05,0,0,0,0,0,0
1,201392386,2170660915,5839,36895,2024-10-04 19:29:05,0,0,0,0,0,0
1,201392386,2170660915,0,0,2024-10-04 19:29:05,0,0,0,0,0,0
1,201392386,2170660915,37534,36895,2024-10-04 19:29:05,0,0,0,0,0,0
1,201392386,2170660915,57029,36895,2024-10-04 19:29:06,0,0,0,0,0,0
1,201392386,1145490691,36537,47873,2024-10-04 19:29:06,0,0,0,0,0,0
1,201392386,2170660915,5839,36895,2024-10-04 19:29:06,0,0,0,0,0,0
1,201392386,2170660915,0,0,2024-10-04 19:29:06,128,0,128,1,0,1
1,201392386,2170660915,37534,36895,2024-10-04 19:29:06,0,0,0,0,0,0
1,201392386,2170660915,57029,36895,2024-10-04 19:29:07,0,0,0,0,0,0
1,201392386,1145490691,36537,47873,2024-10-04 19:29:07,0,0,0,0,0,0
1,201392386,2170660915,5839,36895,2024-10-04 19:29:07,0,0,0,0,0,0
1,201392386,2170660915,0,0,2024-10-04 19:29:07,128,84,212,1,1,2
1,201392386,2170660915,37534,36895,2024-10-04 19:29:07,0,0,0,0,0,0
1,201392386,2170660915,57029,36895,2024-10-04 19:29:08,0,0,0,0,0,0
1,201392386,1145490691,36537,47873,2024-10-04 19:29:08,0,0,0,0,0,0
1,201392386,2170660915,5839,36895,2024-10-04 19:29:08,0,0,0,0,0,0
1,201392386,2170660915,0,0,2024-10-04 19:29:08,128,84,212,1,1,2
1,201392386,2170660915,37534,36895,2024-10-04 19:29:08,0,0,0,0,0,0
1,201392386,2170660915,57029,36895,2024-10-04 19:29:09,0,0,0,0,0,0
1,201392386,1145490691,36537,47873,2024-10-04 19:29:09,0,0,0,0,0,0
1,201392386,2170660915,5839,36895,2024-10-04 19:29:09,0,0,0,0,0,0
1,201392386,2170660915,0,0,2024-10-04 19:29:09,128,84,212,1,1,2
1,201392386,2170660915,37534,36895,2024-10-04 19:29:09,0,0,0,0,0,0
1,201392386,2170660915,57029,36895,2024-10-04 19:29:10,0,0,0,0,0,0
1,201392386,1145490691,36537,47873,2024-10-04 19:29:10,0,0,0,0,0,0
1,201392386,2170660915,5839,36895,2024-10-04 19:29:10,0,0,0,0,0,0
1,201392386,2170660915,0,0,2024-10-04 19:29:10,128,168,296,1,2,3
1,201392386,2170660915,37534,36895,2024-10-04 19:29:10,0,0,0,0,0,0
1,201392386,2170660915,57029,36895,2024-10-04 19:29:11,0,0,0,0,0,0
1,201392386,1145490691,36537,47873,2024-10-04 19:29:11,0,0,0,0,0,0
1,201392386,2170660915,5839,36895,2024-10-04 19:29:11,0,0,0,0,0,0
1,201392386,2170660915,0,0,2024-10-04 19:29:11,128,84,212,1,1,2
1,201392386,2170660915,37534,36895,2024-10-04 19:29:11,0,0,0,0,0,0
1,201392386,2170660915,57029,36895,2024-10-04 19:29:12,0,0,0,0,0,0
1,201392386,1145490691,36537,47873,2024-10-04 19:29:12,0,0,0,0,0,0
1,201392386,2170660915,5839,36895,2024-10-04 19:29:12,0,0,0,0,0,0
1,201392386,2170660915,0,0,2024-10-04 19:29:12,128,84,212,1,1,2
1,201392386,2170660915,37534,36895,2024-10-04 19:29:12,0,0,0,0,0,0
1,201392386,2170660915,57029,36895,2024-10-04 19:29:13,0,0,0,0,0,0
1,201392386,2170660915,5839,36895,2024-10-04 19:29:13,0,0,0,0,0,0
1,201392386,2170660915,0,0,2024-10-04 19:29:13,128,84,212,1,1,2
1,201392386,2170660915,37534,36895,2024-10-04 19:29:13,0,0,0,0,0,0
1,201392386,2170660915,57029,36895,2024-10-04 19:29:14,0,0,0,0,0,0
1,201392386,2170660915,5839,36895,2024-10-04 19:29:14,0,0,0,0,0,0
1,201392386,2170660915,0,0,2024-10-04 19:29:14,128,84,212,1,1,2
1,201392386,2170660915,37534,36895,2024-10-04 19:29:14,0,0,0,0,0,0
1,201392386,2170660915,57029,36895,2024-10-04 19:29:15,0,0,0,0,0,0
1,201392386,2170660915,5839,36895,2024-10-04 19:29:15,0,0,0,0,0,0
1,201392386,2170660915,0,0,2024-10-04 19:29:15,128,84,212,1,1,2
1,201392386,2170660915,37534,36895,2024-10-04 19:29:15,0,0,0,0,0,0
1,201392386,2170660915,57029,36895,2024-10-04 19:29:16,0,0,0,0,0,0
1,201392386,2170660915,5839,36895,2024-10-04 19:29:16,0,0,0,0,0,0
1,201392386,2170660915,0,0,2024-10-04 19:29:16,0,0,0,0,0,0
1,201392386,2170660915,37534,36895,2024-10-04 19:29:16,0,0,0,0,0,0
1,201392386,2170660915,57029,36895,2024-10-04 19:29:17,0,0,0,0,0,0
1,201392386,2170660915,5839,36895,2024-10-04 19:29:17,0,0,0,0,0,0
1,201392386,2170660915,0,0,2024-10-04 19:29:17,0,0,0,0,0,0
1,201392386,2170660915,37534,36895,2024-10-04 19:29:17,0,0,0,0,0,0
1,201392386,2170660915,57029,36895,2024-10-04 19:29:18,0,0,0,0,0,0
1,201392386,2170660915,4237,36895,2024-10-04 19:29:18,666,507,1173,6,6,12
1,201392386,2170660915,0,0,2024-10-04 19:29:18,0,0,0,0,0,0
1,201392386,2170660915,37534,36895,2024-10-04 19:29:18,0,0,0,0,0,0
1,201392386,2170660915,57029,36895,2024-10-04 19:29:19,0,0,0,0,0,0
1,201392386,2170660915,4237,36895,2024-10-04 19:29:19,0,0,0,0,0,0
1,201392386,2170660915,0,0,2024-10-04 19:29:19,128,84,212,1,1,2
1,201392386,2170660915,37534,36895,2024-10-04 19:29:19,0,0,0,0,0,0
1,201392386,2170660915,57029,36895,2024-10-04 19:29:20,0,0,0,0,0,0
1,201392386,2170660915,4237,36895,2024-10-04 19:29:20,0,0,0,0,0,0
1,201392386,2170660915,0,0,2024-10-04 19:29:20,128,84,212,1,1,2
1,201392386,2170660915,37534,36895,2024-10-04 19:29:20,0,0,0,0,0,0
1,201392386,2170660915,57029,36895,2024-10-04 19:29:21,0,0,0,0,0,0
1,201392386,2170660915,0,0,2024-10-04 19:29:21,128,84,212,1,1,2
1,201392386,2170660915,37534,36895,2024-10-04 19:29:21,0,0,0,0,0,0
1,201392386,2170660915,57029,36895,2024-10-04 19:29:22,0,0,0,0,0,0
1,201392386,2170660915,0,0,2024-10-04 19:29:22,0,0,0,0,0,0
1,201392386,2170660915,37534,36895,2024-10-04 19:29:22,0,0,0,0,0,0
1,201392386,2170660915,57029,36895,2024-10-04 19:29:23,0,0,0,0,0,0
1,201392386,2170660915,0,0,2024-10-04 19:29:23,0,0,0,0,0,0
1,201392386,2170660915,37534,36895,2024-10-04 19:29:23,0,0,0,0,0,0
1,201392386,2170660915,57029,36895,2024-10-04 19:29:24,0,0,0,0,0,0
1,201392386,2170660915,0,0,2024-10-04 19:29:24,128,84,212,1,1,2
1,201392386,2170660915,37534,36895,2024-10-04 19:29:24,0,0,0,0,0,0
1,201392386,2170660915,57029,36895,2024-10-04 19:29:25,0,0,0,0,0,0
1,201392386,2170660915,0,0,2024-10-04 19:29:25,128,84,212,1,1,2
1,201392386,2170660915,37534,36895,2024-10-04 19:29:25,0,0,0,0,0,0
1,201392386,2170660915,57029,36895,2024-10-04 19:29:26,0,0,0,0,0,0
1,201392386,1145490691,38621,47873,2024-10-04 19:29:26,3348,40417,43765,25,35,60
1,201392386,2170660915,0,0,2024-10-04 19:29:26,128,84,212,1,1,2
1,201392386,2170660915,37534,36895,2024-10-04 19:29:26,0,0,0,0,0,0
1,201392386,2170660915,57029,36895,2024-10-04 19:29:27,0,0,0,0,0,0
1,201392386,1145490691,38621,47873,2024-10-04 19:29:27,0,0,0,0,0,0
1,201392386,2170660915,0,0,2024-10-04 19:29:27,0,0,0,0,0,0
1,201392386,2170660915,37534,36895,2024-10-04 19:29:27,0,0,0,0,0,0
1,201392386,2170660915,57029,36895,2024-10-04 19:29:28,0,0,0,0,0,0
1,201392386,1145490691,38621,47873,2024-10-04 19:29:28,0,0,0,0,0,0
1,201392386,2170660915,0,0,2024-10-04 19:29:28,0,0,0,0,0,0
1,201392386,2170660915,37534,36895,2024-10-04 19:29:28,0,0,0,0,0,0
1,201392386,2170660915,57029,36895,2024-10-04 19:29:29,0,0,0,0,0,0
1,201392386,1145490691,38621,47873,2024-10-04 19:29:29,0,0,0,0,0,0
1,201392386,2170660915,0,0,2024-10-04 19:29:29,0,0,0,0,0,0
1,201392386,2170660915,37534,36895,2024-10-04 19:29:29,0,0,0,0,0,0
1,201392386,2170660915,57029,36895,2024-10-04 19:29:30,0,0,0,0,0,0
1,201392386,1145490691,38621,47873,2024-10-04 19:29:30,0,0,0,0,0,0
1,201392386,2170660915,0,0,2024-10-04 19:29:30,0,0,0,0,0,0
1,201392386,2170660915,37534,36895,2024-10-04 19:29:30,0,0,0,0,0,0
1,201392386,2170660915,57029,36895,2024-10-04 19:29:31,0,0,0,0,0,0
1,201392386,1145490691,38621,47873,2024-10-04 19:29:31,0,0,0,0,0,0
1,201392386,2170660915,0,0,2024-10-04 19:29:31,0,0,0,0,0,0
1,201392386,2170660915,37534,36895,2024-10-04 19:29:31,0,0,0,0,0,0
1,201392386,2170660915,57029,36895,2024-10-04 19:29:32,0,0,0,0,0,0
1,201392386,1145490691,38621,47873,2024-10-04 19:29:32,3528,60815,64343,35,42,77
1,201392386,2170660915,0,0,2024-10-04 19:29:32,0,0,0,0,0,0
1,201392386,2170660915,37534,36895,2024-10-04 19:29:32,0,0,0,0,0,0
1,201392386,2170660915,57029,36895,2024-10-04 19:29:33,0,0,0,0,0,0
1,201392386,1145490691,38621,47873,2024-10-04 19:29:33,0,0,0,0,0,0
1,201392386,2170660915,0,0,2024-10-04 19:29:33,0,0,0,0,0,0
1,201392386,2170660915,37534,36895,2024-10-04 19:29:33,0,0,0,0,0,0
1,201392386,2170660915,57029,36895,2024-10-04 19:29:34,0,0,0,0,0,0
1,201392386,1145490691,38621,47873,2024-10-04 19:29:34,0,0,0,0,0,0
1,201392386,2170660915,0,0,2024-10-04 19:29:34,0,0,0,0,0,0
1,201392386,2170660915,37534,36895,2024-10-04 19:29:34,0,0,0,0,0,0
1,201392386,2170660915,57029,36895,2024-10-04 19:29:35,0,0,0,0,0,0
1,201392386,1145490691,38621,47873,2024-10-04 19:29:35,0,0,0,0,0,0
1,201392386,2170660915,0,0,2024-10-04 19:29:35,0,0,0,0,0,0
1,201392386,2170660915,37534,36895,2024-10-04 19:29:35,0,0,0,0,0,0
1,201392386,2170660915,57029,36895,2024-10-04 19:29:36,0,0,0,0,0,0
1,201392386,1145490691,38621,47873,2024-10-04 19:29:36,0,0,0,0,0,0
1,201392386,2170660915,0,0,2024-10-04 19:29:36,0,0,0,0,0,0
1,201392386,2170660915,37534,36895,2024-10-04 19:29:36,0,0,0,0,0,0
1,201392386,2170660915,57029,36895,2024-10-04 19:29:37,0,0,0,0,0,0
1,201392386,1145490691,38621,47873,2024-10-04 19:29:37,0,0,0,0,0,0
1,201392386,2170660915,0,0,2024-10-04 19:29:37,128,84,212,1,1,2
1,201392386,2170660915,37534,36895,2024-10-04 19:29:37,0,0,0,0,0,0
1,201392386,2170660915,57029,36895,2024-10-04 19:29:38,0,0,0,0,0,0
1,201392386,1145490691,38621,47873,2024-10-04 19:29:38,0,0,0,0,0,0
1,201392386,2170660915,0,0,2024-10-04 19:29:38,128,84,212,1,1,2
1,201392386,2170660915,37534,36895,2024-10-04 19:29:38,0,0,0,0,0,0
1,201392386,2170660915,57029,36895,2024-10-04 19:29:39,0,0,0,0,0,0
1,201392386,1145490691,38621,47873,2024-10-04 19:29:39,0,0,0,0,0,0
1,201392386,2170660915,0,0,2024-10-04 19:29:39,128,84,212,1,1,2
1,201392386,2170660915,37534,36895,2024-10-04 19:29:39,0,0,0,0,0,0
1,201392386,2170660915,57029,36895,2024-10-04 19:29:40,0,0,0,0,0,0
1,201392386,1145490691,38621,47873,2024-10-04 19:29:40,0,0,0,0,0,0
1,201392386,2170660915,0,0,2024-10-04 19:29:40,0,0,0,0,0,0
1,201392386,2170660915,37534,36895,2024-10-04 19:29:40,0,0,0,0,0,0
1,201392386,2170660915,57029,36895,2024-10-04 19:29:41,0,0,0,0,0,0
1,201392386,1145490691,38621,47873,2024-10-04 19:29:41,0,0,0,0,0,0
1,201392386,2170660915,0,0,2024-10-04 19:29:41,128,84,212,1,1,2
1,201392386,2170660915,37534,36895,2024-10-04 19:29:41,0,0,0,0,0,0
1,201392386,2170660915,57029,36895,2024-10-04 19:29:42,0,0,0,0,0,0
1,201392386,1145490691,38621,47873,2024-10-04 19:29:42,0,0,0,0,0,0
1,201392386,2170660915,0,0,2024-10-04 19:29:42,128,84,212,1,1,2
1,201392386,2170660915,37534,36895,2024-10-04 19:29:42,0,0,0,0,0,0
1,201392386,2170660915,57029,36895,2024-10-04 19:29:43,0,0,0,0,0,0
1,201392386,2170660915,0,0,2024-10-04 19:29:43,256,84,340,2,1,3
1,201392386,2170660915,37534,36895,2024-10-04 19:29:43,0,0,0,0,0,0
1,201392386,2170660915,57029,36895,2024-10-04 19:29:44,0,0,0,0,0,0
1,201392386,2170660915,0,0,2024-10-04 19:29:44,128,84,212,1,1,2
1,201392386,2170660915,37534,36895,2024-10-04 19:29:44,0,0,0,0,0,0
1,201392386,2170660915,57029,36895,2024-10-04 19:29:45,0,0,0,0,0,0
1,201392386,2170660915,0,0,2024-10-04 19:29:45,128,84,212,1,1,2
1,201392386,2170660915,37534,36895,2024-10-04 19:29:45,0,0,0,0,0,0
1,201392386,2170660915,57029,36895,2024-10-04 19:29:46,0,0,0,0,0,0
1,201392386,2170660915,0,0,2024-10-04 19:29:46,128,84,212,1,1,2
1,201392386,2170660915,37534,36895,2024-10-04 19:29:46,0,0,0,0,0,0
1,201392386,2170660915,57029,36895,2024-10-04 19:29:47,0,0,0,0,0,0
1,201392386,2170660915,0,0,2024-10-04 19:29:47,0,84,84,0,1,1
1,201392386,2170660915,37534,36895,2024-10-04 19:29:47,0,0,0,0,0,0
1,201392386,2170660915,57029,36895,2024-10-04 19:29:48,0,0,0,0,0,0
1,201392386,2170660915,5828,36895,2024-10-04 19:29:48,666,507,1173,6,6,12
1,201392386,2170660915,0,0,2024-10-04 19:29:48,0,0,0,0,0,0
1,201392386,2170660915,37534,36895,2024-10-04 19:29:48,0,0,0,0,0,0
1,201392386,2170660915,57029,36895,2024-10-04 19:29:49,0,0,0,0,0,0
1,201392386,2170660915,5828,36895,2024-10-04 19:29:49,0,0,0,0,0,0
1,201392386,2170660915,0,0,2024-10-04 19:29:49,128,84,212,1,1,2
1,201392386,2170660915,37534,36895,2024-10-04 19:29:49,0,0,0,0,0,0
1,201392386,2170660915,57029,36895,2024-10-04 19:29:50,0,0,0,0,0,0
1,201392386,2170660915,5828,36895,2024-10-04 19:29:50,0,0,0,0,0,0
1,201392386,2170660915,0,0,2024-10-04 19:29:50,128,84,212,1,1,2
1,201392386,2170660915,37534,36895,2024-10-04 19:29:50,0,0,0,0,0,0
1,201392386,2170660915,57029,36895,2024-10-04 19:29:51,0,0,0,0,0,0
1,201392386,2170660915,5828,36895,2024-10-04 19:29:51,0,0,0,0,0,0
1,201392386,2170660915,0,0,2024-10-04 19:29:51,128,84,212,1,1,2
1,201392386,2170660915,37534,36895,2024-10-04 19:29:51,0,0,0,0,0,0
1,201392386,2170660915,57029,36895,2024-10-04 19:29:52,0,0,0,0,0,0
1,201392386,2170660915,0,0,2024-10-04 19:29:52,0,0,0,0,0,0
1,201392386,2170660915,37534,36895,2024-10-04 19:29:52,0,0,0,0,0,0
1,201392386,2170660915,57029,36895,2024-10-04 19:29:53,0,0,0,0,0,0
1,201392386,2170660915,0,0,2024-10-04 19:29:53,0,0,0,0,0,0
1,201392386,2170660915,37534,36895,2024-10-04 19:29:53,0,0,0,0,0,0
1,201392386,2170660915,57029,36895,2024-10-04 19:29:54,0,0,0,0,0,0
1,201392386,2170660915,0,0,2024-10-04 19:29:54,128,0,128,1,0,1
1,201392386,2170660915,37534,36895,2024-10-04 19:29:54,0,0,0,0,0,0
1,201392386,2170660915,57029,36895,2024-10-04 19:29:55,0,0,0,0,0,0
1,201392386,2170660915,0,0,2024-10-04 19:29:55,128,84,212,1,1,2
1,201392386,2170660915,37534,36895,2024-10-04 19:29:55,0,0,0,0,0,0
1,201392386,2170660915,57029,36895,2024-10-04 19:29:56,0,0,0,0,0,0
1,201392386,2170660915,0,0,2024-10-04 19:29:56,0,84,84,0,1,1
1,201392386,2170660915,37534,36895,2024-10-04 19:29:56,0,0,0,0,0,0
1,201392386,2170660915,57029,36895,2024-10-04 19:29:57,0,0,0,0,0,0
1,201392386,1145490692,47233,47873,2024-10-04 19:29:57,3660,52325,55985,28,44,72
1,201392386,2170660915,0,0,2024-10-04 19:29:57,128,84,212,1,1,2
1,201392386,2170660915,37534,36895,2024-10-04 19:29:57,0,0,0,0,0,0
1,201392386,2170660915,57029,36895,2024-10-04 19:29:58,0,0,0,0,0,0
1,201392386,1145490692,47233,47873,2024-10-04 19:29:58,0,0,0,0,0,0
1,201392386,2170660915,0,0,2024-10-04 19:29:58,0,0,0,0,0,0
1,201392386,2170660915,37534,36895,2024-10-04 19:29:58,0,0,0,0,0,0
1,201392386,2170660915,57029,36895,2024-10-04 19:29:59,0,0,0,0,0,0
1,201392386,1145490692,47233,47873,2024-10-04 19:29:59,0,0,0,0,0,0
1,201392386,2170660915,0,0,2024-10-04 19:29:59,0,0,0,0,0,0
1,201392386,2170660915,37534,36895,2024-10-04 19:29:59,0,0,0,0,0,0
1,201392386,2170660915,57029,36895,2024-10-04 19:30:00,0,0,0,0,0,0
1,201392386,1145490692,47233,47873,2024-10-04 19:30:00,0,0,0,0,0,0
1,201392386,2170660915,0,0,2024-10-04 19:30:00,0,0,0,0,0,0
1,201392386,2170660915,37534,36895,2024-10-04 19:30:00,0,0,0,0,0,0
1,201392386,2170660915,57029,36895,2024-10-04 19:30:01,0,0,0,0,0,0
1,201392386,1145490692,47233,47873,2024-10-04 19:30:01,0,0,0,0,0,0
1,201392386,2170660915,0,0,2024-10-04 19:30:01,0,0,0,0,0,0
1,201392386,2170660915,37534,36895,2024-10-04 19:30:01,0,0,0,0,0,0
1,201392386,2170660915,57029,36895,2024-10-04 19:30:02,0,0,0,0,0,0
1,201392386,1145490692,47233,47873,2024-10-04 19:30:02,0,0,0,0,0,0
1,201392386,2170660915,0,0,2024-10-04 19:30:02,0,0,0,0,0,0
1,201392386,2170660915,37534,36895,2024-10-04 19:30:02,0,0,0,0,0,0
1,201392386,2170660915,57029,36895,2024-10-04 19:30:03,0,0,0,0,0,0
1,201392386,1145490692,47233,47873,2024-10-04 19:30:03,2856,53153,56009,28,38,66
1,201392386,2170660915,0,0,2024-10-04 19:30:03,0,0,0,0,0,0
1,201392386,2170660915,37534,36895,2024-10-04 19:30:03,0,0,0,0,0,0
1,201392386,2170660915,57029,36895,2024-10-04 19:30:04,0,0,0,0,0,0
1,201392386,1145490692,47233,47873,2024-10-04 19:30:04,0,0,0,0,0,0
1,201392386,2170660915,0,0,2024-10-04 19:30:04,0,0,0,0,0,0
1,201392386,2170660915,37534,36895,2024-10-04 19:30:04,0,0,0,0,0,0
1,201392386,2170660915,57029,36895,2024-10-04 19:30:05,0,0,0,0,0,0
1,201392386,1145490692,47233,47873,2024-10-04 19:30:05,0,0,0,0,0,0
1,201392386,2170660915,0,0,2024-10-04 19:30:05,0,0,0,0,0,0
1,201392386,2170660915,37534,36895,2024-10-04 19:30:05,0,0,0,0,0,0
1,201392386,2170660915,57029,36895,2024-10-04 19:30:06,0,0,0,0,0,0
1,201392386,1145490692,47233,47873,2024-10-04 19:30:06,0,0,0,0,0,0
1,201392386,2170660915,0,0,2024-10-04 19:30:06,0,0,0,0,0,0
1,201392386,2170660915,37534,36895,2024-10-04 19:30:06,0,0,0,0,0,0
1,201392386,2170660915,57029,36895,2024-10-04 19:30:07,0,0,0,0,0,0
1,201392386,1145490692,47233,47873,2024-10-04 19:30:07,0,0,0,0,0,0
1,201392386,2170660915,0,0,2024-10-04 19:30:07,0,0,0,0,0,0
1,201392386,2170660915,37534,36895,2024-10-04 19:30:07,0,0,0,0,0,0
1,201392386,2170660915,57029,36895,2024-10-04 19:30:08,0,0,0,0,0,0
1,201392386,1145490692,47233,47873,2024-10-04 19:30:08,0,0,0,0,0,0
1,201392386,2170660915,0,0,2024-10-04 19:30:08,128,84,212,1,1,2
1,201392386,2170660915,37534,36895,2024-10-04 19:30:08,0,0,0,0,0,0
1,201392386,2170660915,57029,36895,2024-10-04 19:30:09,0,0,0,0,0,0
1,201392386,1145490692,47233,47873,2024-10-04 19:30:09,0,0,0,0,0,0
1,201392386,2170660915,0,0,2024-10-04 19:30:09,128,84,212,1,1,2
1,201392386,2170660915,37534,36895,2024-10-04 19:30:09,0,0,0,0,0,0
1,201392386,2170660915,57029,36895,2024-10-04 19:30:10,0,0,0,0,0,0
1,201392386,1145490692,47233,47873,2024-10-04 19:30:10,0,0,0,0,0,0
1,201392386,2170660915,0,0,2024-10-04 19:30:10,128,84,212,1,1,2
1,201392386,2170660915,37534,36895,2024-10-04 19:30:10,0,0,0,0,0,0
1,201392386,2170660915,57029,36895,2024-10-04 19:30:11,0,0,0,0,0,0
1,201392386,1145490692,47233,47873,2024-10-04 19:30:11,0,0,0,0,0,0
1,201392386,2170660915,0,0,2024-10-04 19:30:11,128,84,212,1,1,2
1,201392386,2170660915,37534,36895,2024-10-04 19:30:11,0,0,0,0,0,0
1,201392386,2170660915,57029,36895,2024-10-04 19:30:12,0,0,0,0,0,0
1,201392386,1145490692,47233,47873,2024-10-04 19:30:12,0,0,0,0,0,0
1,201392386,2170660915,0,0,2024-10-04 19:30:12,128,0,128,1,0,1
1,201392386,2170660915,37534,36895,2024-10-04 19:30:12,0,0,0,0,0,0
1,201392386,2170660915,57029,36895,2024-10-04 19:30:13,0,0,0,0,0,0
1,201392386,2170660915,0,0,2024-10-04 19:30:13,0,84,84,0,1,1
1,201392386,2170660915,37534,36895,2024-10-04 19:30:13,0,0,0,0,0,0
1,201392386,2170660915,57029,36895,2024-10-04 19:30:14,0,0,0,0,0,0
1,201392386,2170660915,0,0,2024-10-04 19:30:14,256,84,340,2,1,3
1,201392386,2170660915,37534,36895,2024-10-04 19:30:14,0,0,0,0,0,0
1,201392386,2170660915,57029,36895,2024-10-04 19:30:15,0,0,0,0,0,0
1,201392386,2170660915,0,0,2024-10-04 19:30:15,128,84,212,1,1,2
1,201392386,2170660915,37534,36895,2024-10-04 19:30:15,0,0,0,0,0,0
1,201392386,2170660915,57029,36895,2024-10-04 19:30:16,0,0,0,0,0,0
1,201392386,2170660915,0,0,2024-10-04 19:30:16,128,84,212,1,1,2
1,201392386,2170660915,37534,36895,2024-10-04 19:30:16,0,0,0,0,0,0
1,201392386,2170660915,57029,36895,2024-10-04 19:30:17,0,0,0,0,0,0
1,201392386,2170660915,0,0,2024-10-04 19:30:17,128,84,212,1,1,2
1,201392386,2170660915,37534,36895,2024-10-04 19:30:17,0,0,0,0,0,0
1,201392386,2170660915,57029,36895,2024-10-04 19:30:18,0,0,0,0,0,0
1,201392386,2170660915,0,0,2024-10-04 19:30:18,0,84,84,0,1,1
1,201392386,2170660915,37534,36895,2024-10-04 19:30:18,0,0,0,0,0,0
1,201392386,2170660915,57029,36895,2024-10-04 19:30:19,0,0,0,0,0,0
1,201392386,2170660915,41606,36895,2024-10-04 19:30:19,666,507,1173,6,6,12
1,201392386,2170660915,0,0,2024-10-04 19:30:19,0,0,0,0,0,0
1,201392386,2170660915,37534,36895,2024-10-04 19:30:19,0,0,0,0,0,0
1,201392386,2170660915,57029,36895,2024-10-04 19:30:20,0,0,0,0,0,0
1,201392386,2170660915,41606,36895,2024-10-04 19:30:20,0,0,0,0,0,0
1,201392386,2170660915,0,0,2024-10-04 19:30:20,128,84,212,1,1,2
1,201392386,2170660915,37534,36895,2024-10-04 19:30:20,0,0,0,0,0,0
1,201392386,2170660915,57029,36895,2024-10-04 19:30:21,0,0,0,0,0,0
1,201392386,2170660915,41606,36895,2024-10-04 19:30:21,0,0,0,0,0,0
1,201392386,2170660915,0,0,2024-10-04 19:30:21,128,84,212,1,1,2
1,201392386,2170660915,37534,36895,2024-10-04 19:30:21,0,0,0,0,0,0
1,201392386,2170660915,57029,36895,2024-10-04 19:30:22,0,0,0,0,0,0
1,201392386,2170660915,0,0,2024-10-04 19:30:22,128,0,128,1,0,1
1,201392386,2170660915,37534,36895,2024-10-04 19:30:22,0,0,0,0,0,0
1,201392386,2170660915,57029,36895,2024-10-04 19:30:23,0,0,0,0,0,0
1,201392386,2170660915,0,0,2024-10-04 19:30:23,0,0,0,0,0,0
1,201392386,2170660915,37534,36895,2024-10-04 19:30:23,0,0,0,0,0,0
1,201392386,2170660915,57029,36895,2024-10-04 19:30:24,0,0,0,0,0,0
1,201392386,2170660915,0,0,2024-10-04 19:30:24,0,0,0,0,0,0
1,201392386,2170660915,37534,36895,2024-10-04 19:30:24,0,0,0,0,0,0
1,201392386,2170660915,57029,36895,2024-10-04 19:30:25,0,0,0,0,0,0
1,201392386,2170660915,0,0,2024-10-04 19:30:25,0,84,84,0,1,1
1,201392386,2170660915,37534,36895,2024-10-04 19:30:25,0,0,0,0,0,0
1,201392386,2170660915,57029,36895,2024-10-04 19:30:26,0,0,0,0,0,0
1,201392386,2170660915,0,0,2024-10-04 19:30:26,128,0,128,1,0,1
1,201392386,2170660915,37534,36895,2024-10-04 19:30:26,0,0,0,0,0,0
1,201392386,2170660915,57029,36895,2024-10-04 19:30:27,0,0,0,0,0,0
1,201392386,2170660915,0,0,2024-10-04 19:30:27,128,168,296,1,2,3
1,201392386,2170660915,37534,36895,2024-10-04 19:30:27,0,0,0,0,0,0
1,201392386,2170660915,57029,36895,2024-10-04 19:30:28,0,0,0,0,0,0
1,201392386,1145490690,50381,47873,2024-10-04 19:30:28,3564,39189,42753,27,35,62
1,201392386,2170660915,0,0,2024-10-04 19:30:28,128,84,212,1,1,2
1,201392386,2170660915,37534,36895,2024-10-04 19:30:28,0,0,0,0,0,0
1,201392386,2170660915,57029,36895,2024-10-04 19:30:29,0,0,0,0,0,0
1,201392386,1145490690,50381,47873,2024-10-04 19:30:29,0,0,0,0,0,0
1,201392386,2170660915,0,0,2024-10-04 19:30:29,0,0,0,0,0,0
1,201392386,2170660915,37534,36895,2024-10-04 19:30:29,0,0,0,0,0,0
1,201392386,2170660915,57029,36895,2024-10-04 19:30:30,0,0,0,0,0,0
1,201392386,1145490690,50381,47873,2024-10-04 19:30:30,0,0,0,0,0,0
1,201392386,2170660915,0,0,2024-10-04 19:30:30,0,0,0,0,0,0
1,201392386,2170660915,37534,36895,2024-10-04 19:30:30,0,0,0,0,0,0
1,201392386,2170660915,57029,36895,2024-10-04 19:30:31,0,0,0,0,0,0
1,201392386,1145490690,50381,47873,2024-10-04 19:30:31,0,0,0,0,0,0
1,201392386,2170660915,0,0,2024-10-04 19:30:31,0,0,0,0,0,0
1,201392386,2170660915,37534,36895,2024-10-04 19:30:31,0,0,0,0,0,0
1,201392386,2170660915,57029,36895,2024-10-04 19:30:32,0,0,0,0,0,0
1,201392386,1145490690,50381,47873,2024-10-04 19:30:32,0,0,0,0,0,0
1,201392386,2170660915,0,0,2024-10-04 19:30:32,0,0,0,0,0,0
1,201392386,2170660915,37534,36895,2024-10-04 19:30:32,0,0,0,0,0,0
1,201392386,2170660915,57029,36895,2024-10-04 19:30:33,0,0,0,0,0,0
1,201392386,1145490690,50381,47873,2024-10-04 19:30:33,2532,51873,54405,25,37,62
1,201392386,2170660915,0,0,2024-10-04 19:30:33,0,0,0,0,0,0
1,201392386,2170660915,37534,36895,2024-10-04 19:30:33,0,0,0,0,0,0
1,201392386,2170660915,57029,36895,2024-10-04 19:30:34,0,0,0,0,0,0
1,201392386,1145490690,50381,47873,2024-10-04 19:30:34,0,0,0,0,0,0
1,201392386,2170660915,0,0,2024-10-04 19:30:34,0,0,0,0,0,0
1,201392386,2170660915,37534,36895,2024-10-04 19:30:34,0,0,0,0,0,0
1,201392386,2170660915,57029,36895,2024-10-04 19:30:35,0,0,0,0,0,0
1,201392386,1145490690,50381,47873,2024-10-04 19:30:35,0,0,0,0,0,0
1,201392386,2170660915,0,0,2024-10-04 19:30:35,0,0,0,0,0,0
1,201392386,2170660915,37534,36895,2024-10-04 19:30:35,0,0,0,0,0,0
1,201392386,2170660915,57029,36895,2024-10-04 19:30:36,0,0,0,0,0,0
1,201392386,1145490690,50381,47873,2024-10-04 19:30:36,0,0,0,0,0,0
1,201392386,2170660915,0,0,2024-10-04 19:30:36,0,0,0,0,0,0
1,201392386,2170660915,37534,36895,2024-10-04 19:30:36,0,0,0,0,0,0
1,201392386,2170660915,57029,36895,2024-10-04 19:30:37,0,0,0,0,0,0
1,201392386,1145490690,50381,47873,2024-10-04 19:30:37,0,0,0,0,0,0
1,201392386,2170660915,0,0,2024-10-04 19:30:37,0,0,0,0,0,0
1,201392386,2170660915,37534,36895,2024-10-04 19:30:37,0,0,0,0,0,0
1,201392386,2170660915,57029,36895,2024-10-04 19:30:38,0,0,0,0,0,0
1,201392386,1145490690,50381,47873,2024-10-04 19:30:38,0,0,0,0,0,0
1,201392386,2170660915,0,0,2024-10-04 19:30:38,0,0,0,0,0,0
1,201392386,2170660915,37534,36895,2024-10-04 19:30:38,0,0,0,0,0,0
1,201392386,2170660915,57029,36895,2024-10-04 19:30:39,0,0,0,0,0,0
1,201392386,1145490690,50381,47873,2024-10-04 19:30:39,0,0,0,0,0,0
1,201392386,2170660915,0,0,2024-10-04 19:30:39,128,0,128,1,0,1
1,201392386,2170660915,37534,36895,2024-10-04 19:30:39,0,0,0,0,0,0
1,201392386,2170660915,57029,36895,2024-10-04 19:30:40,0,0,0,0,0,0
1,201392386,1145490690,50381,47873,2024-10-04 19:30:40,0,0,0,0,0,0
1,201392386,2170660915,0,0,2024-10-04 19:30:40,128,84,212,1,1,2
1,201392386,2170660915,37534,36895,2024-10-04 19:30:40,0,0,0,0,0,0
1,201392386,2170660915,57029,36895,2024-10-04 19:30:41,0,0,0,0,0,0
1,201392386,1145490690,50381,47873,2024-10-04 19:30:41,0,0,0,0,0,0
1,201392386,2170660915,0,0,2024-10-04 19:30:41,128,168,296,1,2,3
1,201392386,2170660915,37534,36895,2024-10-04 19:30:41,0,0,0,0,0,0
1,201392386,2170660915,57029,36895,2024-10-04 19:30:42,0,0,0,0,0,0
1,201392386,1145490690,50381,47873,2024-10-04 19:30:42,0,0,0,0,0,0
1,201392386,2170660915,0,0,2024-10-04 19:30:42,128,84,212,1,1,2
1,201392386,2170660915,37534,36895,2024-10-04 19:30:42,0,0,0,0,0,0
1,201392386,2170660915,57029,36895,2024-10-04 19:30:43,0,0,0,0,0,0
1,201392386,1145490690,50381,47873,2024-10-04 19:30:43,0,0,0,0,0,0
1,201392386,2170660915,0,0,2024-10-04 19:30:43,128,84,212,1,1,2
1,201392386,2170660915,37534,36895,2024-10-04 19:30:43,0,0,0,0,0,0
1,201392386,2170660915,57029,36895,2024-10-04 19:30:44,0,0,0,0,0,0
1,201392386,2170660915,0,0,2024-10-04 19:30:44,128,84,212,1,1,2
1,201392386,2170660915,37534,36895,2024-10-04 19:30:44,0,0,0,0,0,0
1,201392386,2170660915,57029,36895,2024-10-04 19:30:45,0,0,0,0,0,0
1,201392386,2170660915,0,0,2024-10-04 19:30:45,128,84,212,1,1,2
1,201392386,2170660915,37534,36895,2024-10-04 19:30:45,0,0,0,0,0,0
1,201392386,2170660915,57029,36895,2024-10-04 19:30:46,0,0,0,0,0,0
1,201392386,2170660915,0,0,2024-10-04 19:30:46,128,84,212,1,1,2
1,201392386,2170660915,37534,36895,2024-10-04 19:30:46,0,0,0,0,0,0
1,201392386,2170660915,57029,36895,2024-10-04 19:30:47,0,0,0,0,0,0
1,201392386,2170660915,0,0,2024-10-04 19:30:47,128,84,212,1,1,2
1,201392386,2170660915,37534,36895,2024-10-04 19:30:47,0,0,0,0,0,0
1,201392386,2170660915,57029,36895,2024-10-04 19:30:48,0,0,0,0,0,0
1,201392386,2170660915,0,0,2024-10-04 19:30:48,128,84,212,1,1,2
1,201392386,2170660915,37534,36895,2024-10-04 19:30:48,0,0,0,0,0,0
1,201392386,2170660915,57029,36895,2024-10-04 19:30:49,0,0,0,0,0,0
1,201392386,2170660915,0,0,2024-10-04 19:30:49,0,0,0,0,0,0
1,201392386,2170660915,37534,36895,2024-10-04 19:30:49,0,0,0,0,0,0
1,201392386,2170660915,57029,36895,2024-10-04 19:30:50,0,0,0,0,0,0
1,201392386,2170660915,5303,36895,2024-10-04 19:30:50,666,507,1173,6,6,12
1,201392386,2170660915,0,0,2024-10-04 19:30:50,0,0,0,0,0,0
1,201392386,2170660915,37534,36895,2024-10-04 19:30:50,0,0,0,0,0,0
1,201392386,2170660915,57029,36895,2024-10-04 19:30:51,0,0,0,0,0,0
1,201392386,2170660915,5303,36895,2024-10-04 19:30:51,0,0,0,0,0,0
1,201392386,2170660915,0,0,2024-10-04 19:30:51,128,84,212,1,1,2
1,201392386,2170660915,37534,36895,2024-10-04 19:30:51,0,0,0,0,0,0
1,201392386,2170660915,57029,36895,2024-10-04 19:30:52,0,0,0,0,0,0
1,201392386,2170660915,5303,36895,2024-10-04 19:30:52,0,0,0,0,0,0
1,201392386,2170660915,0,0,2024-10-04 19:30:52,128,84,212,1,1,2
1,201392386,2170660915,37534,36895,2024-10-04 19:30:52,0,0,0,0,0,0
1,201392386,2170660915,57029,36895,2024-10-04 19:30:53,0,0,0,0,0,0
1,201392386,2170660915,5303,36895,2024-10-04 19:30:53,0,0,0,0,0,0
1,201392386,2170660915,0,0,2024-10-04 19:30:53,128,84,212,1,1,2
1,201392386,2170660915,37534,36895,2024-10-04 19:30:53,0,0,0,0,0,0
1,201392386,2170660915,57029,36895,2024-10-04 19:30:54,0,0,0,0,0,0
1,201392386,2170660915,5303,36895,2024-10-04 19:30:54,0,0,0,0,0,0
1,201392386,2170660915,0,0,2024-10-04 19:30:54,0,0,0,0,0,0
1,201392386,2170660915,37534,36895,2024-10-04 19:30:54,0,0,0,0,0,0
1,201392386,2170660915,57029,36895,2024-10-04 19:30:55,0,0,0,0,0,0
1,201392386,2170660915,5303,36895,2024-10-04 19:30:55,0,0,0,0,0,0
1,201392386,2170660915,0,0,2024-10-04 19:30:55,0,0,0,0,0,0
1,201392386,2170660915,37534,36895,2024-10-04 19:30:55,0,0,0,0,0,0
1,201392386,2170660915,57029,36895,2024-10-04 19:30:56,0,0,0,0,0,0
1,201392386,2170660915,5303,36895,2024-10-04 19:30:56,0,0,0,0,0,0
1,201392386,2170660915,0,0,2024-10-04 19:30:56,128,0,128,1,0,1
1,201392386,2170660915,37534,36895,2024-10-04 19:30:56,0,0,0,0,0,0
1,201392386,2170660915,57029,36895,2024-10-04 19:30:57,0,0,0,0,0,0
1,201392386,2170660915,5303,36895,2024-10-04 19:30:57,0,0,0,0,0,0
1,201392386,2170660915,0,0,2024-10-04 19:30:57,128,84,212,1,1,2
1,201392386,2170660915,37534,36895,2024-10-04 19:30:57,0,0,0,0,0,0
1,201392386,2170660915,57029,36895,2024-10-04 19:30:58,0,0,0,0,0,0
1,201392386,2170660915,5303,36895,2024-10-04 19:30:58,0,0,0,0,0,0
1,201392386,2170660915,0,0,2024-10-04 19:30:58,128,84,212,1,1,2
1,201392386,2170660915,37534,36895,2024-10-04 19:30:58,0,0,0,0,0,0
1,201392386,1145490692,47237,47873,2024-10-04 19:30:59,5548,92995,98543,46,69,115
1,201392386,2170660915,57029,36895,2024-10-04 19:30:59,0,0,0,0,0,0
1,201392386,2170660915,5303,36895,2024-10-04 19:30:59,0,0,0,0,0,0
1,201392386,2170660915,0,0,2024-10-04 19:30:59,0,84,84,0,1,1
1,201392386,2170660915,37534,36895,2024-10-04 19:30:59,0,0,0,0,0,0
1,201392386,1145490692,47237,47873,2024-10-04 19:31:00,0,0,0,0,0,0
1,201392386,2170660915,57029,36895,2024-10-04 19:31:00,0,0,0,0,0,0
1,201392386,2170660915,5303,36895,2024-10-04 19:31:00,0,0,0,0,0,0
1,201392386,2170660915,0,0,2024-10-04 19:31:00,0,0,0,0,0,0
1,201392386,2170660915,37534,36895,2024-10-04 19:31:00,0,0,0,0,0,0
1,201392386,1145490692,47237,47873,2024-10-04 19:31:01,0,0,0,0,0,0
1,201392386,2170660915,57029,36895,2024-10-04 19:31:01,0,0,0,0,0,0
1,201392386,2170660915,5303,36895,2024-10-04 19:31:01,0,0,0,0,0,0
1,201392386,2170660915,0,0,2024-10-04 19:31:01,0,0,0,0,0,0
1,201392386,2170660915,37534,36895,2024-10-04 19:31:01,0,0,0,0,0,0
1,201392386,1145490692,47237,47873,2024-10-04 19:31:02,0,0,0,0,0,0
1,201392386,2170660915,57029,36895,2024-10-04 19:31:02,0,0,0,0,0,0
1,201392386,2170660915,5303,36895,2024-10-04 19:31:02,0,0,0,0,0,0
1,201392386,2170660915,0,0,2024-10-04 19:31:02,0,0,0,0,0,0
1,201392386,2170660915,37534,36895,2024-10-04 19:31:02,0,0,0,0,0,0
1,201392386,1145490692,47237,47873,2024-10-04 19:31:03,984,8237,9221,10,8,18
1,201392386,2170660915,57029,36895,2024-10-04 19:31:03,0,0,0,0,0,0
1,201392386,2170660915,5303,36895,2024-10-04 19:31:03,0,0,0,0,0,0
1,201392386,2170660915,0,0,2024-10-04 19:31:03,0,0,0,0,0,0
1,201392386,2170660915,37534,36895,2024-10-04 19:31:03,0,0,0,0,0,0
1,201392386,1145490692,47237,47873,2024-10-04 19:31:04,0,0,0,0,0,0
1,201392386,2170660915,57029,36895,2024-10-04 19:31:04,0,0,0,0,0,0
1,201392386,2170660915,5303,36895,2024-10-04 19:31:04,0,0,0,0,0,0
1,201392386,2170660915,0,0,2024-10-04 19:31:04,0,0,0,0,0,0
1,201392386,2170660915,37534,36895,2024-10-04 19:31:04,0,0,0,0,0,0
1,201392386,1145490692,47237,47873,2024-10-04 19:31:05,0,0,0,0,0,0
1,201392386,2170660915,57029,36895,2024-10-04 19:31:05,0,0,0,0,0,0
1,201392386,2170660915,5303,36895,2024-10-04 19:31:05,0,0,0,0,0,0
1,201392386,2170660915,0,0,2024-10-04 19:31:05,0,0,0,0,0,0
1,201392386,2170660915,37534,36895,2024-10-04 19:31:05,0,0,0,0,0,0
1,201392386,1145490692,47237,47873,2024-10-04 19:31:06,0,0,0,0,0,0
1,201392386,2170660915,57029,36895,2024-10-04 19:31:06,0,0,0,0,0,0
1,201392386,2170660915,5303,36895,2024-10-04 19:31:06,0,0,0,0,0,0
1,201392386,2170660915,0,0,2024-10-04 19:31:06,0,0,0,0,0,0
1,201392386,2170660915,37534,36895,2024-10-04 19:31:06,0,0,0,0,0,0
1,201392386,1145490692,47237,47873,2024-10-04 19:31:07,0,0,0,0,0,0
1,201392386,2170660915,57029,36895,2024-10-04 19:31:07,0,0,0,0,0,0
1,201392386,2170660915,5303,36895,2024-10-04 19:31:07,0,0,0,0,0,0
1,201392386,2170660915,0,0,2024-10-04 19:31:07,0,0,0,0,0,0
1,201392386,2170660915,37534,36895,2024-10-04 19:31:07,0,0,0,0,0,0
1,201392386,1145490692,47237,47873,2024-10-04 19:31:08,0,0,0,0,0,0
1,201392386,2170660915,57029,36895,2024-10-04 19:31:08,0,0,0,0,0,0
1,201392386,2170660915,5303,36895,2024-10-04 19:31:08,0,0,0,0,0,0
1,201392386,2170660915,0,0,2024-10-04 19:31:08,0,0,0,0,0,0
1,201392386,2170660915,37534,36895,2024-10-04 19:31:08,0,0,0,0,0,0
1,201392386,1145490692,47237,47873,2024-10-04 19:31:09,0,0,0,0,0,0
1,201392386,2170660915,57029,36895,2024-10-04 19:31:09,0,0,0,0,0,0
1,201392386,2170660915,5303,36895,2024-10-04 19:31:09,0,0,0,0,0,0
1,201392386,2170660915,0,0,2024-10-04 19:31:09,128,0,128,1,0,1
1,201392386,2170660915,37534,36895,2024-10-04 19:31:09,0,0,0,0,0,0
1,201392386,1145490692,47237,47873,2024-10-04 19:31:10,0,0,0,0,0,0
1,201392386,2170660915,57029,36895,2024-10-04 19:31:10,0,0,0,0,0,0
1,201392386,2170660915,5303,36895,2024-10-04 19:31:10,0,0,0,0,0,0
1,201392386,2170660915,0,0,2024-10-04 19:31:10,128,84,212,1,1,2
1,201392386,2170660915,37534,36895,2024-10-04 19:31:10,0,0,0,0,0,0
1,201392386,1145490692,47237,47873,2024-10-04 19:31:11,0,0,0,0,0,0
1,201392386,2170660915,57029,36895,2024-10-04 19:31:11,0,0,0,0,0,0
1,201392386,2170660915,5303,36895,2024-10-04 19:31:11,0,0,0,0,0,0
1,201392386,2170660915,0,0,2024-10-04 19:31:11,128,84,212,1,1,2
1,201392386,2170660915,37534,36895,2024-10-04 19:31:11,0,0,0,0,0,0
1,201392386,1145490692,47237,47873,2024-10-04 19:31:12,0,0,0,0,0,0
1,201392386,2170660915,57029,36895,2024-10-04 19:31:12,0,0,0,0,0,0
1,201392386,2170660915,5303,36895,2024-10-04 19:31:12,0,0,0,0,0,0
1,201392386,2170660915,0,0,2024-10-04 19:31:12,128,84,212,1,1,2
1,201392386,2170660915,37534,36895,2024-10-04 19:31:12,0,0,0,0,0,0
1,201392386,1145490692,47237,47873,2024-10-04 19:31:13,0,0,0,0,0,0
1,201392386,2170660915,57029,36895,2024-10-04 19:31:13,0,0,0,0,0,0
1,201392386,2170660915,5303,36895,2024-10-04 19:31:13,0,0,0,0,0,0
1,201392386,2170660915,0,0,2024-10-04 19:31:13,128,84,212,1,1,2
1,201392386,2170660915,37534,36895,2024-10-04 19:31:13,0,0,0,0,0,0
1,201392386,1145490692,47237,47873,2024-10-04 19:31:14,0,0,0,0,0,0
1,201392386,2170660915,57029,36895,2024-10-04 19:31:14,0,0,0,0,0,0
1,201392386,2170660915,5303,36895,2024-10-04 19:31:14,0,0,0,0,0,0
1,201392386,2170660915,0,0,2024-10-04 19:31:14,0,84,84,0,1,1
1,201392386,2170660915,37534,36895,2024-10-04 19:31:14,0,0,0,0,0,0
1,201392386,2170660915,57029,36895,2024-10-04 19:31:15,0,0,0,0,0,0
1,201392386,2170660915,5303,36895,2024-10-04 19:31:15,0,0,0,0,0,0
1,201392386,2170660915,0,0,2024-10-04 19:31:15,256,84,340,2,1,3
1,201392386,2170660915,37534,36895,2024-10-04 19:31:15,0,0,0,0,0,0
1,201392386,2170660915,57029,36895,2024-10-04 19:31:16,0,0,0,0,0,0
1,201392386,2170660915,5303,36895,2024-10-04 19:31:16,0,0,0,0,0,0
1,201392386,2170660915,0,0,2024-10-04 19:31:16,128,84,212,1,1,2
1,201392386,2170660915,37534,36895,2024-10-04 19:31:16,0,0,0,0,0,0
1,201392386,2170660915,57029,36895,2024-10-04 19:31:17,0,0,0,0,0,0
1,201392386,2170660915,5303,36895,2024-10-04 19:31:17,0,0,0,0,0,0
1,201392386,2170660915,0,0,2024-10-04 19:31:17,128,84,212,1,1,2
1,201392386,2170660915,37534,36895,2024-10-04 19:31:17,0,0,0,0,0,0
1,201392386,2170660915,57029,36895,2024-10-04 19:31:18,0,0,0,0,0,0
1,201392386,2170660915,5303,36895,2024-10-04 19:31:18,0,0,0,0,0,0
1,201392386,2170660915,0,0,2024-10-04 19:31:18,128,84,212,1,1,2
1,201392386,2170660915,37534,36895,2024-10-04 19:31:18,0,0,0,0,0,0
1,201392386,2170660915,57029,36895,2024-10-04 19:31:19,0,0,0,0,0,0
1,201392386,2170660915,5303,36895,2024-10-04 19:31:19,0,0,0,0,0,0
1,201392386,2170660915,0,0,2024-10-04 19:31:19,0,84,84,0,1,1
1,201392386,2170660915,37534,36895,2024-10-04 19:31:19,0,0,0,0,0,0
1,201392386,2170660915,57029,36895,2024-10-04 19:31:20,0,0,0,0,0,0
1,201392386,2170660915,8391,36895,2024-10-04 19:31:20,666,507,1173,6,6,12
1,201392386,2170660915,0,0,2024-10-04 19:31:20,0,0,0,0,0,0
1,201392386,2170660915,37534,36895,2024-10-04 19:31:20,0,0,0,0,0,0
1,201392386,2170660915,57029,36895,2024-10-04 19:31:21,0,0,0,0,0,0
1,201392386,2170660915,8391,36895,2024-10-04 19:31:21,0,0,0,0,0,0
1,201392386,2170660915,0,0,2024-10-04 19:31:21,0,0,0,0,0,0
1,201392386,2170660915,37534,36895,2024-10-04 19:31:21,0,0,0,0,0,0
1,201392386,2170660915,57029,36895,2024-10-04 19:31:22,0,0,0,0,0,0
1,201392386,2170660915,8391,36895,2024-10-04 19:31:22,0,0,0,0,0,0
1,201392386,2170660915,0,0,2024-10-04 19:31:22,256,84,340,2,1,3
1,201392386,2170660915,37534,36895,2024-10-04 19:31:22,0,0,0,0,0,0
1,201392386,2170660915,57029,36895,2024-10-04 19:31:23,0,0,0,0,0,0
1,201392386,2170660915,8391,36895,2024-10-04 19:31:23,0,0,0,0,0,0
1,201392386,2170660915,0,0,2024-10-04 19:31:23,128,84,212,1,1,2
1,201392386,2170660915,37534,36895,2024-10-04 19:31:23,0,0,0,0,0,0
1,201392386,2170660915,57029,36895,2024-10-04 19:31:24,0,0,0,0,0,0
1,201392386,2170660915,0,0,2024-10-04 19:31:24,0,84,84,0,1,1
1,201392386,2170660915,37534,36895,2024-10-04 19:31:24,0,0,0,0,0,0
1,201392386,2170660915,57029,36895,2024-10-04 19:31:25,0,0,0,0,0,0
1,201392386,2170660915,0,0,2024-10-04 19:31:25,0,0,0,0,0,0
1,201392386,2170660915,37534,36895,2024-10-04 19:31:25,0,0,0,0,0,0
1,201392386,2170660915,57029,36895,2024-10-04 19:31:26,0,0,0,0,0,0
1,201392386,2170660915,0,0,2024-10-04 19:31:26,0,0,0,0,0,0
1,201392386,2170660915,37534,36895,2024-10-04 19:31:26,0,0,0,0,0,0
1,201392386,2170660915,57029,36895,2024-10-04 19:31:27,0,0,0,0,0,0
1,201392386,2170660915,0,0,2024-10-04 19:31:27,128,0,128,1,0,1
1,201392386,2170660915,37534,36895,2024-10-04 19:31:27,0,0,0,0,0,0
1,201392386,2170660915,57029,36895,2024-10-04 19:31:28,0,0,0,0,0,0
1,201392386,2170660915,0,0,2024-10-04 19:31:28,0,84,84,0,1,1
1,201392386,2170660915,37534,36895,2024-10-04 19:31:28,0,0,0,0,0,0
1,201392386,2170660915,57029,36895,2024-10-04 19:31:29,0,0,0,0,0,0
1,201392386,1145490692,32490,47873,2024-10-04 19:31:29,3936,56089,60025,31,47,78
1,201392386,2170660915,0,0,2024-10-04 19:31:29,256,168,424,2,2,4
1,201392386,2170660915,37534,36895,2024-10-04 19:31:29,0,0,0,0,0,0
1,201392386,2170660915,57029,36895,2024-10-04 19:31:30,0,0,0,0,0,0
1,201392386,1145490692,32490,47873,2024-10-04 19:31:30,2472,35077,37549,25,27,52
1,201392386,2170660915,0,0,2024-10-04 19:31:30,0,0,0,0,0,0
1,201392386,2170660915,37534,36895,2024-10-04 19:31:30,0,0,0,0,0,0
1,201392386,2170660915,57029,36895,2024-10-04 19:31:31,0,0,0,0,0,0
1,201392386,1145490692,32490,47873,2024-10-04 19:31:31,0,0,0,0,0,0
1,201392386,2170660915,0,0,2024-10-04 19:31:31,0,0,0,0,0,0
1,201392386,2170660915,37534,36895,2024-10-04 19:31:31,0,0,0,0,0,0
1,201392386,2170660915,57029,36895,2024-10-04 19:31:32,0,0,0,0,0,0
1,201392386,1145490692,32490,47873,2024-10-04 19:31:32,0,0,0,0,0,0
1,201392386,2170660915,0,0,2024-10-04 19:31:32,0,0,0,0,0,0
1,201392386,2170660915,37534,36895,2024-10-04 19:31:32,0,0,0,0,0,0
1,201392386,2170660915,57029,36895,2024-10-04 19:31:33,0,0,0,0,0,0
1,201392386,1145490692,32490,47873,2024-10-04 19:31:33,0,0,0,0,0,0
1,201392386,2170660915,0,0,2024-10-04 19:31:33,0,0,0,0,0,0
1,201392386,2170660915,37534,36895,2024-10-04 19:31:33,0,0,0,0,0,0
1,201392386,2170660915,57029,36895,2024-10-04 19:31:34,0,0,0,0,0,0
1,201392386,1145490692,32490,47873,2024-10-04 19:31:34,0,0,0,0,0,0
1,201392386,2170660915,0,0,2024-10-04 19:31:34,0,0,0,0,0,0
1,201392386,2170660915,37534,36895,2024-10-04 19:31:34,0,0,0,0,0,0
1,201392386,2170660915,57029,36895,2024-10-04 19:31:35,0,0,0,0,0,0
1,201392386,1145490692,32490,47873,2024-10-04 19:31:35,0,0,0,0,0,0
1,201392386,2170660915,0,0,2024-10-04 19:31:35,0,0,0,0,0,0
1,201392386,2170660915,37534,36895,2024-10-04 19:31:35,0,0,0,0,0,0
1,201392386,2170660915,57029,36895,2024-10-04 19:31:36,0,0,0,0,0,0
1,201392386,1145490692,32490,47873,2024-10-04 19:31:36,0,0,0,0,0,0
1,201392386,2170660915,0,0,2024-10-04 19:31:36,0,0,0,0,0,0
1,201392386,2170660915,37534,36895,2024-10-04 19:31:36,0,0,0,0,0,0
1,201392386,2170660915,57029,36895,2024-10-04 19:31:37,0,0,0,0,0,0
1,201392386,1145490692,32490,47873,2024-10-04 19:31:37,0,0,0,0,0,0
1,201392386,2170660915,0,0,2024-10-04 19:31:37,0,0,0,0,0,0
1,201392386,2170660915,37534,36895,2024-10-04 19:31:37,0,0,0,0,0,0
1,201392386,2170660915,57029,36895,2024-10-04 19:31:38,0,0,0,0,0,0
1,201392386,1145490692,32490,47873,2024-10-04 19:31:38,0,0,0,0,0,0
1,201392386,2170660915,0,0,2024-10-04 19:31:38,0,0,0,0,0,0
1,201392386,2170660915,37534,36895,2024-10-04 19:31:38,0,0,0,0,0,0
1,201392386,2170660915,57029,36895,2024-10-04 19:31:39,0,0,0,0,0,0
1,201392386,1145490692,32490,47873,2024-10-04 19:31:39,0,0,0,0,0,0
1,201392386,2170660915,0,0,2024-10-04 19:31:39,128,0,128,1,0,1
1,201392386,2170660915,37534,36895,2024-10-04 19:31:39,0,0,0,0,0,0
1,201392386,2170660915,57029,36895,2024-10-04 19:31:40,0,0,0,0,0,0
1,201392386,1145490692,32490,47873,2024-10-04 19:31:40,0,0,0,0,0,0
1,201392386,2170660915,0,0,2024-10-04 19:31:40,128,84,212,1,1,2
1,201392386,2170660915,37534,36895,2024-10-04 19:31:40,0,0,0,0,0,0
1,201392386,2170660915,57029,36895,2024-10-04 19:31:41,0,0,0,0,0,0
1,201392386,1145490692,32490,47873,2024-10-04 19:31:41,0,0,0,0,0,0
1,201392386,2170660915,0,0,2024-10-04 19:31:41,128,84,212,1,1,2
1,201392386,2170660915,37534,36895,2024-10-04 19:31:41,0,0,0,0,0,0
1,201392386,2170660915,57029,36895,2024-10-04 19:31:42,0,0,0,0,0,0
1,201392386,1145490692,32490,47873,2024-10-04 19:31:42,0,0,0,0,0,0
1,201392386,2170660915,0,0,2024-10-04 19:31:42,128,84,212,1,1,2
1,201392386,2170660915,37534,36895,2024-10-04 19:31:42,0,0,0,0,0,0
1,201392386,2170660915,57029,36895,2024-10-04 19:31:43,0,0,0,0,0,0
1,201392386,1145490692,32490,47873,2024-10-04 19:31:43,0,0,0,0,0,0
1,201392386,2170660915,0,0,2024-10-04 19:31:43,128,84,212,1,1,2
1,201392386,2170660915,37534,36895,2024-10-04 19:31:43,0,0,0,0,0,0
1,201392386,2170660915,57029,36895,2024-10-04 19:31:44,0,0,0,0,0,0
1,201392386,1145490692,32490,47873,2024-10-04 19:31:44,0,0,0,0,0,0
1,201392386,2170660915,0,0,2024-10-04 19:31:44,0,0,0,0,0,0
1,201392386,2170660915,37534,36895,2024-10-04 19:31:44,0,0,0,0,0,0
1,201392386,2170660915,57029,36895,2024-10-04 19:31:45,0,0,0,0,0,0
1,201392386,1145490692,32490,47873,2024-10-04 19:31:45,0,0,0,0,0,0
1,201392386,2170660915,0,0,2024-10-04 19:31:45,128,84,212,1,1,2
1,201392386,2170660915,37534,36895,2024-10-04 19:31:45,0,0,0,0,0,0
1,201392386,2170660915,57029,36895,2024-10-04 19:31:46,0,0,0,0,0,0
1,201392386,2170660915,0,0,2024-10-04 19:31:46,128,84,212,1,1,2
1,201392386,2170660915,37534,36895,2024-10-04 19:31:46,0,0,0,0,0,0
1,201392386,2170660915,57029,36895,2024-10-04 19:31:47,0,0,0,0,0,0
1,201392386,2170660915,0,0,2024-10-04 19:31:47,128,84,212,1,1,2
1,201392386,2170660915,37534,36895,2024-10-04 19:31:47,0,0,0,0,0,0
1,201392386,2170660915,57029,36895,2024-10-04 19:31:48,0,0,0,0,0,0
1,201392386,2170660915,0,0,2024-10-04 19:31:48,128,84,212,1,1,2
1,201392386,2170660915,37534,36895,2024-10-04 19:31:48,0,0,0,0,0,0
1,201392386,2170660915,57029,36895,2024-10-04 19:31:49,0,0,0,0,0,0
1,201392386,2170660915,0,0,2024-10-04 19:31:49,128,84,212,1,1,2
1,201392386,2170660915,37534,36895,2024-10-04 19:31:49,0,0,0,0,0,0
1,201392386,2170660915,57029,36895,2024-10-04 19:31:50,0,0,0,0,0,0
1,201392386,2170660915,0,0,2024-10-04 19:31:50,0,84,84,0,1,1
1,201392386,2170660915,37534,36895,2024-10-04 19:31:50,0,0,0,0,0,0
1,201392386,2170660915,50374,36895,2024-10-04 19:31:51,570,455,1025,5,5,10
1,201392386,2170660915,57029,36895,2024-10-04 19:31:51,0,0,0,0,0,0
1,201392386,2170660915,0,0,2024-10-04 19:31:51,128,84,212,1,1,2
1,201392386,2170660915,37534,36895,2024-10-04 19:31:51,0,0,0,0,0,0
1,201392386,2170660915,50374,36895,2024-10-04 19:31:52,0,0,0,0,0,0
1,201392386,2170660915,57029,36895,2024-10-04 19:31:52,0,0,0,0,0,0
1,201392386,2170660915,0,0,2024-10-04 19:31:52,0,0,0,0,0,0
1,201392386,2170660915,37534,36895,2024-10-04 19:31:52,0,0,0,0,0,0
1,201392386,2170660915,50374,36895,2024-10-04 19:31:53,0,0,0,0,0,0
1,201392386,2170660915,57029,36895,2024-10-04 19:31:53,0,0,0,0,0,0
1,201392386,2170660915,0,0,2024-10-04 19:31:53,128,84,212,1,1,2
1,201392386,2170660915,37534,36895,2024-10-04 19:31:53,0,0,0,0,0,0
1,201392386,2170660915,57029,36895,2024-10-04 19:31:54,0,0,0,0,0,0
1,201392386,2170660915,0,0,2024-10-04 19:31:54,128,84,212,1,1,2
1,201392386,2170660915,37534,36895,2024-10-04 19:31:54,0,0,0,0,0,0
1,201392386,2170660915,57029,36895,2024-10-04 19:31:55,0,0,0,0,0,0
1,201392386,2170660915,0,0,2024-10-04 19:31:55,0,0,0,0,0,0
1,201392386,2170660915,37534,36895,2024-10-04 19:31:55,0,0,0,0,0,0
1,201392386,2170660915,57029,36895,2024-10-04 19:31:56,0,0,0,0,0,0
1,201392386,2170660915,0,0,2024-10-04 19:31:56,0,0,0,0,0,0
1,201392386,2170660915,37534,36895,2024-10-04 19:31:56,0,0,0,0,0,0
1,201392386,2170660915,57029,36895,2024-10-04 19:31:57,0,0,0,0,0,0
1,201392386,2170660915,0,0,2024-10-04 19:31:57,128,0,128,1,0,1
1,201392386,2170660915,37534,36895,2024-10-04 19:31:57,0,0,0,0,0,0
1,201392386,2170660915,57029,36895,2024-10-04 19:31:58,0,0,0,0,0,0
1,201392386,2170660915,0,0,2024-10-04 19:31:58,128,84,212,1,1,2
1,201392386,2170660915,37534,36895,2024-10-04 19:31:58,0,0,0,0,0,0
1,201392386,1145490690,6854,47873,2024-10-04 19:31:59,2316,18938,21254,15,22,37
1,201392386,2170660915,57029,36895,2024-10-04 19:31:59,0,0,0,0,0,0
1,201392386,2170660915,0,0,2024-10-04 19:31:59,128,168,296,1,2,3
1,201392386,2170660915,37534,36895,2024-10-04 19:31:59,0,0,0,0,0,0
1,201392386,1145490690,6854,47873,2024-10-04 19:32:00,0,0,0,0,0,0
1,201392386,2170660915,57029,36895,2024-10-04 19:32:00,0,0,0,0,0,0
1,201392386,2170660915,0,0,2024-10-04 19:32:00,0,0,0,0,0,0
1,201392386,2170660915,37534,36895,2024-10-04 19:32:00,0,0,0,0,0,0
1,201392386,1145490690,6854,47873,2024-10-04 19:32:01,3864,76348,80212,38,55,93
1,201392386,2170660915,57029,36895,2024-10-04 19:32:01,0,0,0,0,0,0
1,201392386,2170660915,0,0,2024-10-04 19:32:01,0,0,0,0,0,0
1,201392386,2170660915,37534,36895,2024-10-04 19:32:01,0,0,0,0,0,0
1,201392386,1145490690,6854,47873,2024-10-04 19:32:02,0,0,0,0,0,0
1,201392386,2170660915,57029,36895,2024-10-04 19:32:02,0,0,0,0,0,0
1,201392386,2170660915,0,0,2024-10-04 19:32:02,0,0,0,0,0,0
1,201392386,2170660915,37534,36895,2024-10-04 19:32:02,0,0,0,0,0,0
1,201392386,1145490690,6854,47873,2024-10-04 19:32:03,0,0,0,0,0,0
1,201392386,2170660915,57029,36895,2024-10-04 19:32:03,0,0,0,0,0,0
1,201392386,2170660915,0,0,2024-10-04 19:32:03,0,0,0,0,0,0
1,201392386,2170660915,37534,36895,2024-10-04 19:32:03,0,0,0,0,0,0
1,201392386,1145490690,6854,47873,2024-10-04 19:32:04,0,0,0,0,0,0
1,201392386,2170660915,57029,36895,2024-10-04 19:32:04,0,0,0,0,0,0
1,201392386,2170660915,0,0,2024-10-04 19:32:04,0,0,0,0,0,0
1,201392386,2170660915,37534,36895,2024-10-04 19:32:04,0,0,0,0,0,0
1,201392386,1145490690,6854,47873,2024-10-04 19:32:05,0,0,0,0,0,0
1,201392386,2170660915,57029,36895,2024-10-04 19:32:05,0,0,0,0,0,0
1,201392386,2170660915,0,0,2024-10-04 19:32:05,0,0,0,0,0,0
1,201392386,2170660915,37534,36895,2024-10-04 19:32:05,0,0,0,0,0,0
1,201392386,1145490690,6854,47873,2024-10-04 19:32:06,0,0,0,0,0,0
1,201392386,2170660915,57029,36895,2024-10-04 19:32:06,0,0,0,0,0,0
1,201392386,2170660915,0,0,2024-10-04 19:32:06,0,0,0,0,0,0
1,201392386,2170660915,37534,36895,2024-10-04 19:32:06,0,0,0,0,0,0
1,201392386,1145490690,6854,47873,2024-10-04 19:32:07,0,0,0,0,0,0
1,201392386,2170660915,57029,36895,2024-10-04 19:32:07,0,0,0,0,0,0
1,201392386,2170660915,0,0,2024-10-04 19:32:07,0,0,0,0,0,0
1,201392386,2170660915,37534,36895,2024-10-04 19:32:07,0,0,0,0,0,0
1,201392386,1145490690,6854,47873,2024-10-04 19:32:08,0,0,0,0,0,0
1,201392386,2170660915,57029,36895,2024-10-04 19:32:08,0,0,0,0,0,0
1,201392386,2170660915,0,0,2024-10-04 19:32:08,0,0,0,0,0,0
1,201392386,2170660915,37534,36895,2024-10-04 19:32:08,0,0,0,0,0,0
1,201392386,1145490690,6854,47873,2024-10-04 19:32:09,0,0,0,0,0,0
1,201392386,2170660915,57029,36895,2024-10-04 19:32:09,0,0,0,0,0,0
1,201392386,2170660915,0,0,2024-10-04 19:32:09,0,0,0,0,0,0
1,201392386,2170660915,37534,36895,2024-10-04 19:32:09,0,0,0,0,0,0
1,201392386,1145490690,6854,47873,2024-10-04 19:32:10,0,0,0,0,0,0
1,201392386,2170660915,57029,36895,2024-10-04 19:32:10,0,0,0,0,0,0
1,201392386,2170660915,0,0,2024-10-04 19:32:10,0,0,0,0,0,0
1,201392386,2170660915,37534,36895,2024-10-04 19:32:10,0,0,0,0,0,0
1,201392386,1145490690,6854,47873,2024-10-04 19:32:11,0,0,0,0,0,0
1,201392386,2170660915,57029,36895,2024-10-04 19:32:11,0,0,0,0,0,0
1,201392386,2170660915,0,0,2024-10-04 19:32:11,128,84,212,1,1,2
1,201392386,2170660915,37534,36895,2024-10-04 19:32:11,0,0,0,0,0,0
1,201392386,1145490690,6854,47873,2024-10-04 19:32:12,0,0,0,0,0,0
1,201392386,2170660915,57029,36895,2024-10-04 19:32:12,0,0,0,0,0,0
1,201392386,2170660915,0,0,2024-10-04 19:32:12,128,84,212,1,1,2
1,201392386,2170660915,37534,36895,2024-10-04 19:32:12,0,0,0,0,0,0
1,201392386,1145490690,6854,47873,2024-10-04 19:32:13,0,0,0,0,0,0
1,201392386,2170660915,57029,36895,2024-10-04 19:32:13,0,0,0,0,0,0
1,201392386,2170660915,0,0,2024-10-04 19:32:13,128,84,212,1,1,2
1,201392386,2170660915,37534,36895,2024-10-04 19:32:13,0,0,0,0,0,0
1,201392386,1145490690,6854,47873,2024-10-04 19:32:14,0,0,0,0,0,0
1,201392386,2170660915,57029,36895,2024-10-04 19:32:14,0,0,0,0,0,0
1,201392386,2170660915,0,0,2024-10-04 19:32:14,128,84,212,1,1,2
1,201392386,2170660915,37534,36895,2024-10-04 19:32:14,0,0,0,0,0,0
1,201392386,1145490690,6854,47873,2024-10-04 19:32:15,0,0,0,0,0,0
1,201392386,2170660915,57029,36895,2024-10-04 19:32:15,0,0,0,0,0,0
1,201392386,2170660915,0,0,2024-10-04 19:32:15,128,84,212,1,1,2
1,201392386,2170660915,37534,36895,2024-10-04 19:32:15,0,0,0,0,0,0
1,201392386,1145490690,6854,47873,2024-10-04 19:32:16,0,0,0,0,0,0
1,201392386,2170660915,57029,36895,2024-10-04 19:32:16,0,0,0,0,0,0
1,201392386,2170660915,0,0,2024-10-04 19:32:16,128,84,212,1,1,2
1,201392386,2170660915,37534,36895,2024-10-04 19:32:16,0,0,0,0,0,0
1,201392386,2170660915,57029,36895,2024-10-04 19:32:17,0,0,0,0,0,0
1,201392386,2170660915,0,0,2024-10-04 19:32:17,128,84,212,1,1,2
1,201392386,2170660915,37534,36895,2024-10-04 19:32:17,0,0,0,0,0,0
1,201392386,2170660915,57029,36895,2024-10-04 19:32:18,0,0,0,0,0,0
1,201392386,2170660915,0,0,2024-10-04 19:32:18,128,84,212,1,1,2
1,201392386,2170660915,37534,36895,2024-10-04 19:32:18,0,0,0,0,0,0
1,201392386,2170660915,57029,36895,2024-10-04 19:32:19,0,0,0,0,0,0
1,201392386,2170660915,0,0,2024-10-04 19:32:19,128,84,212,1,1,2
1,201392386,2170660915,37534,36895,2024-10-04 19:32:19,0,0,0,0,0,0
1,201392386,2170660915,57029,36895,2024-10-04 19:32:20,0,0,0,0,0,0
1,201392386,2170660915,0,0,2024-10-04 19:32:20,128,84,212,1,1,2
1,201392386,2170660915,37534,36895,2024-10-04 19:32:20,0,0,0,0,0,0
1,201392386,2170660915,57029,36895,2024-10-04 19:32:21,0,0,0,0,0,0
1,201392386,2170660915,53933,36895,2024-10-04 19:32:21,666,507,1173,6,6,12
1,201392386,2170660915,0,0,2024-10-04 19:32:21,0,0,0,0,0,0
1,201392386,2170660915,37534,36895,2024-10-04 19:32:21,0,0,0,0,0,0
1,201392386,2170660915,57029,36895,2024-10-04 19:32:22,0,0,0,0,0,0
1,201392386,2170660915,53933,36895,2024-10-04 19:32:22,0,0,0,0,0,0
1,201392386,2170660915,0,0,2024-10-04 19:32:22,128,84,212,1,1,2
1,201392386,2170660915,37534,36895,2024-10-04 19:32:22,0,0,0,0,0,0
1,201392386,2170660915,57029,36895,2024-10-04 19:32:23,0,0,0,0,0,0
1,201392386,2170660915,53933,36895,2024-10-04 19:32:23,0,0,0,0,0,0
1,201392386,2170660915,0,0,2024-10-04 19:32:23,128,84,212,1,1,2
1,201392386,2170660915,37534,36895,2024-10-04 19:32:23,0,0,0,0,0,0
1,201392386,2170660915,57029,36895,2024-10-04 19:32:24,0,0,0,0,0,0
1,201392386,2170660915,53933,36895,2024-10-04 19:32:24,0,0,0,0,0,0
1,201392386,2170660915,0,0,2024-10-04 19:32:24,128,84,212,1,1,2
1,201392386,2170660915,37534,36895,2024-10-04 19:32:24,0,0,0,0,0,0
1,201392386,2170660915,57029,36895,2024-10-04 19:32:25,0,0,0,0,0,0
1,201392386,2170660915,0,0,2024-10-04 19:32:25,0,0,0,0,0,0
1,201392386,2170660915,37534,36895,2024-10-04 19:32:25,0,0,0,0,0,0
1,201392386,2170660915,57029,36895,2024-10-04 19:32:26,0,0,0,0,0,0
1,201392386,2170660915,0,0,2024-10-04 19:32:26,0,0,0,0,0,0
1,201392386,2170660915,37534,36895,2024-10-04 19:32:26,0,0,0,0,0,0
1,201392386,2170660915,57029,36895,2024-10-04 19:32:27,0,0,0,0,0,0
1,201392386,2170660915,0,0,2024-10-04 19:32:27,0,0,0,0,0,0
1,201392386,2170660915,37534,36895,2024-10-04 19:32:27,0,0,0,0,0,0
1,201392386,2170660915,57029,36895,2024-10-04 19:32:28,0,0,0,0,0,0
1,201392386,2170660915,0,0,2024-10-04 19:32:28,256,84,340,2,1,3
1,201392386,2170660915,37534,36895,2024-10-04 19:32:28,0,0,0,0,0,0
1,201392386,2170660915,57029,36895,2024-10-04 19:32:29,0,0,0,0,0,0
1,201392386,2170660915,0,0,2024-10-04 19:32:29,128,84,212,1,1,2
1,201392386,2170660915,37534,36895,2024-10-04 19:32:29,0,0,0,0,0,0
1,201392386,2170660915,57029,36895,2024-10-04 19:32:30,0,0,0,0,0,0
1,201392386,2170660915,0,0,2024-10-04 19:32:30,0,0,0,0,0,0
1,201392386,2170660915,37534,36895,2024-10-04 19:32:30,0,0,0,0,0,0
1,201392386,2170660915,57029,36895,2024-10-04 19:32:31,0,0,0,0,0,0
1,201392386,1145490690,41689,47873,2024-10-04 19:32:31,6600,117526,124126,55,85,140
1,201392386,2170660915,0,0,2024-10-04 19:32:31,0,84,84,0,1,1
1,201392386,2170660915,37534,36895,2024-10-04 19:32:31,0,0,0,0,0,0
1,201392386,2170660915,57029,36895,2024-10-04 19:32:32,0,0,0,0,0,0
1,201392386,1145490690,41689,47873,2024-10-04 19:32:32,0,0,0,0,0,0
1,201392386,2170660915,0,0,2024-10-04 19:32:32,0,0,0,0,0,0
1,201392386,2170660915,37534,36895,2024-10-04 19:32:32,0,0,0,0,0,0
1,201392386,2170660915,57029,36895,2024-10-04 19:32:33,0,0,0,0,0,0
1,201392386,1145490690,41689,47873,2024-10-04 19:32:33,0,0,0,0,0,0
1,201392386,2170660915,0,0,2024-10-04 19:32:33,0,0,0,0,0,0
1,201392386,2170660915,37534,36895,2024-10-04 19:32:33,0,0,0,0,0,0
1,201392386,2170660915,57029,36895,2024-10-04 19:32:34,0,0,0,0,0,0
1,201392386,1145490690,41689,47873,2024-10-04 19:32:34,0,0,0,0,0,0
1,201392386,2170660915,0,0,2024-10-04 19:32:34,0,0,0,0,0,0
1,201392386,2170660915,37534,36895,2024-10-04 19:32:34,0,0,0,0,0,0
1,201392386,2170660915,57029,36895,2024-10-04 19:32:35,0,0,0,0,0,0
1,201392386,1145490690,41689,47873,2024-10-04 19:32:35,0,0,0,0,0,0
1,201392386,2170660915,0,0,2024-10-04 19:32:35,0,0,0,0,0,0
1,201392386,2170660915,37534,36895,2024-10-04 19:32:35,0,0,0,0,0,0
1,201392386,2170660915,57029,36895,2024-10-04 19:32:36,0,0,0,0,0,0
1,201392386,1145490690,41689,47873,2024-10-04 19:32:36,0,0,0,0,0,0
1,201392386,2170660915,0,0,2024-10-04 19:32:36,0,0,0,0,0,0
1,201392386,2170660915,37534,36895,2024-10-04 19:32:36,0,0,0,0,0,0
1,201392386,2170660915,57029,36895,2024-10-04 19:32:37,0,0,0,0,0,0
1,201392386,1145490690,41689,47873,2024-10-04 19:32:37,0,0,0,0,0,0
1,201392386,2170660915,0,0,2024-10-04 19:32:37,0,0,0,0,0,0
1,201392386,2170660915,37534,36895,2024-10-04 19:32:37,0,0,0,0,0,0
1,201392386,2170660915,57029,36895,2024-10-04 19:32:38,0,0,0,0,0,0
1,201392386,1145490690,41689,47873,2024-10-04 19:32:38,0,0,0,0,0,0
1,201392386,2170660915,0,0,2024-10-04 19:32:38,0,0,0,0,0,0
1,201392386,2170660915,37534,36895,2024-10-04 19:32:38,0,0,0,0,0,0
1,201392386,2170660915,57029,36895,2024-10-04 19:32:39,0,0,0,0,0,0
1,201392386,1145490690,41689,47873,2024-10-04 19:32:39,0,0,0,0,0,0
1,201392386,2170660915,0,0,2024-10-04 19:32:39,0,0,0,0,0,0
1,201392386,2170660915,37534,36895,2024-10-04 19:32:39,0,0,0,0,0,0
1,201392386,2170660915,57029,36895,2024-10-04 19:32:40,0,0,0,0,0,0
1,201392386,1145490690,41689,47873,2024-10-04 19:32:40,0,0,0,0,0,0
1,201392386,2170660915,0,0,2024-10-04 19:32:40,128,84,212,1,1,2
1,201392386,2170660915,37534,36895,2024-10-04 19:32:40,0,0,0,0,0,0
1,201392386,2170660915,57029,36895,2024-10-04 19:32:41,0,0,0,0,0,0
1,201392386,1145490690,41689,47873,2024-10-04 19:32:41,0,0,0,0,0,0
1,201392386,2170660915,0,0,2024-10-04 19:32:41,128,84,212,1,1,2
1,201392386,2170660915,37534,36895,2024-10-04 19:32:41,0,0,0,0,0,0
1,201392386,2170660915,57029,36895,2024-10-04 19:32:42,0,0,0,0,0,0
1,201392386,1145490690,41689,47873,2024-10-04 19:32:42,0,0,0,0,0,0
1,201392386,2170660915,0,0,2024-10-04 19:32:42,128,84,212,1,1,2
1,201392386,2170660915,37534,36895,2024-10-04 19:32:42,0,0,0,0,0,0
1,201392386,2170660915,57029,36895,2024-10-04 19:32:43,0,0,0,0,0,0
1,201392386,1145490690,41689,47873,2024-10-04 19:32:43,0,0,0,0,0,0
1,201392386,2170660915,0,0,2024-10-04 19:32:43,128,84,212,1,1,2
1,201392386,2170660915,37534,36895,2024-10-04 19:32:43,0,0,0,0,0,0
1,201392386,2170660915,57029,36895,2024-10-04 19:32:44,0,0,0,0,0,0
1,201392386,1145490690,41689,47873,2024-10-04 19:32:44,0,0,0,0,0,0
1,201392386,2170660915,0,0,2024-10-04 19:32:44,128,84,212,1,1,2
1,201392386,2170660915,37534,36895,2024-10-04 19:32:44,0,0,0,0,0,0
1,201392386,2170660915,57029,36895,2024-10-04 19:32:45,0,0,0,0,0,0
1,201392386,1145490690,41689,47873,2024-10-04 19:32:45,0,0,0,0,0,0
1,201392386,2170660915,0,0,2024-10-04 19:32:45,128,84,212,1,1,2
1,201392386,2170660915,37534,36895,2024-10-04 19:32:45,0,0,0,0,0,0
1,201392386,2170660915,57029,36895,2024-10-04 19:32:46,0,0,0,0,0,0
1,201392386,1145490690,41689,47873,2024-10-04 19:32:46,0,0,0,0,0,0
1,201392386,2170660915,0,0,2024-10-04 19:32:46,128,84,212,1,1,2
1,201392386,2170660915,37534,36895,2024-10-04 19:32:46,0,0,0,0,0,0
1,201392386,2170660915,57029,36895,2024-10-04 19:32:47,0,0,0,0,0,0
1,201392386,2170660915,0,0,2024-10-04 19:32:47,128,84,212,1,1,2
1,201392386,2170660915,37534,36895,2024-10-04 19:32:47,0,0,0,0,0,0
1,201392386,2170660915,57029,36895,2024-10-04 19:32:48,0,0,0,0,0,0
1,201392386,2170660915,0,0,2024-10-04 19:32:48,128,84,212,1,1,2
1,201392386,2170660915,37534,36895,2024-10-04 19:32:48,0,0,0,0,0,0
1,201392386,2170660915,57029,36895,2024-10-04 19:32:49,0,0,0,0,0,0
1,201392386,2170660915,0,0,2024-10-04 19:32:49,128,84,212,1,1,2
1,201392386,2170660915,37534,36895,2024-10-04 19:32:49,0,0,0,0,0,0
1,201392386,2170660915,57029,36895,2024-10-04 19:32:50,0,0,0,0,0,0
1,201392386,2170660915,0,0,2024-10-04 19:32:50,0,0,0,0,0,0
1,201392386,2170660915,37534,36895,2024-10-04 19:32:50,0,0,0,0,0,0
1,201392386,2170660915,57029,36895,2024-10-04 19:32:51,0,0,0,0,0,0
1,201392386,2170660915,0,0,2024-10-04 19:32:51,0,0,0,0,0,0
1,201392386,2170660915,37534,36895,2024-10-04 19:32:51,0,0,0,0,0,0
1,201392386,2170660915,56472,36895,2024-10-04 19:32:52,570,455,1025,5,5,10
1,201392386,2170660915,57029,36895,2024-10-04 19:32:52,0,0,0,0,0,0
1,201392386,2170660915,0,0,2024-10-04 19:32:52,128,0,128,1,0,1
1,201392386,2170660915,37534,36895,2024-10-04 19:32:52,0,0,0,0,0,0
1,201392386,2170660915,56472,36895,2024-10-04 19:32:53,0,0,0,0,0,0
1,201392386,2170660915,57029,36895,2024-10-04 19:32:53,0,0,0,0,0,0
1,201392386,2170660915,0,0,2024-10-04 19:32:53,128,168,296,1,2,3
1,201392386,2170660915,37534,36895,2024-10-04 19:32:53,0,0,0,0,0,0
1,201392386,2170660915,56472,36895,2024-10-04 19:32:54,0,0,0,0,0,0
1,201392386,2170660915,57029,36895,2024-10-04 19:32:54,0,0,0,0,0,0
1,201392386,2170660915,0,0,2024-10-04 19:32:54,0,0,0,0,0,0
1,201392386,2170660915,37534,36895,2024-10-04 19:32:54,0,0,0,0,0,0
1,201392386,2170660915,57029,36895,2024-10-04 19:32:55,0,0,0,0,0,0
1,201392386,2170660915,0,0,2024-10-04 19:32:55,128,84,212,1,1,2
1,201392386,2170660915,37534,36895,2024-10-04 19:32:55,0,0,0,0,0,0
1,201392386,2170660915,57029,36895,2024-10-04 19:32:56,0,0,0,0,0,0
1,201392386,2170660915,0,0,2024-10-04 19:32:56,0,0,0,0,0,0
1,201392386,2170660915,37534,36895,2024-10-04 19:32:56,0,0,0,0,0,0
1,201392386,2170660915,57029,36895,2024-10-04 19:32:57,0,0,0,0,0,0
1,201392386,2170660915,0,0,2024-10-04 19:32:57,128,0,128,1,0,1
1,201392386,2170660915,37534,36895,2024-10-04 19:32:57,0,0,0,0,0,0
1,201392386,2170660915,57029,36895,2024-10-04 19:32:58,0,0,0,0,0,0
1,201392386,2170660915,0,0,2024-10-04 19:32:58,128,84,212,1,1,2
1,201392386,2170660915,37534,36895,2024-10-04 19:32:58,0,0,0,0,0,0
1,201392386,2170660915,57029,36895,2024-10-04 19:32:59,0,0,0,0,0,0
1,201392386,2170660915,0,0,2024-10-04 19:32:59,128,84,212,1,1,2
1,201392386,2170660915,37534,36895,2024-10-04 19:32:59,0,0,0,0,0,0
1,201392386,1145490692,13487,47873,2024-10-04 19:33:00,6492,93096,99588,56,73,129
1,201392386,2170660915,57029,36895,2024-10-04 19:33:00,0,0,0,0,0,0
1,201392386,2170660915,0,0,2024-10-04 19:33:00,0,84,84,0,1,1
1,201392386,2170660915,37534,36895,2024-10-04 19:33:00,0,0,0,0,0,0
1,201392386,1145490692,13487,47873,2024-10-04 19:33:01,96,52,148,1,1,2
1,201392386,2170660915,57029,36895,2024-10-04 19:33:01,0,0,0,0,0,0
1,201392386,2170660915,0,0,2024-10-04 19:33:01,0,0,0,0,0,0
1,201392386,2170660915,37534,36895,2024-10-04 19:33:01,0,0,0,0,0,0
1,201392386,1145490692,13487,47873,2024-10-04 19:33:02,0,0,0,0,0,0
1,201392386,2170660915,57029,36895,2024-10-04 19:33:02,0,0,0,0,0,0
1,201392386,2170660915,0,0,2024-10-04 19:33:02,0,0,0,0,0,0
1,201392386,2170660915,37534,36895,2024-10-04 19:33:02,0,0,0,0,0,0
1,201392386,1145490692,13487,47873,2024-10-04 19:33:03,0,0,0,0,0,0
1,201392386,2170660915,57029,36895,2024-10-04 19:33:03,0,0,0,0,0,0
1,201392386,2170660915,0,0,2024-10-04 19:33:03,0,0,0,0,0,0
1,201392386,2170660915,37534,36895,2024-10-04 19:33:03,0,0,0,0,0,0
1,201392386,1145490692,13487,47873,2024-10-04 19:33:04,0,0,0,0,0,0
1,201392386,2170660915,57029,36895,2024-10-04 19:33:04,0,0,0,0,0,0
1,201392386,2170660915,0,0,2024-10-04 19:33:04,0,0,0,0,0,0
1,201392386,2170660915,37534,36895,2024-10-04 19:33:04,0,0,0,0,0,0
1,201392386,1145490692,13487,47873,2024-10-04 19:33:05,0,0,0,0,0,0
1,201392386,2170660915,57029,36895,2024-10-04 19:33:05,0,0,0,0,0,0
1,201392386,2170660915,0,0,2024-10-04 19:33:05,0,0,0,0,0,0
1,201392386,2170660915,37534,36895,2024-10-04 19:33:05,0,0,0,0,0,0
1,201392386,1145490692,13487,47873,2024-10-04 19:33:06,0,0,0,0,0,0
1,201392386,2170660915,57029,36895,2024-10-04 19:33:06,0,0,0,0,0,0
1,201392386,2170660915,0,0,2024-10-04 19:33:06,0,0,0,0,0,0
1,201392386,2170660915,37534,36895,2024-10-04 19:33:06,0,0,0,0,0,0
1,201392386,1145490692,13487,47873,2024-10-04 19:33:07,0,0,0,0,0,0
1,201392386,2170660915,57029,36895,2024-10-04 19:33:07,0,0,0,0,0,0
1,201392386,2170660915,0,0,2024-10-04 19:33:07,0,0,0,0,0,0
1,201392386,2170660915,37534,36895,2024-10-04 19:33:07,0,0,0,0,0,0
1,201392386,1145490692,13487,47873,2024-10-04 19:33:08,0,0,0,0,0,0
1,201392386,2170660915,57029,36895,2024-10-04 19:33:08,0,0,0,0,0,0
1,201392386,2170660915,0,0,2024-10-04 19:33:08,0,0,0,0,0,0
1,201392386,2170660915,37534,36895,2024-10-04 19:33:08,0,0,0,0,0,0
1,201392386,1145490692,13487,47873,2024-10-04 19:33:09,0,0,0,0,0,0
1,201392386,2170660915,57029,36895,2024-10-04 19:33:09,0,0,0,0,0,0
1,201392386,2170660915,0,0,2024-10-04 19:33:09,0,0,0,0,0,0
1,201392386,2170660915,37534,36895,2024-10-04 19:33:09,0,0,0,0,0,0
1,201392386,1145490692,13487,47873,2024-10-04 19:33:10,0,0,0,0,0,0
1,201392386,2170660915,57029,36895,2024-10-04 19:33:10,0,0,0,0,0,0
1,201392386,2170660915,0,0,2024-10-04 19:33:10,128,0,128,1,0,1
1,201392386,2170660915,37534,36895,2024-10-04 19:33:10,0,0,0,0,0,0
1,201392386,1145490692,13487,47873,2024-10-04 19:33:11,0,0,0,0,0,0
1,201392386,2170660915,57029,36895,2024-10-04 19:33:11,0,0,0,0,0,0
1,201392386,2170660915,0,0,2024-10-04 19:33:11,128,84,212,1,1,2
1,201392386,2170660915,37534,36895,2024-10-04 19:33:11,0,0,0,0,0,0
1,201392386,1145490692,13487,47873,2024-10-04 19:33:12,0,0,0,0,0,0
1,201392386,2170660915,57029,36895,2024-10-04 19:33:12,0,0,0,0,0,0
1,201392386,2170660915,0,0,2024-10-04 19:33:12,128,84,212,1,1,2
1,201392386,2170660915,37534,36895,2024-10-04 19:33:12,0,0,0,0,0,0
1,201392386,1145490692,13487,47873,2024-10-04 19:33:13,0,0,0,0,0,0
1,201392386,2170660915,57029,36895,2024-10-04 19:33:13,0,0,0,0,0,0
1,201392386,2170660915,0,0,2024-10-04 19:33:13,128,84,212,1,1,2
1,201392386,2170660915,37534,36895,2024-10-04 19:33:13,0,0,0,0,0,0
1,201392386,1145490692,13487,47873,2024-10-04 19:33:14,0,0,0,0,0,0
1,201392386,2170660915,57029,36895,2024-10-04 19:33:14,0,0,0,0,0,0
1,201392386,2170660915,0,0,2024-10-04 19:33:14,128,84,212,1,1,2
1,201392386,2170660915,37534,36895,2024-10-04 19:33:14,0,0,0,0,0,0
1,201392386,1145490692,13487,47873,2024-10-04 19:33:15,0,0,0,0,0,0
1,201392386,2170660915,57029,36895,2024-10-04 19:33:15,0,0,0,0,0,0
1,201392386,2170660915,0,0,2024-10-04 19:33:15,128,84,212,1,1,2
1,201392386,2170660915,37534,36895,2024-10-04 19:33:15,0,0,0,0,0,0
1,201392386,1145490692,13487,47873,2024-10-04 19:33:16,0,0,0,0,0,0
1,201392386,2170660915,57029,36895,2024-10-04 19:33:16,0,0,0,0,0,0
1,201392386,2170660915,0,0,2024-10-04 19:33:16,128,84,212,1,1,2
1,201392386,2170660915,37534,36895,2024-10-04 19:33:16,0,0,0,0,0,0
1,201392386,1145490692,13487,47873,2024-10-04 19:33:17,0,0,0,0,0,0
1,201392386,2170660915,57029,36895,2024-10-04 19:33:17,0,0,0,0,0,0
1,201392386,2170660915,0,0,2024-10-04 19:33:17,128,84,212,1,1,2
1,201392386,2170660915,37534,36895,2024-10-04 19:33:17,0,0,0,0,0,0
1,201392386,1145490692,13487,47873,2024-10-04 19:33:18,0,0,0,0,0,0
1,201392386,2170660915,57029,36895,2024-10-04 19:33:18,0,0,0,0,0,0
1,201392386,2170660915,0,0,2024-10-04 19:33:18,128,84,212,1,1,2
1,201392386,2170660915,37534,36895,2024-10-04 19:33:18,0,0,0,0,0,0
1,201392386,2170660915,57029,36895,2024-10-04 19:33:19,0,0,0,0,0,0
1,201392386,2170660915,0,0,2024-10-04 19:33:19,128,84,212,1,1,2
1,201392386,2170660915,37534,36895,2024-10-04 19:33:19,0,0,0,0,0,0
1,201392386,2170660915,57029,36895,2024-10-04 19:33:20,0,0,0,0,0,0
1,201392386,2170660915,0,0,2024-10-04 19:33:20,0,84,84,0,1,1
1,201392386,2170660915,37534,36895,2024-10-04 19:33:20,0,0,0,0,0,0
1,201392386,2170660915,57029,36895,2024-10-04 19:33:21,0,0,0,0,0,0
1,201392386,2170660915,35018,36895,2024-10-04 19:33:21,666,507,1173,6,6,12
1,201392386,2170660915,0,0,2024-10-04 19:33:21,0,0,0,0,0,0
1,201392386,2170660915,37534,36895,2024-10-04 19:33:21,0,0,0,0,0,0
1,201392386,2170660915,57029,36895,2024-10-04 19:33:22,0,0,0,0,0,0
1,201392386,2170660915,35018,36895,2024-10-04 19:33:22,0,0,0,0,0,0
1,201392386,2170660915,0,0,2024-10-04 19:33:22,128,84,212,1,1,2
1,201392386,2170660915,37534,36895,2024-10-04 19:33:22,0,0,0,0,0,0
1,201392386,2170660915,57029,36895,2024-10-04 19:33:23,0,0,0,0,0,0
1,201392386,2170660915,35018,36895,2024-10-04 19:33:23,0,0,0,0,0,0
1,201392386,2170660915,0,0,2024-10-04 19:33:23,128,84,212,1,1,2
1,201392386,2170660915,37534,36895,2024-10-04 19:33:23,0,0,0,0,0,0
1,201392386,2170660915,57029,36895,2024-10-04 19:33:24,0,0,0,0,0,0
1,201392386,2170660915,35018,36895,2024-10-04 19:33:24,0,0,0,0,0,0
1,201392386,2170660915,0,0,2024-10-04 19:33:24,0,0,0,0,0,0
1,201392386,2170660915,37534,36895,2024-10-04 19:33:24,0,0,0,0,0,0
1,201392386,2170660915,57029,36895,2024-10-04 19:33:25,0,0,0,0,0,0
1,201392386,2170660915,0,0,2024-10-04 19:33:25,128,84,212,1,1,2
1,201392386,2170660915,37534,36895,2024-10-04 19:33:25,0,0,0,0,0,0
1,201392386,2170660915,57029,36895,2024-10-04 19:33:26,0,0,0,0,0,0
1,201392386,2170660915,0,0,2024-10-04 19:33:26,0,0,0,0,0,0
1,201392386,2170660915,37534,36895,2024-10-04 19:33:26,0,0,0,0,0,0
1,201392386,2170660915,57029,36895,2024-10-04 19:33:27,0,0,0,0,0,0
1,201392386,2170660915,0,0,2024-10-04 19:33:27,0,0,0,0,0,0
1,201392386,2170660915,37534,36895,2024-10-04 19:33:27,0,0,0,0,0,0
1,201392386,2170660915,57029,36895,2024-10-04 19:33:28,0,0,0,0,0,0
1,201392386,2170660915,0,0,2024-10-04 19:33:28,128,84,212,1,1,2
1,201392386,2170660915,37534,36895,2024-10-04 19:33:28,0,0,0,0,0,0
1,201392386,2170660915,57029,36895,2024-10-04 19:33:29,0,0,0,0,0,0
1,201392386,2170660915,0,0,2024-10-04 19:33:29,0,0,0,0,0,0
1,201392386,2170660915,37534,36895,2024-10-04 19:33:29,0,0,0,0,0,0
1,201392386,1145490689,48344,47873,2024-10-04 19:33:30,2316,20920,23236,15,22,37
1,201392386,2170660915,57029,36895,2024-10-04 19:33:30,0,0,0,0,0,0
1,201392386,2170660915,0,0,2024-10-04 19:33:30,256,168,424,2,2,4
1,201392386,2170660915,37534,36895,2024-10-04 19:33:30,0,0,0,0,0,0
1,201392386,1145490689,48344,47873,2024-10-04 19:33:31,4080,76296,80376,40,54,94
1,201392386,2170660915,57029,36895,2024-10-04 19:33:31,0,0,0,0,0,0
1,201392386,2170660915,0,0,2024-10-04 19:33:31,0,0,0,0,0,0
1,201392386,2170660915,37534,36895,2024-10-04 19:33:31,0,0,0,0,0,0
1,201392386,1145490689,48344,47873,2024-10-04 19:33:32,0,0,0,0,0,0
1,201392386,2170660915,57029,36895,2024-10-04 19:33:32,0,0,0,0,0,0
1,201392386,2170660915,0,0,2024-10-04 19:33:32,0,0,0,0,0,0
1,201392386,2170660915,37534,36895,2024-10-04 19:33:32,0,0,0,0,0,0
1,201392386,1145490689,48344,47873,2024-10-04 19:33:33,0,0,0,0,0,0
1,201392386,2170660915,57029,36895,2024-10-04 19:33:33,0,0,0,0,0,0
1,201392386,2170660915,0,0,2024-10-04 19:33:33,0,0,0,0,0,0
1,201392386,2170660915,37534,36895,2024-10-04 19:33:33,0,0,0,0,0,0
1,201392386,1145490689,48344,47873,2024-10-04 19:33:34,0,0,0,0,0,0
1,201392386,2170660915,57029,36895,2024-10-04 19:33:34,0,0,0,0,0,0
1,201392386,2170660915,0,0,2024-10-04 19:33:34,0,0,0,0,0,0
1,201392386,2170660915,37534,36895,2024-10-04 19:33:34,0,0,0,0,0,0
1,201392386,1145490689,48344,47873,2024-10-04 19:33:35,0,0,0,0,0,0
1,201392386,2170660915,57029,36895,2024-10-04 19:33:35,0,0,0,0,0,0
1,201392386,2170660915,0,0,2024-10-04 19:33:35,0,0,0,0,0,0
1,201392386,2170660915,37534,36895,2024-10-04 19:33:35,0,0,0,0,0,0
1,201392386,1145490689,48344,47873,2024-10-04 19:33:36,0,0,0,0,0,0
1,201392386,2170660915,57029,36895,2024-10-04 19:33:36,0,0,0,0,0,0
1,201392386,2170660915,0,0,2024-10-04 19:33:36,0,0,0,0,0,0
1,201392386,2170660915,37534,36895,2024-10-04 19:33:36,0,0,0,0,0,0
1,201392386,1145490689,48344,47873,2024-10-04 19:33:37,0,0,0,0,0,0
1,201392386,2170660915,57029,36895,2024-10-04 19:33:37,0,0,0,0,0,0
1,201392386,2170660915,0,0,2024-10-04 19:33:37,0,0,0,0,0,0
1,201392386,2170660915,37534,36895,2024-10-04 19:33:37,0,0,0,0,0,0
1,201392386,1145490689,48344,47873,2024-10-04 19:33:38,0,0,0,0,0,0
1,201392386,2170660915,57029,36895,2024-10-04 19:33:38,0,0,0,0,0,0
1,201392386,2170660915,0,0,2024-10-04 19:33:38,0,0,0,0,0,0
1,201392386,2170660915,37534,36895,2024-10-04 19:33:38,0,0,0,0,0,0
1,201392386,1145490689,48344,47873,2024-10-04 19:33:39,0,0,0,0,0,0
1,201392386,2170660915,57029,36895,2024-10-04 19:33:39,0,0,0,0,0,0
1,201392386,2170660915,0,0,2024-10-04 19:33:39,0,0,0,0,0,0
1,201392386,2170660915,37534,36895,2024-10-04 19:33:39,0,0,0,0,0,0
1,201392386,1145490689,48344,47873,2024-10-04 19:33:40,0,0,0,0,0,0
1,201392386,2170660915,57029,36895,2024-10-04 19:33:40,0,0,0,0,0,0
1,201392386,2170660915,0,0,2024-10-04 19:33:40,0,0,0,0,0,0
1,201392386,2170660915,37534,36895,2024-10-04 19:33:40,0,0,0,0,0,0
1,201392386,1145490689,48344,47873,2024-10-04 19:33:41,0,0,0,0,0,0
1,201392386,2170660915,57029,36895,2024-10-04 19:33:41,0,0,0,0,0,0
1,201392386,2170660915,0,0,2024-10-04 19:33:41,0,0,0,0,0,0
1,201392386,2170660915,37534,36895,2024-10-04 19:33:41,0,0,0,0,0,0
1,201392386,1145490689,48344,47873,2024-10-04 19:33:42,0,0,0,0,0,0
1,201392386,2170660915,57029,36895,2024-10-04 19:33:42,0,0,0,0,0,0
1,201392386,2170660915,0,0,2024-10-04 19:33:42,128,84,212,1,1,2
1,201392386,2170660915,37534,36895,2024-10-04 19:33:42,0,0,0,0,0,0
1,201392386,1145490689,48344,47873,2024-10-04 19:33:43,0,0,0,0,0,0
1,201392386,2170660915,57029,36895,2024-10-04 19:33:43,0,0,0,0,0,0
1,201392386,2170660915,0,0,2024-10-04 19:33:43,256,168,424,2,2,4
1,201392386,2170660915,37534,36895,2024-10-04 19:33:43,0,0,0,0,0,0
1,201392386,1145490689,48344,47873,2024-10-04 19:33:44,0,0,0,0,0,0
1,201392386,2170660915,57029,36895,2024-10-04 19:33:44,0,0,0,0,0,0
1,201392386,2170660915,0,0,2024-10-04 19:33:44,128,84,212,1,1,2
1,201392386,2170660915,37534,36895,2024-10-04 19:33:44,0,0,0,0,0,0
1,201392386,1145490689,48344,47873,2024-10-04 19:33:45,0,0,0,0,0,0
1,201392386,2170660915,57029,36895,2024-10-04 19:33:45,0,0,0,0,0,0
1,201392386,2170660915,0,0,2024-10-04 19:33:45,128,84,212,1,1,2
1,201392386,2170660915,37534,36895,2024-10-04 19:33:45,0,0,0,0,0,0
1,201392386,1145490689,48344,47873,2024-10-04 19:33:46,0,0,0,0,0,0
1,201392386,2170660915,57029,36895,2024-10-04 19:33:46,0,0,0,0,0,0
1,201392386,2170660915,0,0,2024-10-04 19:33:46,128,84,212,1,1,2
1,201392386,2170660915,37534,36895,2024-10-04 19:33:46,0,0,0,0,0,0
1,201392386,1145490689,48344,47873,2024-10-04 19:33:47,0,0,0,0,0,0
1,201392386,2170660915,57029,36895,2024-10-04 19:33:47,0,0,0,0,0,0
1,201392386,2170660915,0,0,2024-10-04 19:33:47,128,84,212,1,1,2
1,201392386,2170660915,37534,36895,2024-10-04 19:33:47,0,0,0,0,0,0
1,201392386,1145490689,48344,47873,2024-10-04 19:33:48,0,0,0,0,0,0
1,201392386,2170660915,57029,36895,2024-10-04 19:33:48,0,0,0,0,0,0
1,201392386,2170660915,0,0,2024-10-04 19:33:48,128,84,212,1,1,2
1,201392386,2170660915,37534,36895,2024-10-04 19:33:48,0,0,0,0,0,0
1,201392386,1145490689,48344,47873,2024-10-04 19:33:49,0,0,0,0,0,0
1,201392386,2170660915,57029,36895,2024-10-04 19:33:49,0,0,0,0,0,0
1,201392386,2170660915,0,0,2024-10-04 19:33:49,128,84,212,1,1,2
1,201392386,2170660915,37534,36895,2024-10-04 19:33:49,0,0,0,0,0,0
1,201392386,2170660915,57029,36895,2024-10-04 19:33:50,0,0,0,0,0,0
1,201392386,2170660915,0,0,2024-10-04 19:33:50,128,84,212,1,1,2
1,201392386,2170660915,37534,36895,2024-10-04 19:33:50,0,0,0,0,0,0
1,201392386,2170660915,57029,36895,2024-10-04 19:33:51,0,0,0,0,0,0
1,201392386,2170660915,0,0,2024-10-04 19:33:51,0,0,0,0,0,0
1,201392386,2170660915,37534,36895,2024-10-04 19:33:51,0,0,0,0,0,0
1,201392386,2170660915,57029,36895,2024-10-04 19:33:52,0,0,0,0,0,0
1,201392386,2170660915,36076,36895,2024-10-04 19:33:52,570,455,1025,5,5,10
1,201392386,2170660915,0,0,2024-10-04 19:33:52,0,0,0,0,0,0
1,201392386,2170660915,37534,36895,2024-10-04 19:33:52,0,0,0,0,0,0
1,201392386,2170660915,57029,36895,2024-10-04 19:33:53,0,0,0,0,0,0
1,201392386,2170660915,36076,36895,2024-10-04 19:33:53,0,0,0,0,0,0
1,201392386,2170660915,0,0,2024-10-04 19:33:53,128,84,212,1,1,2
1,201392386,2170660915,37534,36895,2024-10-04 19:33:53,0,0,0,0,0,0
1,201392386,2170660915,57029,36895,2024-10-04 19:33:54,0,0,0,0,0,0
1,201392386,2170660915,36076,36895,2024-10-04 19:33:54,0,0,0,0,0,0
1,201392386,2170660915,0,0,2024-10-04 19:33:54,128,84,212,1,1,2
1,201392386,2170660915,37534,36895,2024-10-04 19:33:54,0,0,0,0,0,0
1,201392386,2170660915,57029,36895,2024-10-04 19:33:55,0,0,0,0,0,0
1,201392386,2170660915,36076,36895,2024-10-04 19:33:55,0,0,0,0,0,0
1,201392386,2170660915,0,0,2024-10-04 19:33:55,128,84,212,1,1,2
1,201392386,2170660915,37534,36895,2024-10-04 19:33:55,0,0,0,0,0,0
1,201392386,2170660915,57029,36895,2024-10-04 19:33:56,0,0,0,0,0,0
1,201392386,2170660915,36076,36895,2024-10-04 19:33:56,0,0,0,0,0,0
1,201392386,2170660915,0,0,2024-10-04 19:33:56,0,0,0,0,0,0
1,201392386,2170660915,37534,36895,2024-10-04 19:33:56,0,0,0,0,0,0
1,201392386,2170660915,57029,36895,2024-10-04 19:33:57,0,0,0,0,0,0
1,201392386,2170660915,36076,36895,2024-10-04 19:33:57,0,0,0,0,0,0
1,201392386,2170660915,0,0,2024-10-04 19:33:57,0,0,0,0,0,0
1,201392386,2170660915,37534,36895,2024-10-04 19:33:57,0,0,0,0,0,0
1,201392386,2170660915,57029,36895,2024-10-04 19:33:58,0,0,0,0,0,0
1,201392386,2170660915,36076,36895,2024-10-04 19:33:58,0,0,0,0,0,0
1,201392386,2170660915,0,0,2024-10-04 19:33:58,128,0,128,1,0,1
1,201392386,2170660915,37534,36895,2024-10-04 19:33:58,0,0,0,0,0,0
1,201392386,2170660915,57029,36895,2024-10-04 19:33:59,0,0,0,0,0,0
1,201392386,2170660915,36076,36895,2024-10-04 19:33:59,0,0,0,0,0,0
1,201392386,2170660915,0,0,2024-10-04 19:33:59,128,84,212,1,1,2
1,201392386,2170660915,37534,36895,2024-10-04 19:33:59,0,0,0,0,0,0
1,201392386,2170660915,57029,36895,2024-10-04 19:34:00,0,0,0,0,0,0
1,201392386,2170660915,36076,36895,2024-10-04 19:34:00,0,0,0,0,0,0
1,201392386,2170660915,0,0,2024-10-04 19:34:00,0,84,84,0,1,1
1,201392386,2170660915,37534,36895,2024-10-04 19:34:00,0,0,0,0,0,0
1,201392386,2170660915,57029,36895,2024-10-04 19:34:01,0,0,0,0,0,0
1,201392386,2170660915,36076,36895,2024-10-04 19:34:01,0,0,0,0,0,0
1,201392386,1145490692,22719,47873,2024-10-04 19:34:01,4848,67871,72719,40,54,94
1,201392386,2170660915,0,0,2024-10-04 19:34:01,128,84,212,1,1,2
1,201392386,2170660915,37534,36895,2024-10-04 19:34:01,0,0,0,0,0,0
1,201392386,2170660915,57029,36895,2024-10-04 19:34:02,0,0,0,0,0,0
1,201392386,2170660915,36076,36895,2024-10-04 19:34:02,0,0,0,0,0,0
1,201392386,1145490692,22719,47873,2024-10-04 19:34:02,0,0,0,0,0,0
1,201392386,2170660915,0,0,2024-10-04 19:34:02,0,0,0,0,0,0
1,201392386,2170660915,37534,36895,2024-10-04 19:34:02,0,0,0,0,0,0
1,201392386,2170660915,57029,36895,2024-10-04 19:34:03,0,0,0,0,0,0
1,201392386,2170660915,36076,36895,2024-10-04 19:34:03,0,0,0,0,0,0
1,201392386,1145490692,22719,47873,2024-10-04 19:34:03,1824,31379,33203,18,23,41
1,201392386,2170660915,0,0,2024-10-04 19:34:03,0,0,0,0,0,0
1,201392386,2170660915,37534,36895,2024-10-04 19:34:03,0,0,0,0,0,0
1,201392386,2170660915,57029,36895,2024-10-04 19:34:04,0,0,0,0,0,0
1,201392386,2170660915,36076,36895,2024-10-04 19:34:04,0,0,0,0,0,0
1,201392386,1145490692,22719,47873,2024-10-04 19:34:04,0,0,0,0,0,0
1,201392386,2170660915,0,0,2024-10-04 19:34:04,0,0,0,0,0,0
1,201392386,2170660915,37534,36895,2024-10-04 19:34:04,0,0,0,0,0,0
1,201392386,2170660915,57029,36895,2024-10-04 19:34:05,0,0,0,0,0,0
1,201392386,2170660915,36076,36895,2024-10-04 19:34:05,0,0,0,0,0,0
1,201392386,1145490692,22719,47873,2024-10-04 19:34:05,0,0,0,0,0,0
1,201392386,2170660915,0,0,2024-10-04 19:34:05,0,0,0,0,0,0
1,201392386,2170660915,37534,36895,2024-10-04 19:34:05,0,0,0,0,0,0
1,201392386,2170660915,57029,36895,2024-10-04 19:34:06,0,0,0,0,0,0
1,201392386,2170660915,36076,36895,2024-10-04 19:34:06,0,0,0,0,0,0
1,201392386,1145490692,22719,47873,2024-10-04 19:34:06,0,0,0,0,0,0
1,201392386,2170660915,0,0,2024-10-04 19:34:06,0,0,0,0,0,0
1,201392386,2170660915,37534,36895,2024-10-04 19:34:06,0,0,0,0,0,0
1,201392386,2170660915,57029,36895,2024-10-04 19:34:07,0,0,0,0,0,0
1,201392386,2170660915,36076,36895,2024-10-04 19:34:07,0,0,0,0,0,0
1,201392386,1145490692,22719,47873,2024-10-04 19:34:07,0,0,0,0,0,0
1,201392386,2170660915,0,0,2024-10-04 19:34:07,0,0,0,0,0,0
1,201392386,2170660915,37534,36895,2024-10-04 19:34:07,0,0,0,0,0,0
1,201392386,2170660915,57029,36895,2024-10-04 19:34:08,0,0,0,0,0,0
1,201392386,2170660915,36076,36895,2024-10-04 19:34:08,0,0,0,0,0,0
1,201392386,1145490692,22719,47873,2024-10-04 19:34:08,0,0,0,0,0,0
1,201392386,2170660915,0,0,2024-10-04 19:34:08,0,0,0,0,0,0
1,201392386,2170660915,37534,36895,2024-10-04 19:34:08,0,0,0,0,0,0
1,201392386,2170660915,57029,36895,2024-10-04 19:34:09,0,0,0,0,0,0
1,201392386,2170660915,36076,36895,2024-10-04 19:34:09,0,0,0,0,0,0
1,201392386,1145490692,22719,47873,2024-10-04 19:34:09,0,0,0,0,0,0
1,201392386,2170660915,0,0,2024-10-04 19:34:09,0,0,0,0,0,0
1,201392386,2170660915,37534,36895,2024-10-04 19:34:09,0,0,0,0,0,0
1,201392386,2170660915,57029,36895,2024-10-04 19:34:10,0,0,0,0,0,0
1,201392386,2170660915,36076,36895,2024-10-04 19:34:10,0,0,0,0,0,0
1,201392386,1145490692,22719,47873,2024-10-04 19:34:10,0,0,0,0,0,0
1,201392386,2170660915,0,0,2024-10-04 19:34:10,0,0,0,0,0,0
1,201392386,2170660915,37534,36895,2024-10-04 19:34:10,0,0,0,0,0,0
1,201392386,2170660915,57029,36895,2024-10-04 19:34:11,0,0,0,0,0,0
1,201392386,2170660915,36076,36895,2024-10-04 19:34:11,0,0,0,0,0,0
1,201392386,1145490692,22719,47873,2024-10-04 19:34:11,0,0,0,0,0,0
1,201392386,2170660915,0,0,2024-10-04 19:34:11,0,0,0,0,0,0
1,201392386,2170660915,37534,36895,2024-10-04 19:34:11,0,0,0,0,0,0
1,201392386,2170660915,57029,36895,2024-10-04 19:34:12,0,0,0,0,0,0
1,201392386,2170660915,36076,36895,2024-10-04 19:34:12,0,0,0,0,0,0
1,201392386,1145490692,22719,47873,2024-10-04 19:34:12,0,0,0,0,0,0
1,201392386,2170660915,0,0,2024-10-04 19:34:12,128,84,212,1,1,2
1,201392386,2170660915,37534,36895,2024-10-04 19:34:12,0,0,0,0,0,0
1,201392386,2170660915,57029,36895,2024-10-04 19:34:13,0,0,0,0,0,0
1,201392386,2170660915,36076,36895,2024-10-04 19:34:13,0,0,0,0,0,0
1,201392386,1145490692,22719,47873,2024-10-04 19:34:13,0,0,0,0,0,0
1,201392386,2170660915,0,0,2024-10-04 19:34:13,128,84,212,1,1,2
1,201392386,2170660915,37534,36895,2024-10-04 19:34:13,0,0,0,0,0,0
1,201392386,2170660915,57029,36895,2024-10-04 19:34:14,0,0,0,0,0,0
1,201392386,2170660915,36076,36895,2024-10-04 19:34:14,0,0,0,0,0,0
1,201392386,1145490692,22719,47873,2024-10-04 19:34:14,0,0,0,0,0,0
1,201392386,2170660915,0,0,2024-10-04 19:34:14,128,84,212,1,1,2
1,201392386,2170660915,37534,36895,2024-10-04 19:34:14,0,0,0,0,0,0
1,201392386,2170660915,57029,36895,2024-10-04 19:34:15,0,0,0,0,0,0
1,201392386,2170660915,36076,36895,2024-10-04 19:34:15,0,0,0,0,0,0
1,201392386,1145490692,22719,47873,2024-10-04 19:34:15,0,0,0,0,0,0
1,201392386,2170660915,0,0,2024-10-04 19:34:15,128,84,212,1,1,2
1,201392386,2170660915,37534,36895,2024-10-04 19:34:15,0,0,0,0,0,0
1,201392386,2170660915,57029,36895,2024-10-04 19:34:16,0,0,0,0,0,0
1,201392386,2170660915,36076,36895,2024-10-04 19:34:16,0,0,0,0,0,0
1,201392386,1145490692,22719,47873,2024-10-04 19:34:16,0,0,0,0,0,0
1,201392386,2170660915,0,0,2024-10-04 19:34:16,128,84,212,1,1,2
1,201392386,2170660915,37534,36895,2024-10-04 19:34:16,0,0,0,0,0,0
1,201392386,2170660915,57029,36895,2024-10-04 19:34:17,0,0,0,0,0,0
1,201392386,2170660915,36076,36895,2024-10-04 19:34:17,0,0,0,0,0,0
1,201392386,1145490692,22719,47873,2024-10-04 19:34:17,0,0,0,0,0,0
1,201392386,2170660915,0,0,2024-10-04 19:34:17,128,84,212,1,1,2
1,201392386,2170660915,37534,36895,2024-10-04 19:34:17,0,0,0,0,0,0
1,201392386,2170660915,57029,36895,2024-10-04 19:34:18,0,0,0,0,0,0
1,201392386,2170660915,36076,36895,2024-10-04 19:34:18,0,0,0,0,0,0
1,201392386,1145490692,22719,47873,2024-10-04 19:34:18,0,0,0,0,0,0
1,201392386,2170660915,0,0,2024-10-04 19:34:18,128,84,212,1,1,2
1,201392386,2170660915,37534,36895,2024-10-04 19:34:18,0,0,0,0,0,0
1,201392386,2170660915,57029,36895,2024-10-04 19:34:19,0,0,0,0,0,0
1,201392386,2170660915,36076,36895,2024-10-04 19:34:19,0,0,0,0,0,0
1,201392386,1145490692,22719,47873,2024-10-04 19:34:19,0,0,0,0,0,0
1,201392386,2170660915,0,0,2024-10-04 19:34:19,128,84,212,1,1,2
1,201392386,2170660915,37534,36895,2024-10-04 19:34:19,0,0,0,0,0,0
1,201392386,2170660915,57029,36895,2024-10-04 19:34:20,0,0,0,0,0,0
1,201392386,2170660915,36076,36895,2024-10-04 19:34:20,0,0,0,0,0,0
1,201392386,1145490692,22719,47873,2024-10-04 19:34:20,0,0,0,0,0,0
1,201392386,2170660915,0,0,2024-10-04 19:34:20,128,84,212,1,1,2
1,201392386,2170660915,37534,36895,2024-10-04 19:34:20,0,0,0,0,0,0
1,201392386,2170660915,57029,36895,2024-10-04 19:34:21,0,0,0,0,0,0
1,201392386,2170660915,36076,36895,2024-10-04 19:34:21,0,0,0,0,0,0
1,201392386,1145490692,22719,47873,2024-10-04 19:34:21,0,0,0,0,0,0
1,201392386,2170660915,0,0,2024-10-04 19:34:21,128,84,212,1,1,2
1,201392386,2170660915,37534,36895,2024-10-04 19:34:21,0,0,0,0,0,0
1,201392386,2170660915,57029,36895,2024-10-04 19:34:22,0,0,0,0,0,0
1,201392386,2170660915,36076,36895,2024-10-04 19:34:22,0,0,0,0,0,0
1,201392386,2170660915,0,0,2024-10-04 19:34:22,0,0,0,0,0,0
1,201392386,2170660915,37534,36895,2024-10-04 19:34:22,0,0,0,0,0,0
1,201392386,2170660915,57029,36895,2024-10-04 19:34:23,0,0,0,0,0,0
1,201392386,2170660915,36076,36895,2024-10-04 19:34:23,0,0,0,0,0,0
1,201392386,2170660915,15538,36895,2024-10-04 19:34:23,666,507,1173,6,6,12
1,201392386,2170660915,0,0,2024-10-04 19:34:23,0,0,0,0,0,0
1,201392386,2170660915,37534,36895,2024-10-04 19:34:23,0,0,0,0,0,0
1,201392386,2170660915,57029,36895,2024-10-04 19:34:24,0,0,0,0,0,0
1,201392386,2170660915,15538,36895,2024-10-04 19:34:24,0,0,0,0,0,0
1,201392386,2170660915,0,0,2024-10-04 19:34:24,128,84,212,1,1,2
1,201392386,2170660915,37534,36895,2024-10-04 19:34:24,0,0,0,0,0,0
1,201392386,2170660915,57029,36895,2024-10-04 19:34:25,0,0,0,0,0,0
1,201392386,2170660915,15538,36895,2024-10-04 19:34:25,0,0,0,0,0,0
1,201392386,2170660915,0,0,2024-10-04 19:34:25,0,0,0,0,0,0
1,201392386,2170660915,37534,36895,2024-10-04 19:34:25,0,0,0,0,0,0
1,201392386,2170660915,57029,36895,2024-10-04 19:34:26,0,0,0,0,0,0
1,201392386,2170660915,15538,36895,2024-10-04 19:34:26,0,0,0,0,0,0
1,201392386,2170660915,0,0,2024-10-04 19:34:26,256,84,340,2,1,3
1,201392386,2170660915,37534,36895,2024-10-04 19:34:26,0,0,0,0,0,0
1,201392386,2170660915,57029,36895,2024-10-04 19:34:27,0,0,0,0,0,0
1,201392386,2170660915,15538,36895,2024-10-04 19:34:27,0,0,0,0,0,0
1,201392386,2170660915,0,0,2024-10-04 19:34:27,0,84,84,0,1,1
1,201392386,2170660915,37534,36895,2024-10-04 19:34:27,0,0,0,0,0,0
1,201392386,2170660915,57029,36895,2024-10-04 19:34:28,0,0,0,0,0,0
1,201392386,2170660915,15538,36895,2024-10-04 19:34:28,0,0,0,0,0,0
1,201392386,2170660915,0,0,2024-10-04 19:34:28,0,0,0,0,0,0
1,201392386,2170660915,37534,36895,2024-10-04 19:34:28,0,0,0,0,0,0
1,201392386,2170660915,57029,36895,2024-10-04 19:34:29,0,0,0,0,0,0
1,201392386,2170660915,15538,36895,2024-10-04 19:34:29,0,0,0,0,0,0
1,201392386,2170660915,0,0,2024-10-04 19:34:29,128,0,128,1,0,1
1,201392386,2170660915,37534,36895,2024-10-04 19:34:29,0,0,0,0,0,0
1,201392386,2170660915,57029,36895,2024-10-04 19:34:30,0,0,0,0,0,0
1,201392386,2170660915,15538,36895,2024-10-04 19:34:30,0,0,0,0,0,0
1,201392386,2170660915,0,0,2024-10-04 19:34:30,0,84,84,0,1,1
1,201392386,2170660915,37534,36895,2024-10-04 19:34:30,0,0,0,0,0,0
1,201392386,2170660915,57029,36895,2024-10-04 19:34:31,0,0,0,0,0,0
1,201392386,2170660915,15538,36895,2024-10-04 19:34:31,0,0,0,0,0,0
1,201392386,2170660915,0,0,2024-10-04 19:34:31,128,84,212,1,1,2
1,201392386,2170660915,37534,36895,2024-10-04 19:34:31,0,0,0,0,0,0
1,201392386,1145490689,14006,47873,2024-10-04 19:34:32,5820,93452,99272,49,71,120
1,201392386,2170660915,57029,36895,2024-10-04 19:34:32,0,0,0,0,0,0
1,201392386,2170660915,15538,36895,2024-10-04 19:34:32,0,0,0,0,0,0
1,201392386,2170660915,0,0,2024-10-04 19:34:32,128,84,212,1,1,2
1,201392386,2170660915,37534,36895,2024-10-04 19:34:32,0,0,0,0,0,0
1,201392386,1145490689,14006,47873,2024-10-04 19:34:33,912,7958,8870,9,9,18
1,201392386,2170660915,57029,36895,2024-10-04 19:34:33,0,0,0,0,0,0
1,201392386,2170660915,15538,36895,2024-10-04 19:34:33,0,0,0,0,0,0
1,201392386,2170660915,0,0,2024-10-04 19:34:33,0,0,0,0,0,0
1,201392386,2170660915,37534,36895,2024-10-04 19:34:33,0,0,0,0,0,0
1,201392386,1145490689,14006,47873,2024-10-04 19:34:34,0,0,0,0,0,0
1,201392386,2170660915,57029,36895,2024-10-04 19:34:34,0,0,0,0,0,0
1,201392386,2170660915,15538,36895,2024-10-04 19:34:34,0,0,0,0,0,0
1,201392386,2170660915,0,0,2024-10-04 19:34:34,0,0,0,0,0,0
1,201392386,2170660915,37534,36895,2024-10-04 19:34:34,0,0,0,0,0,0
1,201392386,1145490689,14006,47873,2024-10-04 19:34:35,0,0,0,0,0,0
1,201392386,2170660915,57029,36895,2024-10-04 19:34:35,0,0,0,0,0,0
1,201392386,2170660915,15538,36895,2024-10-04 19:34:35,0,0,0,0,0,0
1,201392386,2170660915,0,0,2024-10-04 19:34:35,0,0,0,0,0,0
1,201392386,2170660915,37534,36895,2024-10-04 19:34:35,0,0,0,0,0,0
1,201392386,1145490689,14006,47873,2024-10-04 19:34:36,0,0,0,0,0,0
1,201392386,2170660915,57029,36895,2024-10-04 19:34:36,0,0,0,0,0,0
1,201392386,2170660915,15538,36895,2024-10-04 19:34:36,0,0,0,0,0,0
1,201392386,2170660915,0,0,2024-10-04 19:34:36,0,0,0,0,0,0
1,201392386,2170660915,37534,36895,2024-10-04 19:34:36,0,0,0,0,0,0
1,201392386,1145490689,14006,47873,2024-10-04 19:34:37,0,0,0,0,0,0
1,201392386,2170660915,57029,36895,2024-10-04 19:34:37,0,0,0,0,0,0
1,201392386,2170660915,15538,36895,2024-10-04 19:34:37,0,0,0,0,0,0
1,201392386,2170660915,0,0,2024-10-04 19:34:37,0,0,0,0,0,0
1,201392386,2170660915,37534,36895,2024-10-04 19:34:37,0,0,0,0,0,0
1,201392386,1145490689,14006,47873,2024-10-04 19:34:38,0,0,0,0,0,0
1,201392386,2170660915,57029,36895,2024-10-04 19:34:38,0,0,0,0,0,0
1,201392386,2170660915,15538,36895,2024-10-04 19:34:38,0,0,0,0,0,0
1,201392386,2170660915,0,0,2024-10-04 19:34:38,0,0,0,0,0,0
1,201392386,2170660915,37534,36895,2024-10-04 19:34:38,0,0,0,0,0,0
1,201392386,1145490689,14006,47873,2024-10-04 19:34:39,0,0,0,0,0,0
1,201392386,2170660915,57029,36895,2024-10-04 19:34:39,0,0,0,0,0,0
1,201392386,2170660915,15538,36895,2024-10-04 19:34:39,0,0,0,0,0,0
1,201392386,2170660915,0,0,2024-10-04 19:34:39,0,0,0,0,0,0
1,201392386,2170660915,37534,36895,2024-10-04 19:34:39,0,0,0,0,0,0
1,201392386,1145490689,14006,47873,2024-10-04 19:34:40,0,0,0,0,0,0
1,201392386,2170660915,57029,36895,2024-10-04 19:34:40,0,0,0,0,0,0
1,201392386,2170660915,15538,36895,2024-10-04 19:34:40,0,0,0,0,0,0
1,201392386,2170660915,0,0,2024-10-04 19:34:40,0,0,0,0,0,0
1,201392386,2170660915,37534,36895,2024-10-04 19:34:40,0,0,0,0,0,0
1,201392386,1145490689,14006,47873,2024-10-04 19:34:41,0,0,0,0,0,0
1,201392386,2170660915,57029,36895,2024-10-04 19:34:41,0,0,0,0,0,0
1,201392386,2170660915,15538,36895,2024-10-04 19:34:41,0,0,0,0,0,0
1,201392386,2170660915,0,0,2024-10-04 19:34:41,0,0,0,0,0,0
1,201392386,2170660915,37534,36895,2024-10-04 19:34:41,0,0,0,0,0,0
1,201392386,1145490689,14006,47873,2024-10-04 19:34:42,0,0,0,0,0,0
1,201392386,2170660915,57029,36895,2024-10-04 19:34:42,0,0,0,0,0,0
1,201392386,2170660915,15538,36895,2024-10-04 19:34:42,0,0,0,0,0,0
1,201392386,2170660915,0,0,2024-10-04 19:34:42,0,0,0,0,0,0
1,201392386,2170660915,37534,36895,2024-10-04 19:34:42,0,0,0,0,0,0
1,201392386,1145490689,14006,47873,2024-10-04 19:34:43,0,0,0,0,0,0
1,201392386,2170660915,57029,36895,2024-10-04 19:34:43,0,0,0,0,0,0
1,201392386,2170660915,15538,36895,2024-10-04 19:34:43,0,0,0,0,0,0
1,201392386,2170660915,0,0,2024-10-04 19:34:43,128,84,212,1,1,2
1,201392386,2170660915,37534,36895,2024-10-04 19:34:43,0,0,0,0,0,0
1,201392386,1145490689,14006,47873,2024-10-04 19:34:44,0,0,0,0,0,0
1,201392386,2170660915,57029,36895,2024-10-04 19:34:44,0,0,0,0,0,0
1,201392386,2170660915,15538,36895,2024-10-04 19:34:44,0,0,0,0,0,0
1,201392386,2170660915,0,0,2024-10-04 19:34:44,128,84,212,1,1,2
1,201392386,2170660915,37534,36895,2024-10-04 19:34:44,0,0,0,0,0,0
1,201392386,1145490689,14006,47873,2024-10-04 19:34:45,0,0,0,0,0,0
1,201392386,2170660915,57029,36895,2024-10-04 19:34:45,0,0,0,0,0,0
1,201392386,2170660915,15538,36895,2024-10-04 19:34:45,0,0,0,0,0,0
1,201392386,2170660915,0,0,2024-10-04 19:34:45,128,84,212,1,1,2
1,201392386,2170660915,37534,36895,2024-10-04 19:34:45,0,0,0,0,0,0
1,201392386,1145490689,14006,47873,2024-10-04 19:34:46,0,0,0,0,0,0
1,201392386,2170660915,57029,36895,2024-10-04 19:34:46,0,0,0,0,0,0
1,201392386,2170660915,15538,36895,2024-10-04 19:34:46,0,0,0,0,0,0
1,201392386,2170660915,0,0,2024-10-04 19:34:46,128,84,212,1,1,2
1,201392386,2170660915,37534,36895,2024-10-04 19:34:46,0,0,0,0,0,0
1,201392386,1145490689,14006,47873,2024-10-04 19:34:47,0,0,0,0,0,0
1,201392386,2170660915,57029,36895,2024-10-04 19:34:47,0,0,0,0,0,0
1,201392386,2170660915,15538,36895,2024-10-04 19:34:47,0,0,0,0,0,0
1,201392386,2170660915,0,0,2024-10-04 19:34:47,128,84,212,1,1,2
1,201392386,2170660915,37534,36895,2024-10-04 19:34:47,0,0,0,0,0,0
1,201392386,1145490689,14006,47873,2024-10-04 19:34:48,0,0,0,0,0,0
1,201392386,2170660915,57029,36895,2024-10-04 19:34:48,0,0,0,0,0,0
1,201392386,2170660915,15538,36895,2024-10-04 19:34:48,0,0,0,0,0,0
1,201392386,2170660915,0,0,2024-10-04 19:34:48,128,84,212,1,1,2
1,201392386,2170660915,37534,36895,2024-10-04 19:34:48,0,0,0,0,0,0
1,201392386,1145490689,14006,47873,2024-10-04 19:34:49,0,0,0,0,0,0
1,201392386,2170660915,57029,36895,2024-10-04 19:34:49,0,0,0,0,0,0
1,201392386,2170660915,15538,36895,2024-10-04 19:34:49,0,0,0,0,0,0
1,201392386,2170660915,0,0,2024-10-04 19:34:49,128,84,212,1,1,2
1,201392386,2170660915,37534,36895,2024-10-04 19:34:49,0,0,0,0,0,0
1,201392386,1145490689,14006,47873,2024-10-04 19:34:50,0,0,0,0,0,0
1,201392386,2170660915,57029,36895,2024-10-04 19:34:50,0,0,0,0,0,0
1,201392386,2170660915,15538,36895,2024-10-04 19:34:50,0,0,0,0,0,0
1,201392386,2170660915,0,0,2024-10-04 19:34:50,128,84,212,1,1,2
1,201392386,2170660915,37534,36895,2024-10-04 19:34:50,0,0,0,0,0,0
1,201392386,1145490689,14006,47873,2024-10-04 19:34:51,0,0,0,0,0,0
1,201392386,2170660915,57029,36895,2024-10-04 19:34:51,0,0,0,0,0,0
1,201392386,2170660915,15538,36895,2024-10-04 19:34:51,0,0,0,0,0,0
1,201392386,2170660915,0,0,2024-10-04 19:34:51,0,0,0,0,0,0
1,201392386,2170660915,37534,36895,2024-10-04 19:34:51,0,0,0,0,0,0
1,201392386,1145490689,14006,47873,2024-10-04 19:34:52,0,0,0,0,0,0
1,201392386,2170660915,57029,36895,2024-10-04 19:34:52,0,0,0,0,0,0
1,201392386,2170660915,15538,36895,2024-10-04 19:34:52,0,0,0,0,0,0
1,201392386,2170660915,0,0,2024-10-04 19:34:52,256,168,424,2,2,4
1,201392386,2170660915,37534,36895,2024-10-04 19:34:52,0,0,0,0,0,0
1,201392386,2170660915,57029,36895,2024-10-04 19:34:53,0,0,0,0,0,0
1,201392386,2170660915,15538,36895,2024-10-04 19:34:53,0,0,0,0,0,0
1,201392386,2170660915,0,0,2024-10-04 19:34:53,0,0,0,0,0,0
1,201392386,2170660915,37534,36895,2024-10-04 19:34:53,0,0,0,0,0,0
1,201392386,2170660915,57029,36895,2024-10-04 19:34:54,0,0,0,0,0,0
1,201392386,2170660915,40669,36895,2024-10-04 19:34:54,666,507,1173,6,6,12
1,201392386,2170660915,0,0,2024-10-04 19:34:54,0,0,0,0,0,0
1,201392386,2170660915,37534,36895,2024-10-04 19:34:54,0,0,0,0,0,0
1,201392386,2170660915,57029,36895,2024-10-04 19:34:55,0,0,0,0,0,0
1,201392386,2170660915,40669,36895,2024-10-04 19:34:55,0,0,0,0,0,0
1,201392386,2170660915,0,0,2024-10-04 19:34:55,128,84,212,1,1,2
1,201392386,2170660915,37534,36895,2024-10-04 19:34:55,0,0,0,0,0,0
1,201392386,2170660915,57029,36895,2024-10-04 19:34:56,0,0,0,0,0,0
1,201392386,2170660915,40669,36895,2024-10-04 19:34:56,0,0,0,0,0,0
1,201392386,2170660915,0,0,2024-10-04 19:34:56,0,0,0,0,0,0
1,201392386,2170660915,37534,36895,2024-10-04 19:34:56,0,0,0,0,0,0
1,201392386,2170660915,57029,36895,2024-10-04 19:34:57,0,0,0,0,0,0
1,201392386,2170660915,40669,36895,2024-10-04 19:34:57,0,0,0,0,0,0
1,201392386,2170660915,0,0,2024-10-04 19:34:57,128,84,212,1,1,2
1,201392386,2170660915,37534,36895,2024-10-04 19:34:57,0,0,0,0,0,0
1,201392386,2170660915,57029,36895,2024-10-04 19:34:58,0,0,0,0,0,0
1,201392386,2170660915,40669,36895,2024-10-04 19:34:58,0,0,0,0,0,0
1,201392386,2170660915,0,0,2024-10-04 19:34:58,128,84,212,1,1,2
1,201392386,2170660915,37534,36895,2024-10-04 19:34:58,0,0,0,0,0,0
1,201392386,2170660915,57029,36895,2024-10-04 19:34:59,0,0,0,0,0,0
1,201392386,2170660915,40669,36895,2024-10-04 19:34:59,0,0,0,0,0,0
1,201392386,2170660915,0,0,2024-10-04 19:34:59,0,0,0,0,0,0
1,201392386,2170660915,37534,36895,2024-10-04 19:34:59,0,0,0,0,0,0
1,201392386,2170660915,57029,36895,2024-10-04 19:35:00,0,0,0,0,0,0
1,201392386,2170660915,40669,36895,2024-10-04 19:35:00,0,0,0,0,0,0
1,201392386,2170660915,0,0,2024-10-04 19:35:00,128,0,128,1,0,1
1,201392386,2170660915,37534,36895,2024-10-04 19:35:00,0,0,0,0,0,0
1,201392386,2170660915,57029,36895,2024-10-04 19:35:01,0,0,0,0,0,0
1,201392386,2170660915,40669,36895,2024-10-04 19:35:01,0,0,0,0,0,0
1,201392386,2170660915,0,0,2024-10-04 19:35:01,0,84,84,0,1,1
1,201392386,2170660915,37534,36895,2024-10-04 19:35:01,0,0,0,0,0,0
1,201392386,2170660915,57029,36895,2024-10-04 19:35:02,0,0,0,0,0,0
1,201392386,2170660915,40669,36895,2024-10-04 19:35:02,0,0,0,0,0,0
1,201392386,2170660915,0,0,2024-10-04 19:35:02,128,84,212,1,1,2
1,201392386,2170660915,37534,36895,2024-10-04 19:35:02,0,0,0,0,0,0
1,201392386,2170660915,57029,36895,2024-10-04 19:35:03,0,0,0,0,0,0
1,201392386,1145490691,56025,47873,2024-10-04 19:35:03,5244,80673,85917,44,63,107
1,201392386,2170660915,40669,36895,2024-10-04 19:35:03,0,0,0,0,0,0
1,201392386,2170660915,0,0,2024-10-04 19:35:03,128,84,212,1,1,2
1,201392386,2170660915,37534,36895,2024-10-04 19:35:03,0,0,0,0,0,0
1,201392386,2170660915,57029,36895,2024-10-04 19:35:04,0,0,0,0,0,0
1,201392386,1145490691,56025,47873,2024-10-04 19:35:04,1116,14531,15647,11,12,23
1,201392386,2170660915,40669,36895,2024-10-04 19:35:04,0,0,0,0,0,0
1,201392386,2170660915,0,0,2024-10-04 19:35:04,0,0,0,0,0,0
1,201392386,2170660915,37534,36895,2024-10-04 19:35:04,0,0,0,0,0,0
1,201392386,2170660915,57029,36895,2024-10-04 19:35:05,0,0,0,0,0,0
1,201392386,1145490691,56025,47873,2024-10-04 19:35:05,0,0,0,0,0,0
1,201392386,2170660915,40669,36895,2024-10-04 19:35:05,0,0,0,0,0,0
1,201392386,2170660915,0,0,2024-10-04 19:35:05,0,0,0,0,0,0
1,201392386,2170660915,37534,36895,2024-10-04 19:35:05,0,0,0,0,0,0
1,201392386,2170660915,57029,36895,2024-10-04 19:35:06,0,0,0,0,0,0
1,201392386,1145490691,56025,47873,2024-10-04 19:35:06,0,0,0,0,0,0
1,201392386,2170660915,40669,36895,2024-10-04 19:35:06,0,0,0,0,0,0
1,201392386,2170660915,0,0,2024-10-04 19:35:06,0,0,0,0,0,0
1,201392386,2170660915,37534,36895,2024-10-04 19:35:06,0,0,0,0,0,0
1,201392386,2170660915,57029,36895,2024-10-04 19:35:07,0,0,0,0,0,0
1,201392386,1145490691,56025,47873,2024-10-04 19:35:07,0,0,0,0,0,0
1,201392386,2170660915,40669,36895,2024-10-04 19:35:07,0,0,0,0,0,0
1,201392386,2170660915,0,0,2024-10-04 19:35:07,0,0,0,0,0,0
1,201392386,2170660915,37534,36895,2024-10-04 19:35:07,0,0,0,0,0,0
1,201392386,2170660915,57029,36895,2024-10-04 19:35:08,0,0,0,0,0,0
1,201392386,1145490691,56025,47873,2024-10-04 19:35:08,0,0,0,0,0,0
1,201392386,2170660915,40669,36895,2024-10-04 19:35:08,0,0,0,0,0,0
1,201392386,2170660915,0,0,2024-10-04 19:35:08,0,0,0,0,0,0
1,201392386,2170660915,37534,36895,2024-10-04 19:35:08,0,0,0,0,0,0
1,201392386,2170660915,57029,36895,2024-10-04 19:35:09,0,0,0,0,0,0
1,201392386,1145490691,56025,47873,2024-10-04 19:35:09,0,0,0,0,0,0
1,201392386,2170660915,40669,36895,2024-10-04 19:35:09,0,0,0,0,0,0
1,201392386,2170660915,0,0,2024-10-04 19:35:09,0,0,0,0,0,0
1,201392386,2170660915,37534,36895,2024-10-04 19:35:09,0,0,0,0,0,0
1,201392386,2170660915,57029,36895,2024-10-04 19:35:10,0,0,0,0,0,0
1,201392386,1145490691,56025,47873,2024-10-04 19:35:10,0,0,0,0,0,0
1,201392386,2170660915,40669,36895,2024-10-04 19:35:10,0,0,0,0,0,0
1,201392386,2170660915,0,0,2024-10-04 19:35:10,0,0,0,0,0,0
1,201392386,2170660915,37534,36895,2024-10-04 19:35:10,0,0,0,0,0,0
1,201392386,2170660915,57029,36895,2024-10-04 19:35:11,0,0,0,0,0,0
1,201392386,1145490691,56025,47873,2024-10-04 19:35:11,0,0,0,0,0,0
1,201392386,2170660915,40669,36895,2024-10-04 19:35:11,0,0,0,0,0,0
1,201392386,2170660915,0,0,2024-10-04 19:35:11,0,0,0,0,0,0
1,201392386,2170660915,37534,36895,2024-10-04 19:35:11,0,0,0,0,0,0
1,201392386,2170660915,57029,36895,2024-10-04 19:35:12,0,0,0,0,0,0
1,201392386,1145490691,56025,47873,2024-10-04 19:35:12,0,0,0,0,0,0
1,201392386,2170660915,40669,36895,2024-10-04 19:35:12,0,0,0,0,0,0
1,201392386,2170660915,0,0,2024-10-04 19:35:12,0,0,0,0,0,0
1,201392386,2170660915,37534,36895,2024-10-04 19:35:12,0,0,0,0,0,0
1,201392386,2170660915,57029,36895,2024-10-04 19:35:13,0,0,0,0,0,0
1,201392386,1145490691,56025,47873,2024-10-04 19:35:13,0,0,0,0,0,0
1,201392386,2170660915,40669,36895,2024-10-04 19:35:13,0,0,0,0,0,0
1,201392386,2170660915,0,0,2024-10-04 19:35:13,128,0,128,1,0,1
1,201392386,2170660915,37534,36895,2024-10-04 19:35:13,0,0,0,0,0,0
1,201392386,2170660915,57029,36895,2024-10-04 19:35:14,0,0,0,0,0,0
1,201392386,1145490691,56025,47873,2024-10-04 19:35:14,0,0,0,0,0,0
1,201392386,2170660915,40669,36895,2024-10-04 19:35:14,0,0,0,0,0,0
1,201392386,2170660915,0,0,2024-10-04 19:35:14,128,84,212,1,1,2
1,201392386,2170660915,37534,36895,2024-10-04 19:35:14,0,0,0,0,0,0
1,201392386,2170660915,57029,36895,2024-10-04 19:35:15,0,0,0,0,0,0
1,201392386,1145490691,56025,47873,2024-10-04 19:35:15,0,0,0,0,0,0
1,201392386,2170660915,40669,36895,2024-10-04 19:35:15,0,0,0,0,0,0
1,201392386,2170660915,0,0,2024-10-04 19:35:15,128,84,212,1,1,2
1,201392386,2170660915,37534,36895,2024-10-04 19:35:15,0,0,0,0,0,0
1,201392386,2170660915,57029,36895,2024-10-04 19:35:16,0,0,0,0,0,0
1,201392386,1145490691,56025,47873,2024-10-04 19:35:16,0,0,0,0,0,0
1,201392386,2170660915,40669,36895,2024-10-04 19:35:16,0,0,0,0,0,0
1,201392386,2170660915,0,0,2024-10-04 19:35:16,128,84,212,1,1,2
1,201392386,2170660915,37534,36895,2024-10-04 19:35:16,0,0,0,0,0,0
1,201392386,2170660915,57029,36895,2024-10-04 19:35:17,0,0,0,0,0,0
1,201392386,1145490691,56025,47873,2024-10-04 19:35:17,0,0,0,0,0,0
1,201392386,2170660915,40669,36895,2024-10-04 19:35:17,0,0,0,0,0,0
1,201392386,2170660915,0,0,2024-10-04 19:35:17,128,84,212,1,1,2
1,201392386,2170660915,37534,36895,2024-10-04 19:35:17,0,0,0,0,0,0
1,201392386,2170660915,57029,36895,2024-10-04 19:35:18,0,0,0,0,0,0
1,201392386,1145490691,56025,47873,2024-10-04 19:35:18,0,0,0,0,0,0
1,201392386,2170660915,40669,36895,2024-10-04 19:35:18,0,0,0,0,0,0
1,201392386,2170660915,0,0,2024-10-04 19:35:18,128,84,212,1,1,2
1,201392386,2170660915,37534,36895,2024-10-04 19:35:18,0,0,0,0,0,0
1,201392386,2170660915,57029,36895,2024-10-04 19:35:19,0,0,0,0,0,0
1,201392386,1145490691,56025,47873,2024-10-04 19:35:19,0,0,0,0,0,0
1,201392386,2170660915,40669,36895,2024-10-04 19:35:19,0,0,0,0,0,0
1,201392386,2170660915,0,0,2024-10-04 19:35:19,128,84,212,1,1,2
1,201392386,2170660915,37534,36895,2024-10-04 19:35:19,0,0,0,0,0,0
1,201392386,2170660915,57029,36895,2024-10-04 19:35:20,0,0,0,0,0,0
1,201392386,1145490691,56025,47873,2024-10-04 19:35:20,0,0,0,0,0,0
1,201392386,2170660915,40669,36895,2024-10-04 19:35:20,0,0,0,0,0,0
1,201392386,2170660915,0,0,2024-10-04 19:35:20,0,84,84,0,1,1
1,201392386,2170660915,37534,36895,2024-10-04 19:35:20,0,0,0,0,0,0
1,201392386,2170660915,57029,36895,2024-10-04 19:35:21,0,0,0,0,0,0
1,201392386,1145490691,56025,47873,2024-10-04 19:35:21,0,0,0,0,0,0
1,201392386,2170660915,40669,36895,2024-10-04 19:35:21,0,0,0,0,0,0
1,201392386,2170660915,0,0,2024-10-04 19:35:21,128,84,212,1,1,2
1,201392386,2170660915,37534,36895,2024-10-04 19:35:21,0,0,0,0,0,0
1,201392386,2170660915,57029,36895,2024-10-04 19:35:22,0,0,0,0,0,0
1,201392386,1145490691,56025,47873,2024-10-04 19:35:22,0,0,0,0,0,0
1,201392386,2170660915,40669,36895,2024-10-04 19:35:22,0,0,0,0,0,0
1,201392386,2170660915,0,0,2024-10-04 19:35:22,128,84,212,1,1,2
1,201392386,2170660915,37534,36895,2024-10-04 19:35:22,0,0,0,0,0,0
1,201392386,2170660915,57029,36895,2024-10-04 19:35:23,0,0,0,0,0,0
1,201392386,2170660915,40669,36895,2024-10-04 19:35:23,0,0,0,0,0,0
1,201392386,2170660915,0,0,2024-10-04 19:35:23,128,84,212,1,1,2
1,201392386,2170660915,37534,36895,2024-10-04 19:35:23,0,0,0,0,0,0
1,201392386,2170660915,57029,36895,2024-10-04 19:35:24,0,0,0,0,0,0
1,201392386,2170660915,40669,36895,2024-10-04 19:35:24,0,0,0,0,0,0
1,201392386,2170660915,0,0,2024-10-04 19:35:24,0,0,0,0,0,0
1,201392386,2170660915,37534,36895,2024-10-04 19:35:24,0,0,0,0,0,0
1,201392386,2170660915,57029,36895,2024-10-04 19:35:25,0,0,0,0,0,0
1,201392386,2170660915,2696,36895,2024-10-04 19:35:25,570,455,1025,5,5,10
1,201392386,2170660915,0,0,2024-10-04 19:35:25,0,0,0,0,0,0
1,201392386,2170660915,37534,36895,2024-10-04 19:35:25,0,0,0,0,0,0
1,201392386,2170660915,57029,36895,2024-10-04 19:35:26,0,0,0,0,0,0
1,201392386,2170660915,2696,36895,2024-10-04 19:35:26,0,0,0,0,0,0
1,201392386,2170660915,0,0,2024-10-04 19:35:26,256,84,340,2,1,3
1,201392386,2170660915,37534,36895,2024-10-04 19:35:26,0,0,0,0,0,0
1,201392386,2170660915,57029,36895,2024-10-04 19:35:27,0,0,0,0,0,0
1,201392386,2170660915,2696,36895,2024-10-04 19:35:27,0,0,0,0,0,0
1,201392386,2170660915,0,0,2024-10-04 19:35:27,128,84,212,1,1,2
1,201392386,2170660915,37534,36895,2024-10-04 19:35:27,0,0,0,0,0,0
1,201392386,2170660915,57029,36895,2024-10-04 19:35:28,0,0,0,0,0,0
1,201392386,2170660915,2696,36895,2024-10-04 19:35:28,0,0,0,0,0,0
1,201392386,2170660915,0,0,2024-10-04 19:35:28,0,84,84,0,1,1
1,201392386,2170660915,37534,36895,2024-10-04 19:35:28,0,0,0,0,0,0
1,201392386,2170660915,57029,36895,2024-10-04 19:35:29,0,0,0,0,0,0
1,201392386,2170660915,2696,36895,2024-10-04 19:35:29,0,0,0,0,0,0
1,201392386,2170660915,0,0,2024-10-04 19:35:29,0,0,0,0,0,0
1,201392386,2170660915,37534,36895,2024-10-04 19:35:29,0,0,0,0,0,0
1,201392386,2170660915,57029,36895,2024-10-04 19:35:30,0,0,0,0,0,0
1,201392386,2170660915,2696,36895,2024-10-04 19:35:30,0,0,0,0,0,0
1,201392386,2170660915,0,0,2024-10-04 19:35:30,0,0,0,0,0,0
1,201392386,2170660915,37534,36895,2024-10-04 19:35:30,0,0,0,0,0,0
1,201392386,2170660915,57029,36895,2024-10-04 19:35:31,0,0,0,0,0,0
1,201392386,2170660915,2696,36895,2024-10-04 19:35:31,0,0,0,0,0,0
1,201392386,2170660915,0,0,2024-10-04 19:35:31,128,84,212,1,1,2
1,201392386,2170660915,37534,36895,2024-10-04 19:35:31,0,0,0,0,0,0
1,201392386,2170660915,57029,36895,2024-10-04 19:35:32,0,0,0,0,0,0
1,201392386,2170660915,2696,36895,2024-10-04 19:35:32,0,0,0,0,0,0
1,201392386,2170660915,0,0,2024-10-04 19:35:32,128,84,212,1,1,2
1,201392386,2170660915,37534,36895,2024-10-04 19:35:32,0,0,0,0,0,0
1,201392386,2170660915,57029,36895,2024-10-04 19:35:33,0,0,0,0,0,0
1,201392386,2170660915,2696,36895,2024-10-04 19:35:33,0,0,0,0,0,0
1,201392386,1145490692,52409,47873,2024-10-04 19:35:33,1029,5429,6458,5,6,11
1,201392386,2170660915,0,0,2024-10-04 19:35:33,128,84,212,1,1,2
1,201392386,2170660915,37534,36895,2024-10-04 19:35:33,0,0,0,0,0,0
1,201392386,2170660915,57029,36895,2024-10-04 19:35:34,0,0,0,0,0,0
1,201392386,2170660915,2696,36895,2024-10-04 19:35:34,0,0,0,0,0,0
1,201392386,1145490692,52409,47873,2024-10-04 19:35:34,4359,76590,80949,40,57,97
1,201392386,2170660915,0,0,2024-10-04 19:35:34,0,0,0,0,0,0
1,201392386,2170660915,37534,36895,2024-10-04 19:35:34,0,0,0,0,0,0
1,201392386,2170660915,57029,36895,2024-10-04 19:35:35,0,0,0,0,0,0
1,201392386,2170660915,2696,36895,2024-10-04 19:35:35,0,0,0,0,0,0
1,201392386,1145490692,52409,47873,2024-10-04 19:35:35,816,11077,11893,8,10,18
1,201392386,2170660915,0,0,2024-10-04 19:35:35,0,0,0,0,0,0
1,201392386,2170660915,37534,36895,2024-10-04 19:35:35,0,0,0,0,0,0
1,201392386,2170660915,57029,36895,2024-10-04 19:35:36,0,0,0,0,0,0
1,201392386,2170660915,2696,36895,2024-10-04 19:35:36,0,0,0,0,0,0
1,201392386,1145490692,52409,47873,2024-10-04 19:35:36,0,0,0,0,0,0
1,201392386,2170660915,0,0,2024-10-04 19:35:36,0,0,0,0,0,0
1,201392386,2170660915,37534,36895,2024-10-04 19:35:36,0,0,0,0,0,0
1,201392386,2170660915,57029,36895,2024-10-04 19:35:37,0,0,0,0,0,0
1,201392386,2170660915,2696,36895,2024-10-04 19:35:37,0,0,0,0,0,0
1,201392386,1145490692,52409,47873,2024-10-04 19:35:37,0,0,0,0,0,0
1,201392386,2170660915,0,0,2024-10-04 19:35:37,0,0,0,0,0,0
1,201392386,2170660915,37534,36895,2024-10-04 19:35:37,0,0,0,0,0,0
1,201392386,2170660915,57029,36895,2024-10-04 19:35:38,0,0,0,0,0,0
1,201392386,2170660915,2696,36895,2024-10-04 19:35:38,0,0,0,0,0,0
1,201392386,1145490692,52409,47873,2024-10-04 19:35:38,0,0,0,0,0,0
1,201392386,2170660915,0,0,2024-10-04 19:35:38,0,0,0,0,0,0
1,201392386,2170660915,37534,36895,2024-10-04 19:35:38,0,0,0,0,0,0
1,201392386,2170660915,57029,36895,2024-10-04 19:35:39,0,0,0,0,0,0
1,201392386,2170660915,2696,36895,2024-10-04 19:35:39,0,0,0,0,0,0
1,201392386,1145490692,52409,47873,2024-10-04 19:35:39,0,0,0,0,0,0
1,201392386,2170660915,0,0,2024-10-04 19:35:39,0,0,0,0,0,0
1,201392386,2170660915,37534,36895,2024-10-04 19:35:39,0,0,0,0,0,0
1,201392386,2170660915,57029,36895,2024-10-04 19:35:40,0,0,0,0,0,0
1,201392386,2170660915,2696,36895,2024-10-04 19:35:40,0,0,0,0,0,0
1,201392386,1145490692,52409,47873,2024-10-04 19:35:40,0,0,0,0,0,0
1,201392386,2170660915,0,0,2024-10-04 19:35:40,0,0,0,0,0,0
1,201392386,2170660915,37534,36895,2024-10-04 19:35:40,0,0,0,0,0,0
1,201392386,2170660915,57029,36895,2024-10-04 19:35:41,0,0,0,0,0,0
1,201392386,2170660915,2696,36895,2024-10-04 19:35:41,0,0,0,0,0,0
1,201392386,1145490692,52409,47873,2024-10-04 19:35:41,0,0,0,0,0,0
1,201392386,2170660915,0,0,2024-10-04 19:35:41,0,0,0,0,0,0
1,201392386,2170660915,37534,36895,2024-10-04 19:35:41,0,0,0,0,0,0
1,201392386,2170660915,57029,36895,2024-10-04 19:35:42,0,0,0,0,0,0
1,201392386,2170660915,2696,36895,2024-10-04 19:35:42,0,0,0,0,0,0
1,201392386,1145490692,52409,47873,2024-10-04 19:35:42,0,0,0,0,0,0
1,201392386,2170660915,0,0,2024-10-04 19:35:42,0,0,0,0,0,0
1,201392386,2170660915,37534,36895,2024-10-04 19:35:42,0,0,0,0,0,0
1,201392386,2170660915,57029,36895,2024-10-04 19:35:43,0,0,0,0,0,0
1,201392386,2170660915,2696,36895,2024-10-04 19:35:43,0,0,0,0,0,0
1,201392386,1145490692,52409,47873,2024-10-04 19:35:43,0,0,0,0,0,0
1,201392386,2170660915,0,0,2024-10-04 19:35:43,0,0,0,0,0,0
1,201392386,2170660915,37534,36895,2024-10-04 19:35:43,0,0,0,0,0,0
1,201392386,2170660915,57029,36895,2024-10-04 19:35:44,0,0,0,0,0,0
1,201392386,2170660915,2696,36895,2024-10-04 19:35:44,0,0,0,0,0,0
1,201392386,1145490692,52409,47873,2024-10-04 19:35:44,0,0,0,0,0,0
1,201392386,2170660915,0,0,2024-10-04 19:35:44,128,0,128,1,0,1
1,201392386,2170660915,37534,36895,2024-10-04 19:35:44,0,0,0,0,0,0
1,201392386,2170660915,57029,36895,2024-10-04 19:35:45,0,0,0,0,0,0
1,201392386,2170660915,2696,36895,2024-10-04 19:35:45,0,0,0,0,0,0
1,201392386,1145490692,52409,47873,2024-10-04 19:35:45,0,0,0,0,0,0
1,201392386,2170660915,0,0,2024-10-04 19:35:45,128,84,212,1,1,2
1,201392386,2170660915,37534,36895,2024-10-04 19:35:45,0,0,0,0,0,0
1,201392386,2170660915,57029,36895,2024-10-04 19:35:46,0,0,0,0,0,0
1,201392386,2170660915,2696,36895,2024-10-04 19:35:46,0,0,0,0,0,0
1,201392386,1145490692,52409,47873,2024-10-04 19:35:46,0,0,0,0,0,0
1,201392386,2170660915,0,0,2024-10-04 19:35:46,128,84,212,1,1,2
1,201392386,2170660915,37534,36895,2024-10-04 19:35:46,0,0,0,0,0,0
1,201392386,2170660915,57029,36895,2024-10-04 19:35:47,0,0,0,0,0,0
1,201392386,2170660915,2696,36895,2024-10-04 19:35:47,0,0,0,0,0,0
1,201392386,1145490692,52409,47873,2024-10-04 19:35:47,0,0,0,0,0,0
1,201392386,2170660915,0,0,2024-10-04 19:35:47,128,84,212,1,1,2
1,201392386,2170660915,37534,36895,2024-10-04 19:35:47,0,0,0,0,0,0
1,201392386,2170660915,57029,36895,2024-10-04 19:35:48,0,0,0,0,0,0
1,201392386,2170660915,2696,36895,2024-10-04 19:35:48,0,0,0,0,0,0
1,201392386,1145490692,52409,47873,2024-10-04 19:35:48,0,0,0,0,0,0
1,201392386,2170660915,0,0,2024-10-04 19:35:48,128,84,212,1,1,2
1,201392386,2170660915,37534,36895,2024-10-04 19:35:48,0,0,0,0,0,0
1,201392386,2170660915,57029,36895,2024-10-04 19:35:49,0,0,0,0,0,0
1,201392386,2170660915,2696,36895,2024-10-04 19:35:49,0,0,0,0,0,0
1,201392386,1145490692,52409,47873,2024-10-04 19:35:49,0,0,0,0,0,0
1,201392386,2170660915,0,0,2024-10-04 19:35:49,128,84,212,1,1,2
1,201392386,2170660915,37534,36895,2024-10-04 19:35:49,0,0,0,0,0,0
1,201392386,2170660915,57029,36895,2024-10-04 19:35:50,0,0,0,0,0,0
1,201392386,2170660915,2696,36895,2024-10-04 19:35:50,0,0,0,0,0,0
1,201392386,1145490692,52409,47873,2024-10-04 19:35:50,0,0,0,0,0,0
1,201392386,2170660915,0,0,2024-10-04 19:35:50,128,84,212,1,1,2
1,201392386,2170660915,37534,36895,2024-10-04 19:35:50,0,0,0,0,0,0
1,201392386,2170660915,57029,36895,2024-10-04 19:35:51,0,0,0,0,0,0
1,201392386,2170660915,2696,36895,2024-10-04 19:35:51,0,0,0,0,0,0
1,201392386,1145490692,52409,47873,2024-10-04 19:35:51,0,0,0,0,0,0
1,201392386,2170660915,0,0,2024-10-04 19:35:51,128,84,212,1,1,2
1,201392386,2170660915,37534,36895,2024-10-04 19:35:51,0,0,0,0,0,0
1,201392386,2170660915,57029,36895,2024-10-04 19:35:52,0,0,0,0,0,0
1,201392386,2170660915,2696,36895,2024-10-04 19:35:52,0,0,0,0,0,0
1,201392386,1145490692,52409,47873,2024-10-04 19:35:52,0,0,0,0,0,0
1,201392386,2170660915,0,0,2024-10-04 19:35:52,128,84,212,1,1,2
1,201392386,2170660915,37534,36895,2024-10-04 19:35:52,0,0,0,0,0,0
1,201392386,2170660915,57029,36895,2024-10-04 19:35:53,0,0,0,0,0,0
1,201392386,2170660915,2696,36895,2024-10-04 19:35:53,0,0,0,0,0,0
1,201392386,1145490692,52409,47873,2024-10-04 19:35:53,0,0,0,0,0,0
1,201392386,2170660915,0,0,2024-10-04 19:35:53,128,84,212,1,1,2
1,201392386,2170660915,37534,36895,2024-10-04 19:35:53,0,0,0,0,0,0
1,201392386,2170660915,57029,36895,2024-10-04 19:35:54,0,0,0,0,0,0
1,201392386,2170660915,2696,36895,2024-10-04 19:35:54,0,0,0,0,0,0
1,201392386,2170660915,0,0,2024-10-04 19:35:54,0,84,84,0,1,1
1,201392386,2170660915,37534,36895,2024-10-04 19:35:54,0,0,0,0,0,0
1,201392386,2170660915,57029,36895,2024-10-04 19:35:55,0,0,0,0,0,0
1,201392386,2170660915,2696,36895,2024-10-04 19:35:55,0,0,0,0,0,0
1,201392386,2170660915,0,0,2024-10-04 19:35:55,0,0,0,0,0,0
1,201392386,2170660915,37534,36895,2024-10-04 19:35:55,0,0,0,0,0,0
1,201392386,2170660915,57029,36895,2024-10-04 19:35:56,0,0,0,0,0,0
1,201392386,2170660915,43657,36895,2024-10-04 19:35:56,570,455,1025,5,5,10
1,201392386,2170660915,0,0,2024-10-04 19:35:56,128,84,212,1,1,2
1,201392386,2170660915,37534,36895,2024-10-04 19:35:56,0,0,0,0,0,0
1,201392386,2170660915,57029,36895,2024-10-04 19:35:57,0,0,0,0,0,0
1,201392386,2170660915,43657,36895,2024-10-04 19:35:57,0,0,0,0,0,0
1,201392386,2170660915,0,0,2024-10-04 19:35:57,0,0,0,0,0,0
1,201392386,2170660915,37534,36895,2024-10-04 19:35:57,0,0,0,0,0,0
1,201392386,2170660915,57029,36895,2024-10-04 19:35:58,0,0,0,0,0,0
1,201392386,2170660915,43657,36895,2024-10-04 19:35:58,0,0,0,0,0,0
1,201392386,2170660915,0,0,2024-10-04 19:35:58,128,84,212,1,1,2
1,201392386,2170660915,37534,36895,2024-10-04 19:35:58,0,0,0,0,0,0
1,201392386,2170660915,57029,36895,2024-10-04 19:35:59,0,0,0,0,0,0
1,201392386,2170660915,43657,36895,2024-10-04 19:35:59,0,0,0,0,0,0
1,201392386,2170660915,0,0,2024-10-04 19:35:59,128,84,212,1,1,2
1,201392386,2170660915,37534,36895,2024-10-04 19:35:59,0,0,0,0,0,0
1,201392386,2170660915,57029,36895,2024-10-04 19:36:00,0,0,0,0,0,0
1,201392386,2170660915,43657,36895,2024-10-04 19:36:00,0,0,0,0,0,0
1,201392386,2170660915,0,0,2024-10-04 19:36:00,0,0,0,0,0,0
1,201392386,2170660915,37534,36895,2024-10-04 19:36:00,0,0,0,0,0,0
1,201392386,2170660915,57029,36895,2024-10-04 19:36:01,0,0,0,0,0,0
1,201392386,2170660915,43657,36895,2024-10-04 19:36:01,0,0,0,0,0,0
1,201392386,2170660915,0,0,2024-10-04 19:36:01,0,0,0,0,0,0
1,201392386,2170660915,37534,36895,2024-10-04 19:36:01,0,0,0,0,0,0
1,201392386,2170660915,57029,36895,2024-10-04 19:36:02,0,0,0,0,0,0
1,201392386,2170660915,43657,36895,2024-10-04 19:36:02,0,0,0,0,0,0
1,201392386,2170660915,0,0,2024-10-04 19:36:02,128,84,212,1,1,2
1,201392386,2170660915,37534,36895,2024-10-04 19:36:02,0,0,0,0,0,0
1,201392386,2170660915,57029,36895,2024-10-04 19:36:03,0,0,0,0,0,0
1,201392386,2170660915,43657,36895,2024-10-04 19:36:03,0,0,0,0,0,0
1,201392386,2170660915,0,0,2024-10-04 19:36:03,128,84,212,1,1,2
1,201392386,2170660915,37534,36895,2024-10-04 19:36:03,0,0,0,0,0,0
1,201392386,2170660915,57029,36895,2024-10-04 19:36:04,0,0,0,0,0,0
1,201392386,2170660915,43657,36895,2024-10-04 19:36:04,0,0,0,0,0,0
1,201392386,1145490690,11917,47873,2024-10-04 19:36:04,3660,46097,49757,28,39,67
1,201392386,2170660915,0,0,2024-10-04 19:36:04,128,84,212,1,1,2
1,201392386,2170660915,37534,36895,2024-10-04 19:36:04,0,0,0,0,0,0
1,201392386,2170660915,57029,36895,2024-10-04 19:36:05,0,0,0,0,0,0
1,201392386,2170660915,43657,36895,2024-10-04 19:36:05,0,0,0,0,0,0
1,201392386,1145490690,11917,47873,2024-10-04 19:36:05,3144,53101,56245,31,37,68
1,201392386,2170660915,0,0,2024-10-04 19:36:05,0,0,0,0,0,0
1,201392386,2170660915,37534,36895,2024-10-04 19:36:05,0,0,0,0,0,0
1,201392386,2170660915,57029,36895,2024-10-04 19:36:06,0,0,0,0,0,0
1,201392386,2170660915,43657,36895,2024-10-04 19:36:06,0,0,0,0,0,0
1,201392386,1145490690,11917,47873,2024-10-04 19:36:06,0,0,0,0,0,0
1,201392386,2170660915,0,0,2024-10-04 19:36:06,0,0,0,0,0,0
1,201392386,2170660915,37534,36895,2024-10-04 19:36:06,0,0,0,0,0,0
1,201392386,2170660915,57029,36895,2024-10-04 19:36:07,0,0,0,0,0,0
1,201392386,2170660915,43657,36895,2024-10-04 19:36:07,0,0,0,0,0,0
1,201392386,1145490690,11917,47873,2024-10-04 19:36:07,0,0,0,0,0,0
1,201392386,2170660915,0,0,2024-10-04 19:36:07,0,0,0,0,0,0
1,201392386,2170660915,37534,36895,2024-10-04 19:36:07,0,0,0,0,0,0
1,201392386,2170660915,57029,36895,2024-10-04 19:36:08,0,0,0,0,0,0
1,201392386,2170660915,43657,36895,2024-10-04 19:36:08,0,0,0,0,0,0
1,201392386,1145490690,11917,47873,2024-10-04 19:36:08,0,0,0,0,0,0
1,201392386,2170660915,0,0,2024-10-04 19:36:08,0,0,0,0,0,0
1,201392386,2170660915,37534,36895,2024-10-04 19:36:08,0,0,0,0,0,0
1,201392386,2170660915,57029,36895,2024-10-04 19:36:09,0,0,0,0,0,0
1,201392386,2170660915,43657,36895,2024-10-04 19:36:09,0,0,0,0,0,0
1,201392386,1145490690,11917,47873,2024-10-04 19:36:09,0,0,0,0,0,0
1,201392386,2170660915,0,0,2024-10-04 19:36:09,0,0,0,0,0,0
1,201392386,2170660915,37534,36895,2024-10-04 19:36:09,0,0,0,0,0,0
1,201392386,2170660915,57029,36895,2024-10-04 19:36:10,0,0,0,0,0,0
1,201392386,2170660915,43657,36895,2024-10-04 19:36:10,0,0,0,0,0,0
1,201392386,1145490690,11917,47873,2024-10-04 19:36:10,0,0,0,0,0,0
1,201392386,2170660915,0,0,2024-10-04 19:36:10,0,0,0,0,0,0
1,201392386,2170660915,37534,36895,2024-10-04 19:36:10,0,0,0,0,0,0
1,201392386,2170660915,57029,36895,2024-10-04 19:36:11,0,0,0,0,0,0
1,201392386,2170660915,43657,36895,2024-10-04 19:36:11,0,0,0,0,0,0
1,201392386,1145490690,11917,47873,2024-10-04 19:36:11,0,0,0,0,0,0
1,201392386,2170660915,0,0,2024-10-04 19:36:11,0,0,0,0,0,0
1,201392386,2170660915,37534,36895,2024-10-04 19:36:11,0,0,0,0,0,0
1,201392386,2170660915,57029,36895,2024-10-04 19:36:12,0,0,0,0,0,0
1,201392386,2170660915,43657,36895,2024-10-04 19:36:12,0,0,0,0,0,0
1,201392386,1145490690,11917,47873,2024-10-04 19:36:12,0,0,0,0,0,0
1,201392386,2170660915,0,0,2024-10-04 19:36:12,0,0,0,0,0,0
1,201392386,2170660915,37534,36895,2024-10-04 19:36:12,0,0,0,0,0,0
1,201392386,2170660915,57029,36895,2024-10-04 19:36:13,0,0,0,0,0,0
1,201392386,2170660915,43657,36895,2024-10-04 19:36:13,0,0,0,0,0,0
1,201392386,1145490690,11917,47873,2024-10-04 19:36:13,0,0,0,0,0,0
1,201392386,2170660915,0,0,2024-10-04 19:36:13,0,0,0,0,0,0
1,201392386,2170660915,37534,36895,2024-10-04 19:36:13,0,0,0,0,0,0
1,201392386,2170660915,57029,36895,2024-10-04 19:36:14,0,0,0,0,0,0
1,201392386,2170660915,43657,36895,2024-10-04 19:36:14,0,0,0,0,0,0
1,201392386,1145490690,11917,47873,2024-10-04 19:36:14,0,0,0,0,0,0
1,201392386,2170660915,0,0,2024-10-04 19:36:14,0,0,0,0,0,0
1,201392386,2170660915,37534,36895,2024-10-04 19:36:14,0,0,0,0,0,0
1,201392386,2170660915,57029,36895,2024-10-04 19:36:15,0,0,0,0,0,0
1,201392386,2170660915,43657,36895,2024-10-04 19:36:15,0,0,0,0,0,0
1,201392386,1145490690,11917,47873,2024-10-04 19:36:15,0,0,0,0,0,0
1,201392386,2170660915,0,0,2024-10-04 19:36:15,0,0,0,0,0,0
1,201392386,2170660915,37534,36895,2024-10-04 19:36:15,0,0,0,0,0,0
1,201392386,2170660915,57029,36895,2024-10-04 19:36:16,0,0,0,0,0,0
1,201392386,2170660915,43657,36895,2024-10-04 19:36:16,0,0,0,0,0,0
1,201392386,1145490690,11917,47873,2024-10-04 19:36:16,0,0,0,0,0,0
1,201392386,2170660915,0,0,2024-10-04 19:36:16,128,84,212,1,1,2
1,201392386,2170660915,37534,36895,2024-10-04 19:36:16,0,0,0,0,0,0
1,201392386,2170660915,57029,36895,2024-10-04 19:36:17,0,0,0,0,0,0
1,201392386,2170660915,43657,36895,2024-10-04 19:36:17,0,0,0,0,0,0
1,201392386,1145490690,11917,47873,2024-10-04 19:36:17,0,0,0,0,0,0
1,201392386,2170660915,0,0,2024-10-04 19:36:17,256,84,340,2,1,3
1,201392386,2170660915,37534,36895,2024-10-04 19:36:17,0,0,0,0,0,0
1,201392386,2170660915,57029,36895,2024-10-04 19:36:18,0,0,0,0,0,0
1,201392386,2170660915,43657,36895,2024-10-04 19:36:18,0,0,0,0,0,0
1,201392386,1145490690,11917,47873,2024-10-04 19:36:18,0,0,0,0,0,0
1,201392386,2170660915,0,0,2024-10-04 19:36:18,128,84,212,1,1,2
1,201392386,2170660915,37534,36895,2024-10-04 19:36:18,0,0,0,0,0,0
1,201392386,2170660915,57029,36895,2024-10-04 19:36:19,0,0,0,0,0,0
1,201392386,2170660915,43657,36895,2024-10-04 19:36:19,0,0,0,0,0,0
1,201392386,1145490690,11917,47873,2024-10-04 19:36:19,0,0,0,0,0,0
1,201392386,2170660915,0,0,2024-10-04 19:36:19,128,84,212,1,1,2
1,201392386,2170660915,37534,36895,2024-10-04 19:36:19,0,0,0,0,0,0
1,201392386,2170660915,57029,36895,2024-10-04 19:36:20,0,0,0,0,0,0
1,201392386,2170660915,43657,36895,2024-10-04 19:36:20,0,0,0,0,0,0
1,201392386,1145490690,11917,47873,2024-10-04 19:36:20,0,0,0,0,0,0
1,201392386,2170660915,0,0,2024-10-04 19:36:20,128,84,212,1,1,2
1,201392386,2170660915,37534,36895,2024-10-04 19:36:20,0,0,0,0,0,0
1,201392386,2170660915,57029,36895,2024-10-04 19:36:21,0,0,0,0,0,0
1,201392386,2170660915,43657,36895,2024-10-04 19:36:21,0,0,0,0,0,0
1,201392386,1145490690,11917,47873,2024-10-04 19:36:21,0,0,0,0,0,0
1,201392386,2170660915,0,0,2024-10-04 19:36:21,128,84,212,1,1,2
1,201392386,2170660915,37534,36895,2024-10-04 19:36:21,0,0,0,0,0,0
1,201392386,2170660915,57029,36895,2024-10-04 19:36:22,0,0,0,0,0,0
1,201392386,2170660915,43657,36895,2024-10-04 19:36:22,0,0,0,0,0,0
1,201392386,1145490690,11917,47873,2024-10-04 19:36:22,0,0,0,0,0,0
1,201392386,2170660915,0,0,2024-10-04 19:36:22,128,84,212,1,1,2
1,201392386,2170660915,37534,36895,2024-10-04 19:36:22,0,0,0,0,0,0
1,201392386,2170660915,57029,36895,2024-10-04 19:36:23,0,0,0,0,0,0
1,201392386,2170660915,43657,36895,2024-10-04 19:36:23,0,0,0,0,0,0
1,201392386,1145490690,11917,47873,2024-10-04 19:36:23,0,0,0,0,0,0
1,201392386,2170660915,0,0,2024-10-04 19:36:23,128,84,212,1,1,2
1,201392386,2170660915,37534,36895,2024-10-04 19:36:23,0,0,0,0,0,0
1,201392386,2170660915,57029,36895,2024-10-04 19:36:24,0,0,0,0,0,0
1,201392386,2170660915,43657,36895,2024-10-04 19:36:24,0,0,0,0,0,0
1,201392386,1145490690,11917,47873,2024-10-04 19:36:24,0,0,0,0,0,0
1,201392386,2170660915,0,0,2024-10-04 19:36:24,128,84,212,1,1,2
1,201392386,2170660915,37534,36895,2024-10-04 19:36:24,0,0,0,0,0,0
1,201392386,2170660915,57029,36895,2024-10-04 19:36:25,0,0,0,0,0,0
1,201392386,2170660915,43657,36895,2024-10-04 19:36:25,0,0,0,0,0,0
1,201392386,2170660915,0,0,2024-10-04 19:36:25,0,84,84,0,1,1
1,201392386,2170660915,37534,36895,2024-10-04 19:36:25,0,0,0,0,0,0
1,201392386,2170660915,57029,36895,2024-10-04 19:36:26,0,0,0,0,0,0
1,201392386,2170660915,43657,36895,2024-10-04 19:36:26,0,0,0,0,0,0
1,201392386,2170660915,0,0,2024-10-04 19:36:26,0,0,0,0,0,0
1,201392386,2170660915,37534,36895,2024-10-04 19:36:26,0,0,0,0,0,0
1,201392386,2170660915,57029,36895,2024-10-04 19:36:27,0,0,0,0,0,0
1,201392386,2170660915,43657,36895,2024-10-04 19:36:27,0,0,0,0,0,0
1,201392386,2170660915,0,0,2024-10-04 19:36:27,0,0,0,0,0,0
1,201392386,2170660915,37534,36895,2024-10-04 19:36:27,0,0,0,0,0,0
1,201392386,2170660915,11980,36895,2024-10-04 19:36:27,570,455,1025,5,5,10
1,201392386,2170660915,57029,36895,2024-10-04 19:36:28,0,0,0,0,0,0
1,201392386,2170660915,43657,36895,2024-10-04 19:36:28,0,0,0,0,0,0
1,201392386,2170660915,0,0,2024-10-04 19:36:28,128,84,212,1,1,2
1,201392386,2170660915,37534,36895,2024-10-04 19:36:28,0,0,0,0,0,0
1,201392386,2170660915,11980,36895,2024-10-04 19:36:28,0,0,0,0,0,0
1,201392386,2170660915,57029,36895,2024-10-04 19:36:29,0,0,0,0,0,0
1,201392386,2170660915,0,0,2024-10-04 19:36:29,128,84,212,1,1,2
1,201392386,2170660915,37534,36895,2024-10-04 19:36:29,0,0,0,0,0,0
1,201392386,2170660915,11980,36895,2024-10-04 19:36:29,0,0,0,0,0,0
1,201392386,2170660915,57029,36895,2024-10-04 19:36:30,0,0,0,0,0,0
1,201392386,2170660915,0,0,2024-10-04 19:36:30,128,84,212,1,1,2
1,201392386,2170660915,37534,36895,2024-10-04 19:36:30,0,0,0,0,0,0
1,201392386,2170660915,11980,36895,2024-10-04 19:36:30,0,0,0,0,0,0
1,201392386,2170660915,57029,36895,2024-10-04 19:36:31,0,0,0,0,0,0
1,201392386,2170660915,0,0,2024-10-04 19:36:31,0,0,0,0,0,0
1,201392386,2170660915,37534,36895,2024-10-04 19:36:31,0,0,0,0,0,0
1,201392386,2170660915,11980,36895,2024-10-04 19:36:31,0,0,0,0,0,0
1,201392386,2170660915,57029,36895,2024-10-04 19:36:32,0,0,0,0,0,0
1,201392386,2170660915,0,0,2024-10-04 19:36:32,0,0,0,0,0,0
1,201392386,2170660915,37534,36895,2024-10-04 19:36:32,0,0,0,0,0,0
1,201392386,2170660915,11980,36895,2024-10-04 19:36:32,0,0,0,0,0,0
1,201392386,2170660915,57029,36895,2024-10-04 19:36:33,0,0,0,0,0,0
1,201392386,2170660915,0,0,2024-10-04 19:36:33,128,0,128,1,0,1
1,201392386,2170660915,37534,36895,2024-10-04 19:36:33,0,0,0,0,0,0
1,201392386,2170660915,11980,36895,2024-10-04 19:36:33,0,0,0,0,0,0
1,201392386,2170660915,57029,36895,2024-10-04 19:36:34,0,0,0,0,0,0
1,201392386,2170660915,0,0,2024-10-04 19:36:34,128,84,212,1,1,2
1,201392386,2170660915,37534,36895,2024-10-04 19:36:34,0,0,0,0,0,0
1,201392386,2170660915,11980,36895,2024-10-04 19:36:34,0,0,0,0,0,0
1,201392386,2170660915,57029,36895,2024-10-04 19:36:35,0,0,0,0,0,0
1,201392386,2170660915,0,0,2024-10-04 19:36:35,128,84,212,1,1,2
1,201392386,2170660915,37534,36895,2024-10-04 19:36:35,0,0,0,0,0,0
1,201392386,2170660915,11980,36895,2024-10-04 19:36:35,0,0,0,0,0,0
1,201392386,2170660915,57029,36895,2024-10-04 19:36:36,0,0,0,0,0,0
1,201392386,1145490691,13005,47873,2024-10-04 19:36:36,5544,85064,90608,47,71,118
1,201392386,2170660915,0,0,2024-10-04 19:36:36,0,84,84,0,1,1
1,201392386,2170660915,37534,36895,2024-10-04 19:36:36,0,0,0,0,0,0
1,201392386,2170660915,11980,36895,2024-10-04 19:36:36,0,0,0,0,0,0
1,201392386,2170660915,57029,36895,2024-10-04 19:36:37,0,0,0,0,0,0
1,201392386,1145490691,13005,47873,2024-10-04 19:36:37,0,0,0,0,0,0
1,201392386,2170660915,0,0,2024-10-04 19:36:37,0,0,0,0,0,0
1,201392386,2170660915,37534,36895,2024-10-04 19:36:37,0,0,0,0,0,0
1,201392386,2170660915,11980,36895,2024-10-04 19:36:37,0,0,0,0,0,0
1,201392386,2170660915,57029,36895,2024-10-04 19:36:38,0,0,0,0,0,0
1,201392386,1145490691,13005,47873,2024-10-04 19:36:38,0,0,0,0,0,0
1,201392386,2170660915,0,0,2024-10-04 19:36:38,0,0,0,0,0,0
1,201392386,2170660915,37534,36895,2024-10-04 19:36:38,0,0,0,0,0,0
1,201392386,2170660915,11980,36895,2024-10-04 19:36:38,0,0,0,0,0,0
1,201392386,2170660915,57029,36895,2024-10-04 19:36:39,0,0,0,0,0,0
1,201392386,1145490691,13005,47873,2024-10-04 19:36:39,0,0,0,0,0,0
1,201392386,2170660915,0,0,2024-10-04 19:36:39,0,0,0,0,0,0
1,201392386,2170660915,37534,36895,2024-10-04 19:36:39,0,0,0,0,0,0
1,201392386,2170660915,11980,36895,2024-10-04 19:36:39,0,0,0,0,0,0
1,201392386,2170660915,57029,36895,2024-10-04 19:36:40,0,0,0,0,0,0
1,201392386,1145490691,13005,47873,2024-10-04 19:36:40,0,0,0,0,0,0
1,201392386,2170660915,0,0,2024-10-04 19:36:40,0,0,0,0,0,0
1,201392386,2170660915,37534,36895,2024-10-04 19:36:40,0,0,0,0,0,0
1,201392386,2170660915,11980,36895,2024-10-04 19:36:40,0,0,0,0,0,0
1,201392386,2170660915,57029,36895,2024-10-04 19:36:41,0,0,0,0,0,0
1,201392386,1145490691,13005,47873,2024-10-04 19:36:41,0,0,0,0,0,0
1,201392386,2170660915,0,0,2024-10-04 19:36:41,0,0,0,0,0,0
1,201392386,2170660915,37534,36895,2024-10-04 19:36:41,0,0,0,0,0,0
1,201392386,2170660915,11980,36895,2024-10-04 19:36:41,0,0,0,0,0,0
1,201392386,2170660915,57029,36895,2024-10-04 19:36:42,0,0,0,0,0,0
1,201392386,1145490691,13005,47873,2024-10-04 19:36:42,0,0,0,0,0,0
1,201392386,2170660915,0,0,2024-10-04 19:36:42,0,0,0,0,0,0
1,201392386,2170660915,37534,36895,2024-10-04 19:36:42,0,0,0,0,0,0
1,201392386,2170660915,11980,36895,2024-10-04 19:36:42,0,0,0,0,0,0
1,201392386,2170660915,57029,36895,2024-10-04 19:36:43,0,0,0,0,0,0
1,201392386,1145490691,13005,47873,2024-10-04 19:36:43,0,0,0,0,0,0
1,201392386,2170660915,0,0,2024-10-04 19:36:43,0,0,0,0,0,0
1,201392386,2170660915,37534,36895,2024-10-04 19:36:43,0,0,0,0,0,0
1,201392386,2170660915,11980,36895,2024-10-04 19:36:43,0,0,0,0,0,0
1,201392386,2170660915,57029,36895,2024-10-04 19:36:44,0,0,0,0,0,0
1,201392386,1145490691,13005,47873,2024-10-04 19:36:44,0,0,0,0,0,0
1,201392386,2170660915,0,0,2024-10-04 19:36:44,0,0,0,0,0,0
1,201392386,2170660915,37534,36895,2024-10-04 19:36:44,0,0,0,0,0,0
1,201392386,2170660915,11980,36895,2024-10-04 19:36:44,0,0,0,0,0,0
1,201392386,2170660915,57029,36895,2024-10-04 19:36:45,0,0,0,0,0,0
1,201392386,1145490691,13005,47873,2024-10-04 19:36:45,0,0,0,0,0,0
1,201392386,2170660915,0,0,2024-10-04 19:36:45,128,0,128,1,0,1
1,201392386,2170660915,37534,36895,2024-10-04 19:36:45,0,0,0,0,0,0
1,201392386,2170660915,11980,36895,2024-10-04 19:36:45,0,0,0,0,0,0
1,201392386,2170660915,57029,36895,2024-10-04 19:36:46,0,0,0,0,0,0
1,201392386,1145490691,13005,47873,2024-10-04 19:36:46,0,0,0,0,0,0
1,201392386,2170660915,0,0,2024-10-04 19:36:46,128,84,212,1,1,2
1,201392386,2170660915,37534,36895,2024-10-04 19:36:46,0,0,0,0,0,0
1,201392386,2170660915,11980,36895,2024-10-04 19:36:46,0,0,0,0,0,0
1,201392386,2170660915,57029,36895,2024-10-04 19:36:47,0,0,0,0,0,0
1,201392386,1145490691,13005,47873,2024-10-04 19:36:47,0,0,0,0,0,0
1,201392386,2170660915,0,0,2024-10-04 19:36:47,128,84,212,1,1,2
1,201392386,2170660915,37534,36895,2024-10-04 19:36:47,0,0,0,0,0,0
1,201392386,2170660915,11980,36895,2024-10-04 19:36:47,0,0,0,0,0,0
1,201392386,2170660915,57029,36895,2024-10-04 19:36:48,0,0,0,0,0,0
1,201392386,1145490691,13005,47873,2024-10-04 19:36:48,0,0,0,0,0,0
1,201392386,2170660915,0,0,2024-10-04 19:36:48,128,168,296,1,2,3
1,201392386,2170660915,37534,36895,2024-10-04 19:36:48,0,0,0,0,0,0
1,201392386,2170660915,11980,36895,2024-10-04 19:36:48,0,0,0,0,0,0
1,201392386,2170660915,57029,36895,2024-10-04 19:36:49,0,0,0,0,0,0
1,201392386,1145490691,13005,47873,2024-10-04 19:36:49,0,0,0,0,0,0
1,201392386,2170660915,0,0,2024-10-04 19:36:49,128,84,212,1,1,2
1,201392386,2170660915,37534,36895,2024-10-04 19:36:49,0,0,0,0,0,0
1,201392386,2170660915,11980,36895,2024-10-04 19:36:49,0,0,0,0,0,0
1,201392386,2170660915,57029,36895,2024-10-04 19:36:50,0,0,0,0,0,0
1,201392386,1145490691,13005,47873,2024-10-04 19:36:50,0,0,0,0,0,0
1,201392386,2170660915,0,0,2024-10-04 19:36:50,128,84,212,1,1,2
1,201392386,2170660915,37534,36895,2024-10-04 19:36:50,0,0,0,0,0,0
1,201392386,2170660915,11980,36895,2024-10-04 19:36:50,0,0,0,0,0,0
1,201392386,2170660915,57029,36895,2024-10-04 19:36:51,0,0,0,0,0,0
1,201392386,1145490691,13005,47873,2024-10-04 19:36:51,0,0,0,0,0,0
1,201392386,2170660915,0,0,2024-10-04 19:36:51,128,84,212,1,1,2
1,201392386,2170660915,37534,36895,2024-10-04 19:36:51,0,0,0,0,0,0
1,201392386,2170660915,11980,36895,2024-10-04 19:36:51,0,0,0,0,0,0
1,201392386,2170660915,57029,36895,2024-10-04 19:36:52,0,0,0,0,0,0
1,201392386,1145490691,13005,47873,2024-10-04 19:36:52,0,0,0,0,0,0
1,201392386,2170660915,0,0,2024-10-04 19:36:52,128,84,212,1,1,2
1,201392386,2170660915,37534,36895,2024-10-04 19:36:52,0,0,0,0,0,0
1,201392386,2170660915,11980,36895,2024-10-04 19:36:52,0,0,0,0,0,0
1,201392386,2170660915,57029,36895,2024-10-04 19:36:53,0,0,0,0,0,0
1,201392386,1145490691,13005,47873,2024-10-04 19:36:53,0,0,0,0,0,0
1,201392386,2170660915,0,0,2024-10-04 19:36:53,128,0,128,1,0,1
1,201392386,2170660915,37534,36895,2024-10-04 19:36:53,0,0,0,0,0,0
1,201392386,2170660915,11980,36895,2024-10-04 19:36:53,0,0,0,0,0,0
1,201392386,2170660915,57029,36895,2024-10-04 19:36:54,0,0,0,0,0,0
1,201392386,1145490691,13005,47873,2024-10-04 19:36:54,0,0,0,0,0,0
1,201392386,2170660915,0,0,2024-10-04 19:36:54,128,84,212,1,1,2
1,201392386,2170660915,37534,36895,2024-10-04 19:36:54,0,0,0,0,0,0
1,201392386,2170660915,11980,36895,2024-10-04 19:36:54,0,0,0,0,0,0
1,201392386,2170660915,57029,36895,2024-10-04 19:36:55,0,0,0,0,0,0
1,201392386,1145490691,13005,47873,2024-10-04 19:36:55,0,0,0,0,0,0
1,201392386,2170660915,0,0,2024-10-04 19:36:55,0,84,84,0,1,1
1,201392386,2170660915,37534,36895,2024-10-04 19:36:55,0,0,0,0,0,0
1,201392386,2170660915,11980,36895,2024-10-04 19:36:55,0,0,0,0,0,0
1,201392386,2170660915,57029,36895,2024-10-04 19:36:56,0,0,0,0,0,0
1,201392386,2170660915,63150,36895,2024-10-04 19:36:56,666,507,1173,6,6,12
1,201392386,2170660915,0,0,2024-10-04 19:36:56,0,0,0,0,0,0
1,201392386,2170660915,37534,36895,2024-10-04 19:36:56,0,0,0,0,0,0
1,201392386,2170660915,11980,36895,2024-10-04 19:36:56,0,0,0,0,0,0
1,201392386,2170660915,57029,36895,2024-10-04 19:36:57,0,0,0,0,0,0
1,201392386,2170660915,63150,36895,2024-10-04 19:36:57,0,0,0,0,0,0
1,201392386,2170660915,0,0,2024-10-04 19:36:57,128,84,212,1,1,2
1,201392386,2170660915,37534,36895,2024-10-04 19:36:57,0,0,0,0,0,0
1,201392386,2170660915,11980,36895,2024-10-04 19:36:57,0,0,0,0,0,0
1,201392386,2170660915,57029,36895,2024-10-04 19:36:58,0,0,0,0,0,0
1,201392386,2170660915,63150,36895,2024-10-04 19:36:58,0,0,0,0,0,0
1,201392386,2170660915,0,0,2024-10-04 19:36:58,128,84,212,1,1,2
1,201392386,2170660915,37534,36895,2024-10-04 19:36:58,0,0,0,0,0,0
1,201392386,2170660915,11980,36895,2024-10-04 19:36:58,0,0,0,0,0,0
1,201392386,2170660915,57029,36895,2024-10-04 19:36:59,0,0,0,0,0,0
1,201392386,2170660915,63150,36895,2024-10-04 19:36:59,0,0,0,0,0,0
1,201392386,2170660915,0,0,2024-10-04 19:36:59,0,0,0,0,0,0
1,201392386,2170660915,37534,36895,2024-10-04 19:36:59,0,0,0,0,0,0
1,201392386,2170660915,11980,36895,2024-10-04 19:36:59,0,0,0,0,0,0
1,201392386,2170660915,57029,36895,2024-10-04 19:37:00,0,0,0,0,0,0
1,201392386,2170660915,63150,36895,2024-10-04 19:37:00,0,0,0,0,0,0
1,201392386,2170660915,0,0,2024-10-04 19:37:00,128,84,212,1,1,2
1,201392386,2170660915,37534,36895,2024-10-04 19:37:00,0,0,0,0,0,0
1,201392386,2170660915,11980,36895,2024-10-04 19:37:00,0,0,0,0,0,0
1,201392386,2170660915,57029,36895,2024-10-04 19:37:01,0,0,0,0,0,0
1,201392386,2170660915,63150,36895,2024-10-04 19:37:01,0,0,0,0,0,0
1,201392386,2170660915,0,0,2024-10-04 19:37:01,0,0,0,0,0,0
1,201392386,2170660915,37534,36895,2024-10-04 19:37:01,0,0,0,0,0,0
1,201392386,2170660915,11980,36895,2024-10-04 19:37:01,0,0,0,0,0,0
1,201392386,2170660915,57029,36895,2024-10-04 19:37:02,0,0,0,0,0,0
1,201392386,2170660915,63150,36895,2024-10-04 19:37:02,0,0,0,0,0,0
1,201392386,2170660915,0,0,2024-10-04 19:37:02,128,0,128,1,0,1
1,201392386,2170660915,37534,36895,2024-10-04 19:37:02,0,0,0,0,0,0
1,201392386,2170660915,11980,36895,2024-10-04 19:37:02,0,0,0,0,0,0
1,201392386,2170660915,57029,36895,2024-10-04 19:37:03,0,0,0,0,0,0
1,201392386,2170660915,63150,36895,2024-10-04 19:37:03,0,0,0,0,0,0
1,201392386,2170660915,0,0,2024-10-04 19:37:03,128,84,212,1,1,2
1,201392386,2170660915,37534,36895,2024-10-04 19:37:03,0,0,0,0,0,0
1,201392386,2170660915,11980,36895,2024-10-04 19:37:03,0,0,0,0,0,0
1,201392386,2170660915,57029,36895,2024-10-04 19:37:04,0,0,0,0,0,0
1,201392386,2170660915,63150,36895,2024-10-04 19:37:04,0,0,0,0,0,0
1,201392386,2170660915,0,0,2024-10-04 19:37:04,128,84,212,1,1,2
1,201392386,2170660915,37534,36895,2024-10-04 19:37:04,0,0,0,0,0,0
1,201392386,2170660915,11980,36895,2024-10-04 19:37:04,0,0,0,0,0,0
1,201392386,2170660915,57029,36895,2024-10-04 19:37:05,0,0,0,0,0,0
1,201392386,2170660915,63150,36895,2024-10-04 19:37:05,0,0,0,0,0,0
1,201392386,1145490692,7915,47873,2024-10-04 19:37:05,3360,40660,44020,25,36,61
1,201392386,2170660915,0,0,2024-10-04 19:37:05,0,84,84,0,1,1
1,201392386,2170660915,37534,36895,2024-10-04 19:37:05,0,0,0,0,0,0
1,201392386,2170660915,11980,36895,2024-10-04 19:37:05,0,0,0,0,0,0
1,201392386,2170660915,57029,36895,2024-10-04 19:37:06,0,0,0,0,0,0
1,201392386,2170660915,63150,36895,2024-10-04 19:37:06,0,0,0,0,0,0
1,201392386,1145490692,7915,47873,2024-10-04 19:37:06,3036,56660,59696,30,42,72
1,201392386,2170660915,0,0,2024-10-04 19:37:06,0,0,0,0,0,0
1,201392386,2170660915,37534,36895,2024-10-04 19:37:06,0,0,0,0,0,0
1,201392386,2170660915,11980,36895,2024-10-04 19:37:06,0,0,0,0,0,0
1,201392386,2170660915,57029,36895,2024-10-04 19:37:07,0,0,0,0,0,0
1,201392386,2170660915,63150,36895,2024-10-04 19:37:07,0,0,0,0,0,0
1,201392386,1145490692,7915,47873,2024-10-04 19:37:07,0,0,0,0,0,0
1,201392386,2170660915,0,0,2024-10-04 19:37:07,0,0,0,0,0,0
1,201392386,2170660915,37534,36895,2024-10-04 19:37:07,0,0,0,0,0,0
1,201392386,2170660915,11980,36895,2024-10-04 19:37:07,0,0,0,0,0,0
1,201392386,2170660915,57029,36895,2024-10-04 19:37:08,0,0,0,0,0,0
1,201392386,2170660915,63150,36895,2024-10-04 19:37:08,0,0,0,0,0,0
1,201392386,1145490692,7915,47873,2024-10-04 19:37:08,0,0,0,0,0,0
1,201392386,2170660915,0,0,2024-10-04 19:37:08,0,0,0,0,0,0
1,201392386,2170660915,37534,36895,2024-10-04 19:37:08,0,0,0,0,0,0
1,201392386,2170660915,11980,36895,2024-10-04 19:37:08,0,0,0,0,0,0
1,201392386,2170660915,57029,36895,2024-10-04 19:37:09,0,0,0,0,0,0
1,201392386,2170660915,63150,36895,2024-10-04 19:37:09,0,0,0,0,0,0
1,201392386,1145490692,7915,47873,2024-10-04 19:37:09,0,0,0,0,0,0
1,201392386,2170660915,0,0,2024-10-04 19:37:09,0,0,0,0,0,0
1,201392386,2170660915,37534,36895,2024-10-04 19:37:09,0,0,0,0,0,0
1,201392386,2170660915,11980,36895,2024-10-04 19:37:09,0,0,0,0,0,0
1,201392386,2170660915,57029,36895,2024-10-04 19:37:10,0,0,0,0,0,0
1,201392386,2170660915,63150,36895,2024-10-04 19:37:10,0,0,0,0,0,0
1,201392386,1145490692,7915,47873,2024-10-04 19:37:10,0,0,0,0,0,0
1,201392386,2170660915,0,0,2024-10-04 19:37:10,0,0,0,0,0,0
1,201392386,2170660915,37534,36895,2024-10-04 19:37:10,0,0,0,0,0,0
1,201392386,2170660915,11980,36895,2024-10-04 19:37:10,0,0,0,0,0,0
1,201392386,2170660915,57029,36895,2024-10-04 19:37:11,0,0,0,0,0,0
1,201392386,2170660915,63150,36895,2024-10-04 19:37:11,0,0,0,0,0,0
1,201392386,1145490692,7915,47873,2024-10-04 19:37:11,0,0,0,0,0,0
1,201392386,2170660915,0,0,2024-10-04 19:37:11,0,0,0,0,0,0
1,201392386,2170660915,37534,36895,2024-10-04 19:37:11,0,0,0,0,0,0
1,201392386,2170660915,11980,36895,2024-10-04 19:37:11,0,0,0,0,0,0
1,201392386,2170660915,57029,36895,2024-10-04 19:37:12,0,0,0,0,0,0
1,201392386,2170660915,63150,36895,2024-10-04 19:37:12,0,0,0,0,0,0
1,201392386,1145490692,7915,47873,2024-10-04 19:37:12,0,0,0,0,0,0
1,201392386,2170660915,0,0,2024-10-04 19:37:12,0,0,0,0,0,0
1,201392386,2170660915,37534,36895,2024-10-04 19:37:12,0,0,0,0,0,0
1,201392386,2170660915,11980,36895,2024-10-04 19:37:12,0,0,0,0,0,0
1,201392386,2170660915,57029,36895,2024-10-04 19:37:13,0,0,0,0,0,0
1,201392386,2170660915,63150,36895,2024-10-04 19:37:13,0,0,0,0,0,0
1,201392386,1145490692,7915,47873,2024-10-04 19:37:13,0,0,0,0,0,0
1,201392386,2170660915,0,0,2024-10-04 19:37:13,0,0,0,0,0,0
1,201392386,2170660915,37534,36895,2024-10-04 19:37:13,0,0,0,0,0,0
1,201392386,2170660915,11980,36895,2024-10-04 19:37:13,0,0,0,0,0,0
1,201392386,2170660915,57029,36895,2024-10-04 19:37:14,0,0,0,0,0,0
1,201392386,2170660915,63150,36895,2024-10-04 19:37:14,0,0,0,0,0,0
1,201392386,1145490692,7915,47873,2024-10-04 19:37:14,0,0,0,0,0,0
1,201392386,2170660915,0,0,2024-10-04 19:37:14,0,0,0,0,0,0
1,201392386,2170660915,37534,36895,2024-10-04 19:37:14,0,0,0,0,0,0
1,201392386,2170660915,11980,36895,2024-10-04 19:37:14,0,0,0,0,0,0
1,201392386,2170660915,57029,36895,2024-10-04 19:37:15,0,0,0,0,0,0
1,201392386,2170660915,63150,36895,2024-10-04 19:37:15,0,0,0,0,0,0
1,201392386,1145490692,7915,47873,2024-10-04 19:37:15,0,0,0,0,0,0
1,201392386,2170660915,0,0,2024-10-04 19:37:15,0,0,0,0,0,0
1,201392386,2170660915,37534,36895,2024-10-04 19:37:15,0,0,0,0,0,0
1,201392386,2170660915,11980,36895,2024-10-04 19:37:15,0,0,0,0,0,0
1,201392386,2170660915,57029,36895,2024-10-04 19:37:16,0,0,0,0,0,0
1,201392386,2170660915,63150,36895,2024-10-04 19:37:16,0,0,0,0,0,0
1,201392386,1145490692,7915,47873,2024-10-04 19:37:16,0,0,0,0,0,0
1,201392386,2170660915,0,0,2024-10-04 19:37:16,128,84,212,1,1,2
1,201392386,2170660915,37534,36895,2024-10-04 19:37:16,0,0,0,0,0,0
1,201392386,2170660915,11980,36895,2024-10-04 19:37:16,0,0,0,0,0,0
1,201392386,2170660915,57029,36895,2024-10-04 19:37:17,0,0,0,0,0,0
1,201392386,2170660915,63150,36895,2024-10-04 19:37:17,0,0,0,0,0,0
1,201392386,1145490692,7915,47873,2024-10-04 19:37:17,0,0,0,0,0,0
1,201392386,2170660915,0,0,2024-10-04 19:37:17,128,84,212,1,1,2
1,201392386,2170660915,37534,36895,2024-10-04 19:37:17,0,0,0,0,0,0
1,201392386,2170660915,11980,36895,2024-10-04 19:37:17,0,0,0,0,0,0
1,201392386,2170660915,57029,36895,2024-10-04 19:37:18,0,0,0,0,0,0
1,201392386,2170660915,63150,36895,2024-10-04 19:37:18,0,0,0,0,0,0
1,201392386,1145490692,7915,47873,2024-10-04 19:37:18,0,0,0,0,0,0
1,201392386,2170660915,0,0,2024-10-04 19:37:18,128,84,212,1,1,2
1,201392386,2170660915,37534,36895,2024-10-04 19:37:18,0,0,0,0,0,0
1,201392386,2170660915,11980,36895,2024-10-04 19:37:18,0,0,0,0,0,0
1,201392386,2170660915,57029,36895,2024-10-04 19:37:19,0,0,0,0,0,0
1,201392386,2170660915,63150,36895,2024-10-04 19:37:19,0,0,0,0,0,0
1,201392386,1145490692,7915,47873,2024-10-04 19:37:19,0,0,0,0,0,0
1,201392386,2170660915,0,0,2024-10-04 19:37:19,128,84,212,1,1,2
1,201392386,2170660915,37534,36895,2024-10-04 19:37:19,0,0,0,0,0,0
1,201392386,2170660915,11980,36895,2024-10-04 19:37:19,0,0,0,0,0,0
1,201392386,2170660915,57029,36895,2024-10-04 19:37:20,0,0,0,0,0,0
1,201392386,2170660915,63150,36895,2024-10-04 19:37:20,0,0,0,0,0,0
1,201392386,1145490692,7915,47873,2024-10-04 19:37:20,0,0,0,0,0,0
1,201392386,2170660915,0,0,2024-10-04 19:37:20,128,84,212,1,1,2
1,201392386,2170660915,37534,36895,2024-10-04 19:37:20,0,0,0,0,0,0
1,201392386,2170660915,11980,36895,2024-10-04 19:37:20,0,0,0,0,0,0
1,201392386,2170660915,57029,36895,2024-10-04 19:37:21,0,0,0,0,0,0
1,201392386,2170660915,63150,36895,2024-10-04 19:37:21,0,0,0,0,0,0
1,201392386,1145490692,7915,47873,2024-10-04 19:37:21,0,0,0,0,0,0
1,201392386,2170660915,0,0,2024-10-04 19:37:21,128,84,212,1,1,2
1,201392386,2170660915,37534,36895,2024-10-04 19:37:21,0,0,0,0,0,0
1,201392386,2170660915,11980,36895,2024-10-04 19:37:21,0,0,0,0,0,0
1,201392386,2170660915,57029,36895,2024-10-04 19:37:22,0,0,0,0,0,0
1,201392386,2170660915,63150,36895,2024-10-04 19:37:22,0,0,0,0,0,0
1,201392386,1145490692,7915,47873,2024-10-04 19:37:22,0,0,0,0,0,0
1,201392386,2170660915,0,0,2024-10-04 19:37:22,128,84,212,1,1,2
1,201392386,2170660915,37534,36895,2024-10-04 19:37:22,0,0,0,0,0,0
1,201392386,2170660915,11980,36895,2024-10-04 19:37:22,0,0,0,0,0,0
1,201392386,2170660915,57029,36895,2024-10-04 19:37:23,0,0,0,0,0,0
1,201392386,2170660915,63150,36895,2024-10-04 19:37:23,0,0,0,0,0,0
1,201392386,1145490692,7915,47873,2024-10-04 19:37:23,0,0,0,0,0,0
1,201392386,2170660915,0,0,2024-10-04 19:37:23,128,84,212,1,1,2
1,201392386,2170660915,37534,36895,2024-10-04 19:37:23,0,0,0,0,0,0
1,201392386,2170660915,11980,36895,2024-10-04 19:37:23,0,0,0,0,0,0
1,201392386,2170660915,57029,36895,2024-10-04 19:37:24,0,0,0,0,0,0
1,201392386,2170660915,63150,36895,2024-10-04 19:37:24,0,0,0,0,0,0
1,201392386,1145490692,7915,47873,2024-10-04 19:37:24,0,0,0,0,0,0
1,201392386,2170660915,0,0,2024-10-04 19:37:24,128,84,212,1,1,2
1,201392386,2170660915,37534,36895,2024-10-04 19:37:24,0,0,0,0,0,0
1,201392386,2170660915,11980,36895,2024-10-04 19:37:24,0,0,0,0,0,0
1,201392386,2170660915,57029,36895,2024-10-04 19:37:25,0,0,0,0,0,0
1,201392386,2170660915,63150,36895,2024-10-04 19:37:25,0,0,0,0,0,0
1,201392386,1145490692,7915,47873,2024-10-04 19:37:25,0,0,0,0,0,0
1,201392386,2170660915,0,0,2024-10-04 19:37:25,128,84,212,1,1,2
1,201392386,2170660915,37534,36895,2024-10-04 19:37:25,0,0,0,0,0,0
1,201392386,2170660915,11980,36895,2024-10-04 19:37:25,0,0,0,0,0,0
1,201392386,2170660915,57029,36895,2024-10-04 19:37:26,0,0,0,0,0,0
1,201392386,2170660915,63150,36895,2024-10-04 19:37:26,0,0,0,0,0,0
1,201392386,2170660915,0,0,2024-10-04 19:37:26,0,0,0,0,0,0
1,201392386,2170660915,37534,36895,2024-10-04 19:37:26,0,0,0,0,0,0
1,201392386,2170660915,11980,36895,2024-10-04 19:37:26,0,0,0,0,0,0
1,201392386,2170660915,57029,36895,2024-10-04 19:37:27,0,0,0,0,0,0
1,201392386,2170660915,63150,36895,2024-10-04 19:37:27,0,0,0,0,0,0
1,201392386,2170660915,8851,36895,2024-10-04 19:37:27,666,507,1173,6,6,12
1,201392386,2170660915,0,0,2024-10-04 19:37:27,128,0,128,1,0,1
1,201392386,2170660915,37534,36895,2024-10-04 19:37:27,0,0,0,0,0,0
1,201392386,2170660915,11980,36895,2024-10-04 19:37:27,0,0,0,0,0,0
1,201392386,2170660915,57029,36895,2024-10-04 19:37:28,0,0,0,0,0,0
1,201392386,2170660915,63150,36895,2024-10-04 19:37:28,0,0,0,0,0,0
1,201392386,2170660915,8851,36895,2024-10-04 19:37:28,0,0,0,0,0,0
1,201392386,2170660915,0,0,2024-10-04 19:37:28,128,84,212,1,1,2
1,201392386,2170660915,37534,36895,2024-10-04 19:37:28,0,0,0,0,0,0
1,201392386,2170660915,11980,36895,2024-10-04 19:37:28,0,0,0,0,0,0
1,201392386,2170660915,57029,36895,2024-10-04 19:37:29,0,0,0,0,0,0
1,201392386,2170660915,63150,36895,2024-10-04 19:37:29,0,0,0,0,0,0
1,201392386,2170660915,0,0,2024-10-04 19:37:29,0,84,84,0,1,1
1,201392386,2170660915,37534,36895,2024-10-04 19:37:29,0,0,0,0,0,0
1,201392386,2170660915,11980,36895,2024-10-04 19:37:29,0,0,0,0,0,0
1,201392386,2170660915,57029,36895,2024-10-04 19:37:30,0,0,0,0,0,0
1,201392386,2170660915,63150,36895,2024-10-04 19:37:30,0,0,0,0,0,0
1,201392386,2170660915,0,0,2024-10-04 19:37:30,128,84,212,1,1,2
1,201392386,2170660915,37534,36895,2024-10-04 19:37:30,0,0,0,0,0,0
1,201392386,2170660915,11980,36895,2024-10-04 19:37:30,0,0,0,0,0,0
1,201392386,2170660915,57029,36895,2024-10-04 19:37:31,0,0,0,0,0,0
1,201392386,2170660915,63150,36895,2024-10-04 19:37:31,0,0,0,0,0,0
1,201392386,2170660915,0,0,2024-10-04 19:37:31,0,0,0,0,0,0
1,201392386,2170660915,37534,36895,2024-10-04 19:37:31,0,0,0,0,0,0
1,201392386,2170660915,11980,36895,2024-10-04 19:37:31,0,0,0,0,0,0
1,201392386,2170660915,57029,36895,2024-10-04 19:37:32,0,0,0,0,0,0
1,201392386,2170660915,63150,36895,2024-10-04 19:37:32,0,0,0,0,0,0
1,201392386,2170660915,0,0,2024-10-04 19:37:32,0,0,0,0,0,0
1,201392386,2170660915,37534,36895,2024-10-04 19:37:32,0,0,0,0,0,0
1,201392386,2170660915,11980,36895,2024-10-04 19:37:32,0,0,0,0,0,0
1,201392386,2170660915,57029,36895,2024-10-04 19:37:33,0,0,0,0,0,0
1,201392386,2170660915,63150,36895,2024-10-04 19:37:33,0,0,0,0,0,0
1,201392386,2170660915,0,0,2024-10-04 19:37:33,0,0,0,0,0,0
1,201392386,2170660915,37534,36895,2024-10-04 19:37:33,0,0,0,0,0,0
1,201392386,2170660915,11980,36895,2024-10-04 19:37:33,0,0,0,0,0,0
1,201392386,2170660915,57029,36895,2024-10-04 19:37:34,0,0,0,0,0,0
1,201392386,2170660915,63150,36895,2024-10-04 19:37:34,0,0,0,0,0,0
1,201392386,2170660915,0,0,2024-10-04 19:37:34,256,84,340,2,1,3
1,201392386,2170660915,37534,36895,2024-10-04 19:37:34,0,0,0,0,0,0
1,201392386,2170660915,11980,36895,2024-10-04 19:37:34,0,0,0,0,0,0
1,201392386,2170660915,57029,36895,2024-10-04 19:37:35,0,0,0,0,0,0
1,201392386,1145490691,48280,47873,2024-10-04 19:37:35,2388,24797,27185,16,24,40
1,201392386,2170660915,63150,36895,2024-10-04 19:37:35,0,0,0,0,0,0
1,201392386,2170660915,0,0,2024-10-04 19:37:35,128,168,296,1,2,3
1,201392386,2170660915,37534,36895,2024-10-04 19:37:35,0,0,0,0,0,0
1,201392386,2170660915,11980,36895,2024-10-04 19:37:35,0,0,0,0,0,0
1,201392386,2170660915,57029,36895,2024-10-04 19:37:36,0,0,0,0,0,0
1,201392386,1145490691,48280,47873,2024-10-04 19:37:36,696,22336,23032,7,14,21
1,201392386,2170660915,63150,36895,2024-10-04 19:37:36,0,0,0,0,0,0
1,201392386,2170660915,0,0,2024-10-04 19:37:36,0,0,0,0,0,0
1,201392386,2170660915,37534,36895,2024-10-04 19:37:36,0,0,0,0,0,0
1,201392386,2170660915,11980,36895,2024-10-04 19:37:36,0,0,0,0,0,0
1,201392386,2170660915,57029,36895,2024-10-04 19:37:37,0,0,0,0,0,0
1,201392386,1145490691,48280,47873,2024-10-04 19:37:37,576,17270,17846,6,10,16
1,201392386,2170660915,63150,36895,2024-10-04 19:37:37,0,0,0,0,0,0
1,201392386,2170660915,0,0,2024-10-04 19:37:37,0,0,0,0,0,0
1,201392386,2170660915,37534,36895,2024-10-04 19:37:37,0,0,0,0,0,0
1,201392386,2170660915,11980,36895,2024-10-04 19:37:37,0,0,0,0,0,0
1,201392386,2170660915,57029,36895,2024-10-04 19:37:38,0,0,0,0,0,0
1,201392386,1145490691,48280,47873,2024-10-04 19:37:38,2796,49033,51829,28,35,63
1,201392386,2170660915,63150,36895,2024-10-04 19:37:38,0,0,0,0,0,0
1,201392386,2170660915,0,0,2024-10-04 19:37:38,0,0,0,0,0,0
1,201392386,2170660915,37534,36895,2024-10-04 19:37:38,0,0,0,0,0,0
1,201392386,2170660915,11980,36895,2024-10-04 19:37:38,0,0,0,0,0,0
1,201392386,2170660915,57029,36895,2024-10-04 19:37:39,0,0,0,0,0,0
1,201392386,1145490691,48280,47873,2024-10-04 19:37:39,0,0,0,0,0,0
1,201392386,2170660915,63150,36895,2024-10-04 19:37:39,0,0,0,0,0,0
1,201392386,2170660915,0,0,2024-10-04 19:37:39,0,0,0,0,0,0
1,201392386,2170660915,37534,36895,2024-10-04 19:37:39,0,0,0,0,0,0
1,201392386,2170660915,11980,36895,2024-10-04 19:37:39,0,0,0,0,0,0
1,201392386,2170660915,57029,36895,2024-10-04 19:37:40,0,0,0,0,0,0
1,201392386,1145490691,48280,47873,2024-10-04 19:37:40,0,0,0,0,0,0
1,201392386,2170660915,63150,36895,2024-10-04 19:37:40,0,0,0,0,0,0
1,201392386,2170660915,0,0,2024-10-04 19:37:40,0,0,0,0,0,0
1,201392386,2170660915,37534,36895,2024-10-04 19:37:40,0,0,0,0,0,0
1,201392386,2170660915,11980,36895,2024-10-04 19:37:40,0,0,0,0,0,0
1,201392386,2170660915,57029,36895,2024-10-04 19:37:41,0,0,0,0,0,0
1,201392386,1145490691,48280,47873,2024-10-04 19:37:41,0,0,0,0,0,0
1,201392386,2170660915,63150,36895,2024-10-04 19:37:41,0,0,0,0,0,0
1,201392386,2170660915,0,0,2024-10-04 19:37:41,0,0,0,0,0,0
1,201392386,2170660915,37534,36895,2024-10-04 19:37:41,0,0,0,0,0,0
1,201392386,2170660915,11980,36895,2024-10-04 19:37:41,0,0,0,0,0,0
1,201392386,2170660915,57029,36895,2024-10-04 19:37:42,0,0,0,0,0,0
1,201392386,1145490691,48280,47873,2024-10-04 19:37:42,0,0,0,0,0,0
1,201392386,2170660915,63150,36895,2024-10-04 19:37:42,0,0,0,0,0,0
1,201392386,2170660915,0,0,2024-10-04 19:37:42,0,0,0,0,0,0
1,201392386,2170660915,37534,36895,2024-10-04 19:37:42,0,0,0,0,0,0
1,201392386,2170660915,11980,36895,2024-10-04 19:37:42,0,0,0,0,0,0
1,201392386,2170660915,57029,36895,2024-10-04 19:37:43,0,0,0,0,0,0
1,201392386,1145490691,48280,47873,2024-10-04 19:37:43,0,0,0,0,0,0
1,201392386,2170660915,63150,36895,2024-10-04 19:37:43,0,0,0,0,0,0
1,201392386,2170660915,0,0,2024-10-04 19:37:43,0,0,0,0,0,0
1,201392386,2170660915,37534,36895,2024-10-04 19:37:43,0,0,0,0,0,0
1,201392386,2170660915,11980,36895,2024-10-04 19:37:43,0,0,0,0,0,0
1,201392386,2170660915,57029,36895,2024-10-04 19:37:44,0,0,0,0,0,0
1,201392386,1145490691,48280,47873,2024-10-04 19:37:44,0,0,0,0,0,0
1,201392386,2170660915,63150,36895,2024-10-04 19:37:44,0,0,0,0,0,0
1,201392386,2170660915,0,0,2024-10-04 19:37:44,0,0,0,0,0,0
1,201392386,2170660915,37534,36895,2024-10-04 19:37:44,0,0,0,0,0,0
1,201392386,2170660915,11980,36895,2024-10-04 19:37:44,0,0,0,0,0,0
1,201392386,2170660915,57029,36895,2024-10-04 19:37:45,0,0,0,0,0,0
1,201392386,1145490691,48280,47873,2024-10-04 19:37:45,0,0,0,0,0,0
1,201392386,2170660915,63150,36895,2024-10-04 19:37:45,0,0,0,0,0,0
1,201392386,2170660915,0,0,2024-10-04 19:37:45,0,0,0,0,0,0
1,201392386,2170660915,37534,36895,2024-10-04 19:37:45,0,0,0,0,0,0
1,201392386,2170660915,11980,36895,2024-10-04 19:37:45,0,0,0,0,0,0
1,201392386,2170660915,57029,36895,2024-10-04 19:37:46,0,0,0,0,0,0
1,201392386,1145490691,48280,47873,2024-10-04 19:37:46,0,0,0,0,0,0
1,201392386,2170660915,63150,36895,2024-10-04 19:37:46,0,0,0,0,0,0
1,201392386,2170660915,0,0,2024-10-04 19:37:46,0,0,0,0,0,0
1,201392386,2170660915,37534,36895,2024-10-04 19:37:46,0,0,0,0,0,0
1,201392386,2170660915,11980,36895,2024-10-04 19:37:46,0,0,0,0,0,0
1,201392386,2170660915,57029,36895,2024-10-04 19:37:47,0,0,0,0,0,0
1,201392386,1145490691,48280,47873,2024-10-04 19:37:47,0,0,0,0,0,0
1,201392386,2170660915,63150,36895,2024-10-04 19:37:47,0,0,0,0,0,0
1,201392386,2170660915,0,0,2024-10-04 19:37:47,0,0,0,0,0,0
1,201392386,2170660915,37534,36895,2024-10-04 19:37:47,0,0,0,0,0,0
1,201392386,2170660915,11980,36895,2024-10-04 19:37:47,0,0,0,0,0,0
1,201392386,2170660915,57029,36895,2024-10-04 19:37:48,0,0,0,0,0,0
1,201392386,1145490691,48280,47873,2024-10-04 19:37:48,0,0,0,0,0,0
1,201392386,2170660915,63150,36895,2024-10-04 19:37:48,0,0,0,0,0,0
1,201392386,2170660915,0,0,2024-10-04 19:37:48,128,84,212,1,1,2
1,201392386,2170660915,37534,36895,2024-10-04 19:37:48,0,0,0,0,0,0
1,201392386,2170660915,11980,36895,2024-10-04 19:37:48,0,0,0,0,0,0
1,201392386,2170660915,57029,36895,2024-10-04 19:37:49,0,0,0,0,0,0
1,201392386,1145490691,48280,47873,2024-10-04 19:37:49,0,0,0,0,0,0
1,201392386,2170660915,63150,36895,2024-10-04 19:37:49,0,0,0,0,0,0
1,201392386,2170660915,0,0,2024-10-04 19:37:49,128,84,212,1,1,2
1,201392386,2170660915,37534,36895,2024-10-04 19:37:49,0,0,0,0,0,0
1,201392386,2170660915,11980,36895,2024-10-04 19:37:49,0,0,0,0,0,0
1,201392386,2170660915,57029,36895,2024-10-04 19:37:50,0,0,0,0,0,0
1,201392386,1145490691,48280,47873,2024-10-04 19:37:50,0,0,0,0,0,0
1,201392386,2170660915,63150,36895,2024-10-04 19:37:50,0,0,0,0,0,0
1,201392386,2170660915,0,0,2024-10-04 19:37:50,128,0,128,1,0,1
1,201392386,2170660915,37534,36895,2024-10-04 19:37:50,0,0,0,0,0,0
1,201392386,2170660915,11980,36895,2024-10-04 19:37:50,0,0,0,0,0,0
1,201392386,2170660915,57029,36895,2024-10-04 19:37:51,0,0,0,0,0,0
1,201392386,1145490691,48280,47873,2024-10-04 19:37:51,0,0,0,0,0,0
1,201392386,2170660915,63150,36895,2024-10-04 19:37:51,0,0,0,0,0,0
1,201392386,2170660915,0,0,2024-10-04 19:37:51,128,84,212,1,1,2
1,201392386,2170660915,37534,36895,2024-10-04 19:37:51,0,0,0,0,0,0
1,201392386,2170660915,11980,36895,2024-10-04 19:37:51,0,0,0,0,0,0
1,201392386,2170660915,57029,36895,2024-10-04 19:37:52,0,0,0,0,0,0
1,201392386,1145490691,48280,47873,2024-10-04 19:37:52,0,0,0,0,0,0
1,201392386,2170660915,63150,36895,2024-10-04 19:37:52,0,0,0,0,0,0
1,201392386,2170660915,0,0,2024-10-04 19:37:52,128,84,212,1,1,2
1,201392386,2170660915,37534,36895,2024-10-04 19:37:52,0,0,0,0,0,0
1,201392386,2170660915,11980,36895,2024-10-04 19:37:52,0,0,0,0,0,0
1,201392386,2170660915,57029,36895,2024-10-04 19:37:53,0,0,0,0,0,0
1,201392386,1145490691,48280,47873,2024-10-04 19:37:53,0,0,0,0,0,0
1,201392386,2170660915,63150,36895,2024-10-04 19:37:53,0,0,0,0,0,0
1,201392386,2170660915,0,0,2024-10-04 19:37:53,128,84,212,1,1,2
1,201392386,2170660915,37534,36895,2024-10-04 19:37:53,0,0,0,0,0,0
1,201392386,2170660915,11980,36895,2024-10-04 19:37:53,0,0,0,0,0,0
1,201392386,2170660915,57029,36895,2024-10-04 19:37:54,0,0,0,0,0,0
1,201392386,1145490691,48280,47873,2024-10-04 19:37:54,0,0,0,0,0,0
1,201392386,2170660915,63150,36895,2024-10-04 19:37:54,0,0,0,0,0,0
1,201392386,2170660915,0,0,2024-10-04 19:37:54,128,84,212,1,1,2
1,201392386,2170660915,37534,36895,2024-10-04 19:37:54,0,0,0,0,0,0
1,201392386,2170660915,11980,36895,2024-10-04 19:37:54,0,0,0,0,0,0
1,201392386,2170660915,57029,36895,2024-10-04 19:37:55,0,0,0,0,0,0
1,201392386,1145490691,48280,47873,2024-10-04 19:37:55,0,0,0,0,0,0
1,201392386,2170660915,63150,36895,2024-10-04 19:37:55,0,0,0,0,0,0
1,201392386,2170660915,0,0,2024-10-04 19:37:55,128,84,212,1,1,2
1,201392386,2170660915,37534,36895,2024-10-04 19:37:55,0,0,0,0,0,0
1,201392386,2170660915,11980,36895,2024-10-04 19:37:55,0,0,0,0,0,0
1,201392386,2170660915,57029,36895,2024-10-04 19:37:56,0,0,0,0,0,0
1,201392386,1145490691,48280,47873,2024-10-04 19:37:56,0,0,0,0,0,0
1,201392386,2170660915,63150,36895,2024-10-04 19:37:56,0,0,0,0,0,0
1,201392386,2170660915,0,0,2024-10-04 19:37:56,128,84,212,1,1,2
1,201392386,2170660915,37534,36895,2024-10-04 19:37:56,0,0,0,0,0,0
1,201392386,2170660915,11980,36895,2024-10-04 19:37:56,0,0,0,0,0,0
1,201392386,2170660915,57029,36895,2024-10-04 19:37:57,0,0,0,0,0,0
1,201392386,1145490691,48280,47873,2024-10-04 19:37:57,0,0,0,0,0,0
1,201392386,2170660915,63150,36895,2024-10-04 19:37:57,0,0,0,0,0,0
1,201392386,2170660915,0,0,2024-10-04 19:37:57,128,84,212,1,1,2
1,201392386,2170660915,37534,36895,2024-10-04 19:37:57,0,0,0,0,0,0
1,201392386,2170660915,11980,36895,2024-10-04 19:37:57,0,0,0,0,0,0
1,201392386,2170660915,57029,36895,2024-10-04 19:37:58,0,0,0,0,0,0
1,201392386,2170660915,63150,36895,2024-10-04 19:37:58,0,0,0,0,0,0
1,201392386,2170660915,0,0,2024-10-04 19:37:58,0,84,84,0,1,1
1,201392386,2170660915,37534,36895,2024-10-04 19:37:58,0,0,0,0,0,0
1,201392386,2170660915,11980,36895,2024-10-04 19:37:58,0,0,0,0,0,0
1,201392386,2170660915,57029,36895,2024-10-04 19:37:59,0,0,0,0,0,0
1,201392386,2170660915,63150,36895,2024-10-04 19:37:59,0,0,0,0,0,0
1,201392386,2170660915,0,0,2024-10-04 19:37:59,0,0,0,0,0,0
1,201392386,2170660915,37534,36895,2024-10-04 19:37:59,0,0,0,0,0,0
1,201392386,2170660915,11980,36895,2024-10-04 19:37:59,0,0,0,0,0,0
1,201392386,2170660915,57029,36895,2024-10-04 19:38:00,0,0,0,0,0,0
1,201392386,2170660915,63150,36895,2024-10-04 19:38:00,0,0,0,0,0,0
1,201392386,2170660915,20141,36895,2024-10-04 19:38:00,666,507,1173,6,6,12
1,201392386,2170660915,0,0,2024-10-04 19:38:00,128,0,128,1,0,1
1,201392386,2170660915,37534,36895,2024-10-04 19:38:00,0,0,0,0,0,0
1,201392386,2170660915,11980,36895,2024-10-04 19:38:00,0,0,0,0,0,0
1,201392386,2170660915,57029,36895,2024-10-04 19:38:01,0,0,0,0,0,0
1,201392386,2170660915,20141,36895,2024-10-04 19:38:01,0,0,0,0,0,0
1,201392386,2170660915,0,0,2024-10-04 19:38:01,0,84,84,0,1,1
1,201392386,2170660915,37534,36895,2024-10-04 19:38:01,0,0,0,0,0,0
1,201392386,2170660915,11980,36895,2024-10-04 19:38:01,0,0,0,0,0,0
1,201392386,2170660915,57029,36895,2024-10-04 19:38:02,0,0,0,0,0,0
1,201392386,2170660915,0,0,2024-10-04 19:38:02,256,84,340,2,1,3
1,201392386,2170660915,37534,36895,2024-10-04 19:38:02,0,0,0,0,0,0
1,201392386,2170660915,11980,36895,2024-10-04 19:38:02,0,0,0,0,0,0
1,201392386,2170660915,57029,36895,2024-10-04 19:38:03,0,0,0,0,0,0
1,201392386,2170660915,0,0,2024-10-04 19:38:03,0,84,84,0,1,1
1,201392386,2170660915,37534,36895,2024-10-04 19:38:03,0,0,0,0,0,0
1,201392386,2170660915,11980,36895,2024-10-04 19:38:03,0,0,0,0,0,0
1,201392386,2170660915,57029,36895,2024-10-04 19:38:04,0,0,0,0,0,0
1,201392386,2170660915,0,0,2024-10-04 19:38:04,0,0,0,0,0,0
1,201392386,2170660915,37534,36895,2024-10-04 19:38:04,0,0,0,0,0,0
1,201392386,2170660915,11980,36895,2024-10-04 19:38:04,0,0,0,0,0,0
1,201392386,2170660915,57029,36895,2024-10-04 19:38:05,0,0,0,0,0,0
1,201392386,2170660915,0,0,2024-10-04 19:38:05,0,0,0,0,0,0
1,201392386,2170660915,37534,36895,2024-10-04 19:38:05,0,0,0,0,0,0
1,201392386,2170660915,11980,36895,2024-10-04 19:38:05,0,0,0,0,0,0
1,201392386,2170660915,57029,36895,2024-10-04 19:38:06,0,0,0,0,0,0
1,201392386,2170660915,0,0,2024-10-04 19:38:06,128,84,212,1,1,2
1,201392386,2170660915,37534,36895,2024-10-04 19:38:06,0,0,0,0,0,0
1,201392386,2170660915,11980,36895,2024-10-04 19:38:06,0,0,0,0,0,0
1,201392386,2170660915,57029,36895,2024-10-04 19:38:07,0,0,0,0,0,0
1,201392386,2170660915,0,0,2024-10-04 19:38:07,128,84,212,1,1,2
1,201392386,2170660915,37534,36895,2024-10-04 19:38:07,0,0,0,0,0,0
1,201392386,2170660915,11980,36895,2024-10-04 19:38:07,0,0,0,0,0,0
1,201392386,2170660915,57029,36895,2024-10-04 19:38:08,0,0,0,0,0,0
1,201392386,1145490690,34491,47873,2024-10-04 19:38:08,3040,43805,46845,22,38,60
1,201392386,2170660915,0,0,2024-10-04 19:38:08,128,84,212,1,1,2
1,201392386,2170660915,37534,36895,2024-10-04 19:38:08,0,0,0,0,0,0
1,201392386,2170660915,11980,36895,2024-10-04 19:38:08,0,0,0,0,0,0
1,201392386,2170660915,57029,36895,2024-10-04 19:38:09,0,0,0,0,0,0
1,201392386,1145490690,34491,47873,2024-10-04 19:38:09,0,0,0,0,0,0
1,201392386,2170660915,0,0,2024-10-04 19:38:09,0,0,0,0,0,0
1,201392386,2170660915,37534,36895,2024-10-04 19:38:09,0,0,0,0,0,0
1,201392386,2170660915,11980,36895,2024-10-04 19:38:09,0,0,0,0,0,0
1,201392386,2170660915,57029,36895,2024-10-04 19:38:10,0,0,0,0,0,0
1,201392386,1145490690,34491,47873,2024-10-04 19:38:10,3640,55583,59223,36,41,77
1,201392386,2170660915,0,0,2024-10-04 19:38:10,0,0,0,0,0,0
1,201392386,2170660915,37534,36895,2024-10-04 19:38:10,0,0,0,0,0,0
1,201392386,2170660915,11980,36895,2024-10-04 19:38:10,0,0,0,0,0,0
1,201392386,2170660915,57029,36895,2024-10-04 19:38:11,0,0,0,0,0,0
1,201392386,1145490690,34491,47873,2024-10-04 19:38:11,0,0,0,0,0,0
1,201392386,2170660915,0,0,2024-10-04 19:38:11,0,0,0,0,0,0
1,201392386,2170660915,37534,36895,2024-10-04 19:38:11,0,0,0,0,0,0
1,201392386,2170660915,11980,36895,2024-10-04 19:38:11,0,0,0,0,0,0
1,201392386,2170660915,57029,36895,2024-10-04 19:38:12,0,0,0,0,0,0
1,201392386,1145490690,34491,47873,2024-10-04 19:38:12,0,0,0,0,0,0
1,201392386,2170660915,0,0,2024-10-04 19:38:12,0,0,0,0,0,0
1,201392386,2170660915,37534,36895,2024-10-04 19:38:12,0,0,0,0,0,0
1,201392386,2170660915,11980,36895,2024-10-04 19:38:12,0,0,0,0,0,0
1,201392386,2170660915,57029,36895,2024-10-04 19:38:13,0,0,0,0,0,0
1,201392386,1145490690,34491,47873,2024-10-04 19:38:13,0,0,0,0,0,0
1,201392386,2170660915,0,0,2024-10-04 19:38:13,0,0,0,0,0,0
1,201392386,2170660915,37534,36895,2024-10-04 19:38:13,0,0,0,0,0,0
1,201392386,2170660915,11980,36895,2024-10-04 19:38:13,0,0,0,0,0,0
1,201392386,2170660915,57029,36895,2024-10-04 19:38:14,0,0,0,0,0,0
1,201392386,1145490690,34491,47873,2024-10-04 19:38:14,0,0,0,0,0,0
1,201392386,2170660915,0,0,2024-10-04 19:38:14,0,0,0,0,0,0
1,201392386,2170660915,37534,36895,2024-10-04 19:38:14,0,0,0,0,0,0
1,201392386,2170660915,11980,36895,2024-10-04 19:38:14,0,0,0,0,0,0
1,201392386,2170660915,57029,36895,2024-10-04 19:38:15,0,0,0,0,0,0
1,201392386,1145490690,34491,47873,2024-10-04 19:38:15,0,0,0,0,0,0
1,201392386,2170660915,0,0,2024-10-04 19:38:15,0,0,0,0,0,0
1,201392386,2170660915,37534,36895,2024-10-04 19:38:15,0,0,0,0,0,0
1,201392386,2170660915,11980,36895,2024-10-04 19:38:15,0,0,0,0,0,0
1,201392386,2170660915,57029,36895,2024-10-04 19:38:16,0,0,0,0,0,0
1,201392386,1145490690,34491,47873,2024-10-04 19:38:16,0,0,0,0,0,0
1,201392386,2170660915,0,0,2024-10-04 19:38:16,0,0,0,0,0,0
1,201392386,2170660915,37534,36895,2024-10-04 19:38:16,0,0,0,0,0,0
1,201392386,2170660915,11980,36895,2024-10-04 19:38:16,0,0,0,0,0,0
1,201392386,2170660915,57029,36895,2024-10-04 19:38:17,0,0,0,0,0,0
1,201392386,1145490690,34491,47873,2024-10-04 19:38:17,0,0,0,0,0,0
1,201392386,2170660915,0,0,2024-10-04 19:38:17,0,0,0,0,0,0
1,201392386,2170660915,37534,36895,2024-10-04 19:38:17,0,0,0,0,0,0
1,201392386,2170660915,11980,36895,2024-10-04 19:38:17,0,0,0,0,0,0
1,201392386,2170660915,57029,36895,2024-10-04 19:38:18,0,0,0,0,0,0
1,201392386,1145490690,34491,47873,2024-10-04 19:38:18,0,0,0,0,0,0
1,201392386,2170660915,0,0,2024-10-04 19:38:18,0,0,0,0,0,0
1,201392386,2170660915,37534,36895,2024-10-04 19:38:18,0,0,0,0,0,0
1,201392386,2170660915,11980,36895,2024-10-04 19:38:18,0,0,0,0,0,0
1,201392386,2170660915,57029,36895,2024-10-04 19:38:19,0,0,0,0,0,0
1,201392386,1145490690,34491,47873,2024-10-04 19:38:19,0,0,0,0,0,0
1,201392386,2170660915,0,0,2024-10-04 19:38:19,128,0,128,1,0,1
1,201392386,2170660915,37534,36895,2024-10-04 19:38:19,0,0,0,0,0,0
1,201392386,2170660915,11980,36895,2024-10-04 19:38:19,0,0,0,0,0,0
1,201392386,2170660915,57029,36895,2024-10-04 19:38:20,0,0,0,0,0,0
1,201392386,1145490690,34491,47873,2024-10-04 19:38:20,0,0,0,0,0,0
1,201392386,2170660915,0,0,2024-10-04 19:38:20,128,84,212,1,1,2
1,201392386,2170660915,37534,36895,2024-10-04 19:38:20,0,0,0,0,0,0
1,201392386,2170660915,11980,36895,2024-10-04 19:38:20,0,0,0,0,0,0
1,201392386,2170660915,57029,36895,2024-10-04 19:38:21,0,0,0,0,0,0
1,201392386,1145490690,34491,47873,2024-10-04 19:38:21,0,0,0,0,0,0
1,201392386,2170660915,0,0,2024-10-04 19:38:21,128,84,212,1,1,2
1,201392386,2170660915,37534,36895,2024-10-04 19:38:21,0,0,0,0,0,0
1,201392386,2170660915,11980,36895,2024-10-04 19:38:21,0,0,0,0,0,0
1,201392386,2170660915,57029,36895,2024-10-04 19:38:22,0,0,0,0,0,0
1,201392386,1145490690,34491,47873,2024-10-04 19:38:22,0,0,0,0,0,0
1,201392386,2170660915,0,0,2024-10-04 19:38:22,128,84,212,1,1,2
1,201392386,2170660915,37534,36895,2024-10-04 19:38:22,0,0,0,0,0,0
1,201392386,2170660915,11980,36895,2024-10-04 19:38:22,0,0,0,0,0,0
1,201392386,2170660915,57029,36895,2024-10-04 19:38:23,0,0,0,0,0,0
1,201392386,1145490690,34491,47873,2024-10-04 19:38:23,0,0,0,0,0,0
1,201392386,2170660915,0,0,2024-10-04 19:38:23,128,84,212,1,1,2
1,201392386,2170660915,37534,36895,2024-10-04 19:38:23,0,0,0,0,0,0
1,201392386,2170660915,11980,36895,2024-10-04 19:38:23,0,0,0,0,0,0
1,201392386,2170660915,57029,36895,2024-10-04 19:38:24,0,0,0,0,0,0
1,201392386,1145490690,34491,47873,2024-10-04 19:38:24,0,0,0,0,0,0
1,201392386,2170660915,0,0,2024-10-04 19:38:24,128,168,296,1,2,3
1,201392386,2170660915,37534,36895,2024-10-04 19:38:24,0,0,0,0,0,0
1,201392386,2170660915,11980,36895,2024-10-04 19:38:24,0,0,0,0,0,0
1,201392386,2170660915,57029,36895,2024-10-04 19:38:25,0,0,0,0,0,0
1,201392386,1145490690,34491,47873,2024-10-04 19:38:25,0,0,0,0,0,0
1,201392386,2170660915,0,0,2024-10-04 19:38:25,128,84,212,1,1,2
1,201392386,2170660915,37534,36895,2024-10-04 19:38:25,0,0,0,0,0,0
1,201392386,2170660915,11980,36895,2024-10-04 19:38:25,0,0,0,0,0,0
1,201392386,2170660915,57029,36895,2024-10-04 19:38:26,0,0,0,0,0,0
1,201392386,1145490690,34491,47873,2024-10-04 19:38:26,0,0,0,0,0,0
1,201392386,2170660915,0,0,2024-10-04 19:38:26,128,84,212,1,1,2
1,201392386,2170660915,37534,36895,2024-10-04 19:38:26,0,0,0,0,0,0
1,201392386,2170660915,11980,36895,2024-10-04 19:38:26,0,0,0,0,0,0
1,201392386,2170660915,57029,36895,2024-10-04 19:38:27,0,0,0,0,0,0
1,201392386,1145490690,34491,47873,2024-10-04 19:38:27,0,0,0,0,0,0
1,201392386,2170660915,0,0,2024-10-04 19:38:27,128,84,212,1,1,2
1,201392386,2170660915,37534,36895,2024-10-04 19:38:27,0,0,0,0,0,0
1,201392386,2170660915,11980,36895,2024-10-04 19:38:27,0,0,0,0,0,0
1,201392386,2170660915,57029,36895,2024-10-04 19:38:28,0,0,0,0,0,0
1,201392386,1145490690,34491,47873,2024-10-04 19:38:28,0,0,0,0,0,0
1,201392386,2170660915,0,0,2024-10-04 19:38:28,128,84,212,1,1,2
1,201392386,2170660915,37534,36895,2024-10-04 19:38:28,0,0,0,0,0,0
1,201392386,2170660915,11980,36895,2024-10-04 19:38:28,0,0,0,0,0,0
1,201392386,2170660915,57029,36895,2024-10-04 19:38:29,0,0,0,0,0,0
1,201392386,2170660915,0,0,2024-10-04 19:38:29,0,0,0,0,0,0
1,201392386,2170660915,37534,36895,2024-10-04 19:38:29,0,0,0,0,0,0
1,201392386,2170660915,11980,36895,2024-10-04 19:38:29,0,0,0,0,0,0
1,201392386,2170660915,57029,36895,2024-10-04 19:38:30,0,0,0,0,0,0
1,201392386,2170660915,4806,36895,2024-10-04 19:38:30,570,455,1025,5,5,10
1,201392386,2170660915,0,0,2024-10-04 19:38:30,0,0,0,0,0,0
1,201392386,2170660915,37534,36895,2024-10-04 19:38:30,0,0,0,0,0,0
1,201392386,2170660915,11980,36895,2024-10-04 19:38:30,0,0,0,0,0,0
1,201392386,2170660915,57029,36895,2024-10-04 19:38:31,0,0,0,0,0,0
1,201392386,2170660915,4806,36895,2024-10-04 19:38:31,0,0,0,0,0,0
1,201392386,2170660915,0,0,2024-10-04 19:38:31,128,84,212,1,1,2
1,201392386,2170660915,37534,36895,2024-10-04 19:38:31,0,0,0,0,0,0
1,201392386,2170660915,11980,36895,2024-10-04 19:38:31,0,0,0,0,0,0
1,201392386,2170660915,57029,36895,2024-10-04 19:38:32,0,0,0,0,0,0
1,201392386,2170660915,4806,36895,2024-10-04 19:38:32,0,0,0,0,0,0
1,201392386,2170660915,0,0,2024-10-04 19:38:32,256,84,340,2,1,3
1,201392386,2170660915,37534,36895,2024-10-04 19:38:32,0,0,0,0,0,0
1,201392386,2170660915,11980,36895,2024-10-04 19:38:32,0,0,0,0,0,0
1,201392386,2170660915,57029,36895,2024-10-04 19:38:33,0,0,0,0,0,0
1,201392386,2170660915,4806,36895,2024-10-04 19:38:33,0,0,0,0,0,0
1,201392386,2170660915,0,0,2024-10-04 19:38:33,0,0,0,0,0,0
1,201392386,2170660915,37534,36895,2024-10-04 19:38:33,0,0,0,0,0,0
1,201392386,2170660915,11980,36895,2024-10-04 19:38:33,0,0,0,0,0,0
1,201392386,2170660915,57029,36895,2024-10-04 19:38:34,0,0,0,0,0,0
1,201392386,2170660915,4806,36895,2024-10-04 19:38:34,0,0,0,0,0,0
1,201392386,2170660915,0,0,2024-10-04 19:38:34,0,84,84,0,1,1
1,201392386,2170660915,37534,36895,2024-10-04 19:38:34,0,0,0,0,0,0
1,201392386,2170660915,11980,36895,2024-10-04 19:38:34,0,0,0,0,0,0
1,201392386,2170660915,57029,36895,2024-10-04 19:38:35,0,0,0,0,0,0
1,201392386,2170660915,4806,36895,2024-10-04 19:38:35,0,0,0,0,0,0
1,201392386,2170660915,0,0,2024-10-04 19:38:35,0,0,0,0,0,0
1,201392386,2170660915,37534,36895,2024-10-04 19:38:35,0,0,0,0,0,0
1,201392386,2170660915,11980,36895,2024-10-04 19:38:35,0,0,0,0,0,0
1,201392386,2170660915,57029,36895,2024-10-04 19:38:36,0,0,0,0,0,0
1,201392386,2170660915,4806,36895,2024-10-04 19:38:36,0,0,0,0,0,0
1,201392386,2170660915,0,0,2024-10-04 19:38:36,0,0,0,0,0,0
1,201392386,2170660915,37534,36895,2024-10-04 19:38:36,0,0,0,0,0,0
1,201392386,2170660915,11980,36895,2024-10-04 19:38:36,0,0,0,0,0,0
1,201392386,2170660915,57029,36895,2024-10-04 19:38:37,0,0,0,0,0,0
1,201392386,2170660915,4806,36895,2024-10-04 19:38:37,0,0,0,0,0,0
1,201392386,2170660915,0,0,2024-10-04 19:38:37,128,84,212,1,1,2
1,201392386,2170660915,37534,36895,2024-10-04 19:38:37,0,0,0,0,0,0
1,201392386,2170660915,11980,36895,2024-10-04 19:38:37,0,0,0,0,0,0
1,201392386,2170660915,57029,36895,2024-10-04 19:38:38,0,0,0,0,0,0
1,201392386,2170660915,4806,36895,2024-10-04 19:38:38,0,0,0,0,0,0
1,201392386,2170660915,0,0,2024-10-04 19:38:38,256,84,340,2,1,3
1,201392386,2170660915,37534,36895,2024-10-04 19:38:38,0,0,0,0,0,0
1,201392386,2170660915,11980,36895,2024-10-04 19:38:38,0,0,0,0,0,0
1,201392386,2170660915,57029,36895,2024-10-04 19:38:39,0,0,0,0,0,0
1,201392386,2170660915,4806,36895,2024-10-04 19:38:39,0,0,0,0,0,0
1,201392386,2170660915,0,0,2024-10-04 19:38:39,0,0,0,0,0,0
1,201392386,2170660915,37534,36895,2024-10-04 19:38:39,0,0,0,0,0,0
1,201392386,2170660915,11980,36895,2024-10-04 19:38:39,0,0,0,0,0,0
1,201392386,2170660915,57029,36895,2024-10-04 19:38:40,0,0,0,0,0,0
1,201392386,1145490690,21195,47873,2024-10-04 19:38:40,6372,93148,99520,55,74,129
1,201392386,2170660915,4806,36895,2024-10-04 19:38:40,0,0,0,0,0,0
1,201392386,2170660915,0,0,2024-10-04 19:38:40,0,84,84,0,1,1
1,201392386,2170660915,37534,36895,2024-10-04 19:38:40,0,0,0,0,0,0
1,201392386,2170660915,11980,36895,2024-10-04 19:38:40,0,0,0,0,0,0
1,201392386,2170660915,57029,36895,2024-10-04 19:38:41,0,0,0,0,0,0
1,201392386,1145490690,21195,47873,2024-10-04 19:38:41,0,0,0,0,0,0
1,201392386,2170660915,4806,36895,2024-10-04 19:38:41,0,0,0,0,0,0
1,201392386,2170660915,0,0,2024-10-04 19:38:41,0,0,0,0,0,0
1,201392386,2170660915,37534,36895,2024-10-04 19:38:41,0,0,0,0,0,0
1,201392386,2170660915,11980,36895,2024-10-04 19:38:41,0,0,0,0,0,0
1,201392386,2170660915,57029,36895,2024-10-04 19:38:42,0,0,0,0,0,0
1,201392386,1145490690,21195,47873,2024-10-04 19:38:42,0,0,0,0,0,0
1,201392386,2170660915,4806,36895,2024-10-04 19:38:42,0,0,0,0,0,0
1,201392386,2170660915,0,0,2024-10-04 19:38:42,0,0,0,0,0,0
1,201392386,2170660915,37534,36895,2024-10-04 19:38:42,0,0,0,0,0,0
1,201392386,2170660915,11980,36895,2024-10-04 19:38:42,0,0,0,0,0,0
1,201392386,2170660915,57029,36895,2024-10-04 19:38:43,0,0,0,0,0,0
1,201392386,1145490690,21195,47873,2024-10-04 19:38:43,0,0,0,0,0,0
1,201392386,2170660915,4806,36895,2024-10-04 19:38:43,0,0,0,0,0,0
1,201392386,2170660915,0,0,2024-10-04 19:38:43,0,0,0,0,0,0
1,201392386,2170660915,37534,36895,2024-10-04 19:38:43,0,0,0,0,0,0
1,201392386,2170660915,11980,36895,2024-10-04 19:38:43,0,0,0,0,0,0
1,201392386,2170660915,57029,36895,2024-10-04 19:38:44,0,0,0,0,0,0
1,201392386,1145490690,21195,47873,2024-10-04 19:38:44,0,0,0,0,0,0
1,201392386,2170660915,4806,36895,2024-10-04 19:38:44,0,0,0,0,0,0
1,201392386,2170660915,0,0,2024-10-04 19:38:44,0,0,0,0,0,0
1,201392386,2170660915,37534,36895,2024-10-04 19:38:44,0,0,0,0,0,0
1,201392386,2170660915,11980,36895,2024-10-04 19:38:44,0,0,0,0,0,0
1,201392386,2170660915,57029,36895,2024-10-04 19:38:45,0,0,0,0,0,0
1,201392386,1145490690,21195,47873,2024-10-04 19:38:45,0,0,0,0,0,0
1,201392386,2170660915,4806,36895,2024-10-04 19:38:45,0,0,0,0,0,0
1,201392386,2170660915,0,0,2024-10-04 19:38:45,0,0,0,0,0,0
1,201392386,2170660915,37534,36895,2024-10-04 19:38:45,0,0,0,0,0,0
1,201392386,2170660915,11980,36895,2024-10-04 19:38:45,0,0,0,0,0,0
1,201392386,2170660915,57029,36895,2024-10-04 19:38:46,0,0,0,0,0,0
1,201392386,1145490690,21195,47873,2024-10-04 19:38:46,0,0,0,0,0,0
1,201392386,2170660915,4806,36895,2024-10-04 19:38:46,0,0,0,0,0,0
1,201392386,2170660915,0,0,2024-10-04 19:38:46,0,0,0,0,0,0
1,201392386,2170660915,37534,36895,2024-10-04 19:38:46,0,0,0,0,0,0
1,201392386,2170660915,11980,36895,2024-10-04 19:38:46,0,0,0,0,0,0
1,201392386,2170660915,57029,36895,2024-10-04 19:38:47,0,0,0,0,0,0
1,201392386,1145490690,21195,47873,2024-10-04 19:38:47,0,0,0,0,0,0
1,201392386,2170660915,4806,36895,2024-10-04 19:38:47,0,0,0,0,0,0
1,201392386,2170660915,0,0,2024-10-04 19:38:47,0,0,0,0,0,0
1,201392386,2170660915,37534,36895,2024-10-04 19:38:47,0,0,0,0,0,0
1,201392386,2170660915,11980,36895,2024-10-04 19:38:47,0,0,0,0,0,0
1,201392386,2170660915,57029,36895,2024-10-04 19:38:48,0,0,0,0,0,0
1,201392386,1145490690,21195,47873,2024-10-04 19:38:48,0,0,0,0,0,0
1,201392386,2170660915,4806,36895,2024-10-04 19:38:48,0,0,0,0,0,0
1,201392386,2170660915,0,0,2024-10-04 19:38:48,0,0,0,0,0,0
1,201392386,2170660915,37534,36895,2024-10-04 19:38:48,0,0,0,0,0,0
1,201392386,2170660915,11980,36895,2024-10-04 19:38:48,0,0,0,0,0,0
1,201392386,2170660915,57029,36895,2024-10-04 19:38:49,0,0,0,0,0,0
1,201392386,1145490690,21195,47873,2024-10-04 19:38:49,0,0,0,0,0,0
1,201392386,2170660915,4806,36895,2024-10-04 19:38:49,0,0,0,0,0,0
1,201392386,2170660915,0,0,2024-10-04 19:38:49,128,0,128,1,0,1
1,201392386,2170660915,37534,36895,2024-10-04 19:38:49,0,0,0,0,0,0
1,201392386,2170660915,11980,36895,2024-10-04 19:38:49,0,0,0,0,0,0
1,201392386,2170660915,57029,36895,2024-10-04 19:38:50,0,0,0,0,0,0
1,201392386,1145490690,21195,47873,2024-10-04 19:38:50,0,0,0,0,0,0
1,201392386,2170660915,4806,36895,2024-10-04 19:38:50,0,0,0,0,0,0
1,201392386,2170660915,0,0,2024-10-04 19:38:50,128,84,212,1,1,2
1,201392386,2170660915,37534,36895,2024-10-04 19:38:50,0,0,0,0,0,0
1,201392386,2170660915,11980,36895,2024-10-04 19:38:50,0,0,0,0,0,0
1,201392386,2170660915,57029,36895,2024-10-04 19:38:51,0,0,0,0,0,0
1,201392386,1145490690,21195,47873,2024-10-04 19:38:51,0,0,0,0,0,0
1,201392386,2170660915,4806,36895,2024-10-04 19:38:51,0,0,0,0,0,0
1,201392386,2170660915,0,0,2024-10-04 19:38:51,128,84,212,1,1,2
1,201392386,2170660915,37534,36895,2024-10-04 19:38:51,0,0,0,0,0,0
1,201392386,2170660915,11980,36895,2024-10-04 19:38:51,0,0,0,0,0,0
1,201392386,2170660915,57029,36895,2024-10-04 19:38:52,0,0,0,0,0,0
1,201392386,1145490690,21195,47873,2024-10-04 19:38:52,0,0,0,0,0,0
1,201392386,2170660915,4806,36895,2024-10-04 19:38:52,0,0,0,0,0,0
1,201392386,2170660915,0,0,2024-10-04 19:38:52,128,168,296,1,2,3
1,201392386,2170660915,37534,36895,2024-10-04 19:38:52,0,0,0,0,0,0
1,201392386,2170660915,11980,36895,2024-10-04 19:38:52,0,0,0,0,0,0
1,201392386,2170660915,57029,36895,2024-10-04 19:38:53,0,0,0,0,0,0
1,201392386,1145490690,21195,47873,2024-10-04 19:38:53,0,0,0,0,0,0
1,201392386,2170660915,4806,36895,2024-10-04 19:38:53,0,0,0,0,0,0
1,201392386,2170660915,0,0,2024-10-04 19:38:53,128,84,212,1,1,2
1,201392386,2170660915,37534,36895,2024-10-04 19:38:53,0,0,0,0,0,0
1,201392386,2170660915,11980,36895,2024-10-04 19:38:53,0,0,0,0,0,0
1,201392386,2170660915,57029,36895,2024-10-04 19:38:54,0,0,0,0,0,0
1,201392386,1145490690,21195,47873,2024-10-04 19:38:54,0,0,0,0,0,0
1,201392386,2170660915,4806,36895,2024-10-04 19:38:54,0,0,0,0,0,0
1,201392386,2170660915,0,0,2024-10-04 19:38:54,128,84,212,1,1,2
1,201392386,2170660915,37534,36895,2024-10-04 19:38:54,0,0,0,0,0,0
1,201392386,2170660915,11980,36895,2024-10-04 19:38:54,0,0,0,0,0,0
1,201392386,2170660915,57029,36895,2024-10-04 19:38:55,0,0,0,0,0,0
1,201392386,1145490690,21195,47873,2024-10-04 19:38:55,0,0,0,0,0,0
1,201392386,2170660915,4806,36895,2024-10-04 19:38:55,0,0,0,0,0,0
1,201392386,2170660915,0,0,2024-10-04 19:38:55,128,84,212,1,1,2
1,201392386,2170660915,37534,36895,2024-10-04 19:38:55,0,0,0,0,0,0
1,201392386,2170660915,11980,36895,2024-10-04 19:38:55,0,0,0,0,0,0
1,201392386,2170660915,57029,36895,2024-10-04 19:38:56,0,0,0,0,0,0
1,201392386,1145490690,21195,47873,2024-10-04 19:38:56,0,0,0,0,0,0
1,201392386,2170660915,4806,36895,2024-10-04 19:38:56,0,0,0,0,0,0
1,201392386,2170660915,0,0,2024-10-04 19:38:56,0,0,0,0,0,0
1,201392386,2170660915,37534,36895,2024-10-04 19:38:56,0,0,0,0,0,0
1,201392386,2170660915,11980,36895,2024-10-04 19:38:56,0,0,0,0,0,0
1,201392386,2170660915,57029,36895,2024-10-04 19:38:57,0,0,0,0,0,0
1,201392386,1145490690,21195,47873,2024-10-04 19:38:57,0,0,0,0,0,0
1,201392386,2170660915,4806,36895,2024-10-04 19:38:57,0,0,0,0,0,0
1,201392386,2170660915,0,0,2024-10-04 19:38:57,256,84,340,2,1,3
1,201392386,2170660915,37534,36895,2024-10-04 19:38:57,0,0,0,0,0,0
1,201392386,2170660915,11980,36895,2024-10-04 19:38:57,0,0,0,0,0,0
1,201392386,2170660915,57029,36895,2024-10-04 19:38:58,0,0,0,0,0,0
1,201392386,1145490690,21195,47873,2024-10-04 19:38:58,0,0,0,0,0,0
1,201392386,2170660915,4806,36895,2024-10-04 19:38:58,0,0,0,0,0,0
1,201392386,2170660915,0,0,2024-10-04 19:38:58,128,84,212,1,1,2
1,201392386,2170660915,37534,36895,2024-10-04 19:38:58,0,0,0,0,0,0
1,201392386,2170660915,11980,36895,2024-10-04 19:38:58,0,0,0,0,0,0
1,201392386,2170660915,57029,36895,2024-10-04 19:38:59,0,0,0,0,0,0
1,201392386,1145490690,21195,47873,2024-10-04 19:38:59,0,0,0,0,0,0
1,201392386,2170660915,4806,36895,2024-10-04 19:38:59,0,0,0,0,0,0
1,201392386,2170660915,0,0,2024-10-04 19:38:59,0,84,84,0,1,1
1,201392386,2170660915,37534,36895,2024-10-04 19:38:59,0,0,0,0,0,0
1,201392386,2170660915,11980,36895,2024-10-04 19:38:59,0,0,0,0,0,0
1,201392386,2170660915,57029,36895,2024-10-04 19:39:00,0,0,0,0,0,0
1,201392386,2170660915,4806,36895,2024-10-04 19:39:00,0,0,0,0,0,0
1,201392386,2170660915,1679,36895,2024-10-04 19:39:00,570,455,1025,5,5,10
1,201392386,2170660915,0,0,2024-10-04 19:39:00,0,0,0,0,0,0
1,201392386,2170660915,37534,36895,2024-10-04 19:39:00,0,0,0,0,0,0
1,201392386,2170660915,11980,36895,2024-10-04 19:39:00,0,0,0,0,0,0
1,201392386,2170660915,57029,36895,2024-10-04 19:39:01,0,0,0,0,0,0
1,201392386,2170660915,1679,36895,2024-10-04 19:39:01,0,0,0,0,0,0
1,201392386,2170660915,0,0,2024-10-04 19:39:01,128,84,212,1,1,2
1,201392386,2170660915,37534,36895,2024-10-04 19:39:01,0,0,0,0,0,0
1,201392386,2170660915,11980,36895,2024-10-04 19:39:01,0,0,0,0,0,0
1,201392386,2170660915,57029,36895,2024-10-04 19:39:02,0,0,0,0,0,0
1,201392386,2170660915,1679,36895,2024-10-04 19:39:02,0,0,0,0,0,0
1,201392386,2170660915,0,0,2024-10-04 19:39:02,128,84,212,1,1,2
1,201392386,2170660915,37534,36895,2024-10-04 19:39:02,0,0,0,0,0,0
1,201392386,2170660915,11980,36895,2024-10-04 19:39:02,0,0,0,0,0,0
1,201392386,2170660915,57029,36895,2024-10-04 19:39:03,0,0,0,0,0,0
1,201392386,2170660915,0,0,2024-10-04 19:39:03,128,84,212,1,1,2
1,201392386,2170660915,37534,36895,2024-10-04 19:39:03,0,0,0,0,0,0
1,201392386,2170660915,57029,36895,2024-10-04 19:39:04,0,0,0,0,0,0
1,201392386,2170660915,0,0,2024-10-04 19:39:04,0,0,0,0,0,0
1,201392386,2170660915,37534,36895,2024-10-04 19:39:04,0,0,0,0,0,0
1,201392386,2170660915,57029,36895,2024-10-04 19:39:05,0,0,0,0,0,0
1,201392386,2170660915,0,0,2024-10-04 19:39:05,0,0,0,0,0,0
1,201392386,2170660915,37534,36895,2024-10-04 19:39:05,0,0,0,0,0,0
1,201392386,2170660915,57029,36895,2024-10-04 19:39:06,0,0,0,0,0,0
1,201392386,2170660915,0,0,2024-10-04 19:39:06,128,0,128,1,0,1
1,201392386,2170660915,37534,36895,2024-10-04 19:39:06,0,0,0,0,0,0
1,201392386,2170660915,57029,36895,2024-10-04 19:39:07,0,0,0,0,0,0
1,201392386,2170660915,0,0,2024-10-04 19:39:07,128,84,212,1,1,2
1,201392386,2170660915,37534,36895,2024-10-04 19:39:07,0,0,0,0,0,0
1,201392386,2170660915,57029,36895,2024-10-04 19:39:08,0,0,0,0,0,0
1,201392386,2170660915,0,0,2024-10-04 19:39:08,128,84,212,1,1,2
1,201392386,2170660915,37534,36895,2024-10-04 19:39:08,0,0,0,0,0,0
1,201392386,2170660915,57029,36895,2024-10-04 19:39:09,0,0,0,0,0,0
1,201392386,2170660915,0,0,2024-10-04 19:39:09,0,84,84,0,1,1
1,201392386,2170660915,37534,36895,2024-10-04 19:39:09,0,0,0,0,0,0
1,201392386,1145490689,39048,47873,2024-10-04 19:39:09,4356,66525,70881,35,54,89
1,201392386,2170660915,57029,36895,2024-10-04 19:39:10,0,0,0,0,0,0
1,201392386,2170660915,0,0,2024-10-04 19:39:10,0,0,0,0,0,0
1,201392386,2170660915,37534,36895,2024-10-04 19:39:10,0,0,0,0,0,0
1,201392386,1145490689,39048,47873,2024-10-04 19:39:10,0,0,0,0,0,0
1,201392386,2170660915,57029,36895,2024-10-04 19:39:11,0,0,0,0,0,0
1,201392386,2170660915,0,0,2024-10-04 19:39:11,0,0,0,0,0,0
1,201392386,2170660915,37534,36895,2024-10-04 19:39:11,0,0,0,0,0,0
1,201392386,1145490689,39048,47873,2024-10-04 19:39:11,2016,34833,36849,20,25,45
1,201392386,2170660915,57029,36895,2024-10-04 19:39:12,0,0,0,0,0,0
1,201392386,2170660915,0,0,2024-10-04 19:39:12,0,0,0,0,0,0
1,201392386,2170660915,37534,36895,2024-10-04 19:39:12,0,0,0,0,0,0
1,201392386,1145490689,39048,47873,2024-10-04 19:39:12,0,0,0,0,0,0
1,201392386,2170660915,57029,36895,2024-10-04 19:39:13,0,0,0,0,0,0
1,201392386,2170660915,0,0,2024-10-04 19:39:13,0,0,0,0,0,0
1,201392386,2170660915,37534,36895,2024-10-04 19:39:13,0,0,0,0,0,0
1,201392386,1145490689,39048,47873,2024-10-04 19:39:13,0,0,0,0,0,0
1,201392386,2170660915,57029,36895,2024-10-04 19:39:14,0,0,0,0,0,0
1,201392386,2170660915,0,0,2024-10-04 19:39:14,0,0,0,0,0,0
1,201392386,2170660915,37534,36895,2024-10-04 19:39:14,0,0,0,0,0,0
1,201392386,1145490689,39048,47873,2024-10-04 19:39:14,0,0,0,0,0,0
1,201392386,2170660915,57029,36895,2024-10-04 19:39:15,0,0,0,0,0,0
1,201392386,2170660915,0,0,2024-10-04 19:39:15,0,0,0,0,0,0
1,201392386,2170660915,37534,36895,2024-10-04 19:39:15,0,0,0,0,0,0
1,201392386,1145490689,39048,47873,2024-10-04 19:39:15,0,0,0,0,0,0
1,201392386,2170660915,57029,36895,2024-10-04 19:39:16,0,0,0,0,0,0
1,201392386,2170660915,0,0,2024-10-04 19:39:16,0,0,0,0,0,0
1,201392386,2170660915,37534,36895,2024-10-04 19:39:16,0,0,0,0,0,0
1,201392386,1145490689,39048,47873,2024-10-04 19:39:16,0,0,0,0,0,0
1,201392386,2170660915,57029,36895,2024-10-04 19:39:17,0,0,0,0,0,0
1,201392386,2170660915,0,0,2024-10-04 19:39:17,0,0,0,0,0,0
1,201392386,2170660915,37534,36895,2024-10-04 19:39:17,0,0,0,0,0,0
1,201392386,1145490689,39048,47873,2024-10-04 19:39:17,0,0,0,0,0,0
1,201392386,2170660915,57029,36895,2024-10-04 19:39:18,0,0,0,0,0,0
1,201392386,2170660915,0,0,2024-10-04 19:39:18,0,0,0,0,0,0
1,201392386,2170660915,37534,36895,2024-10-04 19:39:18,0,0,0,0,0,0
1,201392386,1145490689,39048,47873,2024-10-04 19:39:18,0,0,0,0,0,0
1,201392386,2170660915,57029,36895,2024-10-04 19:39:19,0,0,0,0,0,0
1,201392386,2170660915,0,0,2024-10-04 19:39:19,0,0,0,0,0,0
1,201392386,2170660915,37534,36895,2024-10-04 19:39:19,0,0,0,0,0,0
1,201392386,1145490689,39048,47873,2024-10-04 19:39:19,0,0,0,0,0,0
1,201392386,2170660915,57029,36895,2024-10-04 19:39:20,0,0,0,0,0,0
1,201392386,2170660915,0,0,2024-10-04 19:39:20,128,84,212,1,1,2
1,201392386,2170660915,37534,36895,2024-10-04 19:39:20,0,0,0,0,0,0
1,201392386,1145490689,39048,47873,2024-10-04 19:39:20,0,0,0,0,0,0
1,201392386,2170660915,57029,36895,2024-10-04 19:39:21,0,0,0,0,0,0
1,201392386,2170660915,0,0,2024-10-04 19:39:21,128,84,212,1,1,2
1,201392386,2170660915,37534,36895,2024-10-04 19:39:21,0,0,0,0,0,0
1,201392386,1145490689,39048,47873,2024-10-04 19:39:21,0,0,0,0,0,0
1,201392386,2170660915,57029,36895,2024-10-04 19:39:22,0,0,0,0,0,0
1,201392386,2170660915,0,0,2024-10-04 19:39:22,128,84,212,1,1,2
1,201392386,2170660915,37534,36895,2024-10-04 19:39:22,0,0,0,0,0,0
1,201392386,1145490689,39048,47873,2024-10-04 19:39:22,0,0,0,0,0,0
1,201392386,2170660915,57029,36895,2024-10-04 19:39:23,0,0,0,0,0,0
1,201392386,2170660915,0,0,2024-10-04 19:39:23,128,84,212,1,1,2
1,201392386,2170660915,37534,36895,2024-10-04 19:39:23,0,0,0,0,0,0
1,201392386,1145490689,39048,47873,2024-10-04 19:39:23,0,0,0,0,0,0
1,201392386,2170660915,57029,36895,2024-10-04 19:39:24,0,0,0,0,0,0
1,201392386,2170660915,0,0,2024-10-04 19:39:24,128,84,212,1,1,2
1,201392386,2170660915,37534,36895,2024-10-04 19:39:24,0,0,0,0,0,0
1,201392386,1145490689,39048,47873,2024-10-04 19:39:24,0,0,0,0,0,0
1,201392386,2170660915,57029,36895,2024-10-04 19:39:25,0,0,0,0,0,0
1,201392386,2170660915,0,0,2024-10-04 19:39:25,128,84,212,1,1,2
1,201392386,2170660915,37534,36895,2024-10-04 19:39:25,0,0,0,0,0,0
1,201392386,1145490689,39048,47873,2024-10-04 19:39:25,0,0,0,0,0,0
1,201392386,2170660915,57029,36895,2024-10-04 19:39:26,0,0,0,0,0,0
1,201392386,2170660915,0,0,2024-10-04 19:39:26,128,84,212,1,1,2
1,201392386,2170660915,37534,36895,2024-10-04 19:39:26,0,0,0,0,0,0
1,201392386,1145490689,39048,47873,2024-10-04 19:39:26,0,0,0,0,0,0
1,201392386,2170660915,57029,36895,2024-10-04 19:39:27,0,0,0,0,0,0
1,201392386,2170660915,0,0,2024-10-04 19:39:27,128,84,212,1,1,2
1,201392386,2170660915,37534,36895,2024-10-04 19:39:27,0,0,0,0,0,0
1,201392386,1145490689,39048,47873,2024-10-04 19:39:27,0,0,0,0,0,0
1,201392386,2170660915,57029,36895,2024-10-04 19:39:28,0,0,0,0,0,0
1,201392386,2170660915,0,0,2024-10-04 19:39:28,128,84,212,1,1,2
1,201392386,2170660915,37534,36895,2024-10-04 19:39:28,0,0,0,0,0,0
1,201392386,1145490689,39048,47873,2024-10-04 19:39:28,0,0,0,0,0,0
1,201392386,2170660915,57029,36895,2024-10-04 19:39:29,0,0,0,0,0,0
1,201392386,2170660915,0,0,2024-10-04 19:39:29,128,84,212,1,1,2
1,201392386,2170660915,37534,36895,2024-10-04 19:39:29,0,0,0,0,0,0
1,201392386,1145490689,39048,47873,2024-10-04 19:39:29,0,0,0,0,0,0
1,201392386,2170660915,57029,36895,2024-10-04 19:39:30,0,0,0,0,0,0
1,201392386,2170660915,0,0,2024-10-04 19:39:30,0,0,0,0,0,0
1,201392386,2170660915,37534,36895,2024-10-04 19:39:30,0,0,0,0,0,0
1,201392386,2170660915,57029,36895,2024-10-04 19:39:31,0,0,0,0,0,0
1,201392386,2170660915,43753,36895,2024-10-04 19:39:31,570,455,1025,5,5,10
1,201392386,2170660915,0,0,2024-10-04 19:39:31,0,0,0,0,0,0
1,201392386,2170660915,37534,36895,2024-10-04 19:39:31,0,0,0,0,0,0
1,201392386,2170660915,57029,36895,2024-10-04 19:39:32,0,0,0,0,0,0
1,201392386,2170660915,43753,36895,2024-10-04 19:39:32,0,0,0,0,0,0
1,201392386,2170660915,0,0,2024-10-04 19:39:32,128,84,212,1,1,2
1,201392386,2170660915,37534,36895,2024-10-04 19:39:32,0,0,0,0,0,0
1,201392386,2170660915,57029,36895,2024-10-04 19:39:33,0,0,0,0,0,0
1,201392386,2170660915,43753,36895,2024-10-04 19:39:33,0,0,0,0,0,0
1,201392386,2170660915,0,0,2024-10-04 19:39:33,128,84,212,1,1,2
1,201392386,2170660915,37534,36895,2024-10-04 19:39:33,0,0,0,0,0,0
1,201392386,2170660915,57029,36895,2024-10-04 19:39:34,0,0,0,0,0,0
1,201392386,2170660915,43753,36895,2024-10-04 19:39:34,0,0,0,0,0,0
1,201392386,2170660915,0,0,2024-10-04 19:39:34,0,0,0,0,0,0
1,201392386,2170660915,37534,36895,2024-10-04 19:39:34,0,0,0,0,0,0
1,201392386,2170660915,57029,36895,2024-10-04 19:39:35,0,0,0,0,0,0
1,201392386,2170660915,0,0,2024-10-04 19:39:35,128,84,212,1,1,2
1,201392386,2170660915,37534,36895,2024-10-04 19:39:35,0,0,0,0,0,0
1,201392386,2170660915,57029,36895,2024-10-04 19:39:36,0,0,0,0,0,0
1,201392386,2170660915,0,0,2024-10-04 19:39:36,0,0,0,0,0,0
1,201392386,2170660915,37534,36895,2024-10-04 19:39:36,0,0,0,0,0,0
1,201392386,2170660915,57029,36895,2024-10-04 19:39:37,0,0,0,0,0,0
1,201392386,2170660915,0,0,2024-10-04 19:39:37,128,0,128,1,0,1
1,201392386,2170660915,37534,36895,2024-10-04 19:39:37,0,0,0,0,0,0
1,201392386,2170660915,57029,36895,2024-10-04 19:39:38,0,0,0,0,0,0
1,201392386,2170660915,0,0,2024-10-04 19:39:38,128,84,212,1,1,2
1,201392386,2170660915,37534,36895,2024-10-04 19:39:38,0,0,0,0,0,0
1,201392386,2170660915,57029,36895,2024-10-04 19:39:39,0,0,0,0,0,0
1,201392386,2170660915,0,0,2024-10-04 19:39:39,0,84,84,0,1,1
1,201392386,2170660915,37534,36895,2024-10-04 19:39:39,0,0,0,0,0,0
1,201392386,2170660915,57029,36895,2024-10-04 19:39:40,0,0,0,0,0,0
1,201392386,2170660915,0,0,2024-10-04 19:39:40,128,84,212,1,1,2
1,201392386,2170660915,37534,36895,2024-10-04 19:39:40,0,0,0,0,0,0
1,201392386,1145490689,39064,47873,2024-10-04 19:39:40,6196,97268,103464,51,77,128
1,201392386,2170660915,57029,36895,2024-10-04 19:39:41,0,0,0,0,0,0
1,201392386,2170660915,0,0,2024-10-04 19:39:41,0,0,0,0,0,0
1,201392386,2170660915,37534,36895,2024-10-04 19:39:41,0,0,0,0,0,0
1,201392386,1145490689,39064,47873,2024-10-04 19:39:41,0,0,0,0,0,0
1,201392386,2170660915,57029,36895,2024-10-04 19:39:42,0,0,0,0,0,0
1,201392386,2170660915,0,0,2024-10-04 19:39:42,0,0,0,0,0,0
1,201392386,2170660915,37534,36895,2024-10-04 19:39:42,0,0,0,0,0,0
1,201392386,1145490689,39064,47873,2024-10-04 19:39:42,0,0,0,0,0,0
1,201392386,2170660915,57029,36895,2024-10-04 19:39:43,0,0,0,0,0,0
1,201392386,2170660915,0,0,2024-10-04 19:39:43,0,0,0,0,0,0
1,201392386,2170660915,37534,36895,2024-10-04 19:39:43,0,0,0,0,0,0
1,201392386,1145490689,39064,47873,2024-10-04 19:39:43,0,0,0,0,0,0
1,201392386,2170660915,57029,36895,2024-10-04 19:39:44,0,0,0,0,0,0
1,201392386,2170660915,0,0,2024-10-04 19:39:44,0,0,0,0,0,0
1,201392386,2170660915,37534,36895,2024-10-04 19:39:44,0,0,0,0,0,0
1,201392386,1145490689,39064,47873,2024-10-04 19:39:44,0,0,0,0,0,0
1,201392386,2170660915,57029,36895,2024-10-04 19:39:45,0,0,0,0,0,0
1,201392386,2170660915,0,0,2024-10-04 19:39:45,0,0,0,0,0,0
1,201392386,2170660915,37534,36895,2024-10-04 19:39:45,0,0,0,0,0,0
1,201392386,1145490689,39064,47873,2024-10-04 19:39:45,0,0,0,0,0,0
1,201392386,2170660915,57029,36895,2024-10-04 19:39:46,0,0,0,0,0,0
1,201392386,2170660915,0,0,2024-10-04 19:39:46,0,0,0,0,0,0
1,201392386,2170660915,37534,36895,2024-10-04 19:39:46,0,0,0,0,0,0
1,201392386,1145490689,39064,47873,2024-10-04 19:39:46,0,0,0,0,0,0
1,201392386,2170660915,57029,36895,2024-10-04 19:39:47,0,0,0,0,0,0
1,201392386,2170660915,0,0,2024-10-04 19:39:47,0,0,0,0,0,0
1,201392386,2170660915,37534,36895,2024-10-04 19:39:47,0,0,0,0,0,0
1,201392386,1145490689,39064,47873,2024-10-04 19:39:47,0,0,0,0,0,0
1,201392386,2170660915,57029,36895,2024-10-04 19:39:48,0,0,0,0,0,0
1,201392386,2170660915,0,0,2024-10-04 19:39:48,0,0,0,0,0,0
1,201392386,2170660915,37534,36895,2024-10-04 19:39:48,0,0,0,0,0,0
1,201392386,1145490689,39064,47873,2024-10-04 19:39:48,0,0,0,0,0,0
1,201392386,2170660915,57029,36895,2024-10-04 19:39:49,0,0,0,0,0,0
1,201392386,2170660915,0,0,2024-10-04 19:39:49,0,0,0,0,0,0
1,201392386,2170660915,37534,36895,2024-10-04 19:39:49,0,0,0,0,0,0
1,201392386,1145490689,39064,47873,2024-10-04 19:39:49,0,0,0,0,0,0
1,201392386,2170660915,57029,36895,2024-10-04 19:39:50,0,0,0,0,0,0
1,201392386,2170660915,0,0,2024-10-04 19:39:50,0,0,0,0,0,0
1,201392386,2170660915,37534,36895,2024-10-04 19:39:50,0,0,0,0,0,0
1,201392386,1145490689,39064,47873,2024-10-04 19:39:50,0,0,0,0,0,0
1,201392386,2170660915,57029,36895,2024-10-04 19:39:51,0,0,0,0,0,0
1,201392386,2170660915,0,0,2024-10-04 19:39:51,128,84,212,1,1,2
1,201392386,2170660915,37534,36895,2024-10-04 19:39:51,0,0,0,0,0,0
1,201392386,1145490689,39064,47873,2024-10-04 19:39:51,0,0,0,0,0,0
1,201392386,2170660915,57029,36895,2024-10-04 19:39:52,0,0,0,0,0,0
1,201392386,2170660915,0,0,2024-10-04 19:39:52,128,84,212,1,1,2
1,201392386,2170660915,37534,36895,2024-10-04 19:39:52,0,0,0,0,0,0
1,201392386,1145490689,39064,47873,2024-10-04 19:39:52,0,0,0,0,0,0
1,201392386,2170660915,57029,36895,2024-10-04 19:39:53,0,0,0,0,0,0
1,201392386,2170660915,0,0,2024-10-04 19:39:53,128,84,212,1,1,2
1,201392386,2170660915,37534,36895,2024-10-04 19:39:53,0,0,0,0,0,0
1,201392386,1145490689,39064,47873,2024-10-04 19:39:53,0,0,0,0,0,0
1,201392386,2170660915,57029,36895,2024-10-04 19:39:54,0,0,0,0,0,0
1,201392386,2170660915,0,0,2024-10-04 19:39:54,256,168,424,2,2,4
1,201392386,2170660915,37534,36895,2024-10-04 19:39:54,0,0,0,0,0,0
1,201392386,1145490689,39064,47873,2024-10-04 19:39:54,0,0,0,0,0,0
1,201392386,2170660915,57029,36895,2024-10-04 19:39:55,0,0,0,0,0,0
1,201392386,2170660915,0,0,2024-10-04 19:39:55,128,84,212,1,1,2
1,201392386,2170660915,37534,36895,2024-10-04 19:39:55,0,0,0,0,0,0
1,201392386,1145490689,39064,47873,2024-10-04 19:39:55,0,0,0,0,0,0
1,201392386,2170660915,57029,36895,2024-10-04 19:39:56,0,0,0,0,0,0
1,201392386,2170660915,0,0,2024-10-04 19:39:56,128,84,212,1,1,2
1,201392386,2170660915,37534,36895,2024-10-04 19:39:56,0,0,0,0,0,0
1,201392386,1145490689,39064,47873,2024-10-04 19:39:56,0,0,0,0,0,0
1,201392386,2170660915,57029,36895,2024-10-04 19:39:57,0,0,0,0,0,0
1,201392386,2170660915,0,0,2024-10-04 19:39:57,128,84,212,1,1,2
1,201392386,2170660915,37534,36895,2024-10-04 19:39:57,0,0,0,0,0,0
1,201392386,1145490689,39064,47873,2024-10-04 19:39:57,0,0,0,0,0,0
1,201392386,2170660915,57029,36895,2024-10-04 19:39:58,0,0,0,0,0,0
1,201392386,2170660915,0,0,2024-10-04 19:39:58,128,84,212,1,1,2
1,201392386,2170660915,37534,36895,2024-10-04 19:39:58,0,0,0,0,0,0
1,201392386,1145490689,39064,47873,2024-10-04 19:39:58,0,0,0,0,0,0
1,201392386,2170660915,57029,36895,2024-10-04 19:39:59,0,0,0,0,0,0
1,201392386,2170660915,0,0,2024-10-04 19:39:59,128,84,212,1,1,2
1,201392386,2170660915,37534,36895,2024-10-04 19:39:59,0,0,0,0,0,0
1,201392386,1145490689,39064,47873,2024-10-04 19:39:59,0,0,0,0,0,0
1,201392386,2170660915,57029,36895,2024-10-04 19:40:00,0,0,0,0,0,0
1,201392386,2170660915,0,0,2024-10-04 19:40:00,0,0,0,0,0,0
1,201392386,2170660915,37534,36895,2024-10-04 19:40:00,0,0,0,0,0,0
1,201392386,1145490689,39064,47873,2024-10-04 19:40:00,0,0,0,0,0,0
1,201392386,2170660915,57029,36895,2024-10-04 19:40:01,0,0,0,0,0,0
1,201392386,2170660915,3274,36895,2024-10-04 19:40:01,570,455,1025,5,5,10
1,201392386,2170660915,0,0,2024-10-04 19:40:01,0,0,0,0,0,0
1,201392386,2170660915,37534,36895,2024-10-04 19:40:01,0,0,0,0,0,0
1,201392386,2170660915,57029,36895,2024-10-04 19:40:02,0,0,0,0,0,0
1,201392386,2170660915,3274,36895,2024-10-04 19:40:02,0,0,0,0,0,0
1,201392386,2170660915,0,0,2024-10-04 19:40:02,128,84,212,1,1,2
1,201392386,2170660915,37534,36895,2024-10-04 19:40:02,0,0,0,0,0,0
1,201392386,2170660915,57029,36895,2024-10-04 19:40:03,0,0,0,0,0,0
1,201392386,2170660915,3274,36895,2024-10-04 19:40:03,0,0,0,0,0,0
1,201392386,2170660915,0,0,2024-10-04 19:40:03,128,84,212,1,1,2
1,201392386,2170660915,37534,36895,2024-10-04 19:40:03,0,0,0,0,0,0
1,201392386,2170660915,57029,36895,2024-10-04 19:40:04,0,0,0,0,0,0
1,201392386,2170660915,3274,36895,2024-10-04 19:40:04,0,0,0,0,0,0
1,201392386,2170660915,0,0,2024-10-04 19:40:04,0,0,0,0,0,0
1,201392386,2170660915,37534,36895,2024-10-04 19:40:04,0,0,0,0,0,0
1,201392386,2170660915,57029,36895,2024-10-04 19:40:05,0,0,0,0,0,0
1,201392386,2170660915,0,0,2024-10-04 19:40:05,128,84,212,1,1,2
1,201392386,2170660915,37534,36895,2024-10-04 19:40:05,0,0,0,0,0,0
1,201392386,2170660915,57029,36895,2024-10-04 19:40:06,0,0,0,0,0,0
1,201392386,2170660915,0,0,2024-10-04 19:40:06,0,0,0,0,0,0
1,201392386,2170660915,37534,36895,2024-10-04 19:40:06,0,0,0,0,0,0
1,201392386,2170660915,57029,36895,2024-10-04 19:40:07,0,0,0,0,0,0
1,201392386,2170660915,0,0,2024-10-04 19:40:07,0,0,0,0,0,0
1,201392386,2170660915,37534,36895,2024-10-04 19:40:07,0,0,0,0,0,0
1,201392386,2170660915,57029,36895,2024-10-04 19:40:08,0,0,0,0,0,0
1,201392386,2170660915,0,0,2024-10-04 19:40:08,128,0,128,1,0,1
1,201392386,2170660915,37534,36895,2024-10-04 19:40:08,0,0,0,0,0,0
1,201392386,2170660915,57029,36895,2024-10-04 19:40:09,0,0,0,0,0,0
1,201392386,2170660915,0,0,2024-10-04 19:40:09,128,168,296,1,2,3
1,201392386,2170660915,37534,36895,2024-10-04 19:40:09,0,0,0,0,0,0
1,201392386,2170660915,57029,36895,2024-10-04 19:40:10,0,0,0,0,0,0
1,201392386,1145490691,36503,47873,2024-10-04 19:40:10,2628,24833,27461,18,22,40
1,201392386,2170660915,0,0,2024-10-04 19:40:10,128,84,212,1,1,2
1,201392386,2170660915,37534,36895,2024-10-04 19:40:10,0,0,0,0,0,0
1,201392386,2170660915,57029,36895,2024-10-04 19:40:11,0,0,0,0,0,0
1,201392386,1145490691,36503,47873,2024-10-04 19:40:11,2448,56224,58672,24,37,61
1,201392386,2170660915,0,0,2024-10-04 19:40:11,0,0,0,0,0,0
1,201392386,2170660915,37534,36895,2024-10-04 19:40:11,0,0,0,0,0,0
1,201392386,2170660915,57029,36895,2024-10-04 19:40:12,0,0,0,0,0,0
1,201392386,1145490691,36503,47873,2024-10-04 19:40:12,1104,15951,17055,11,13,24
1,201392386,2170660915,0,0,2024-10-04 19:40:12,0,0,0,0,0,0
1,201392386,2170660915,37534,36895,2024-10-04 19:40:12,0,0,0,0,0,0
1,201392386,2170660915,57029,36895,2024-10-04 19:40:13,0,0,0,0,0,0
1,201392386,1145490691,36503,47873,2024-10-04 19:40:13,0,0,0,0,0,0
1,201392386,2170660915,0,0,2024-10-04 19:40:13,0,0,0,0,0,0
1,201392386,2170660915,37534,36895,2024-10-04 19:40:13,0,0,0,0,0,0
1,201392386,2170660915,57029,36895,2024-10-04 19:40:14,0,0,0,0,0,0
1,201392386,1145490691,36503,47873,2024-10-04 19:40:14,0,0,0,0,0,0
1,201392386,2170660915,0,0,2024-10-04 19:40:14,0,0,0,0,0,0
1,201392386,2170660915,37534,36895,2024-10-04 19:40:14,0,0,0,0,0,0
1,201392386,2170660915,57029,36895,2024-10-04 19:40:15,0,0,0,0,0,0
1,201392386,2170660915,0,0,2024-10-04 19:40:15,0,0,0,0,0,0
1,201392386,2170660915,37534,36895,2024-10-04 19:40:15,0,0,0,0,0,0
1,201392386,2170660915,57029,36895,2024-10-04 19:40:16,0,0,0,0,0,0
1,201392386,2170660915,0,0,2024-10-04 19:40:16,0,0,0,0,0,0
1,201392386,2170660915,37534,36895,2024-10-04 19:40:16,0,0,0,0,0,0
1,201392386,2170660915,57029,36895,2024-10-04 19:40:17,0,0,0,0,0,0
1,201392386,2170660915,0,0,2024-10-04 19:40:17,0,0,0,0,0,0
1,201392386,2170660915,37534,36895,2024-10-04 19:40:17,0,0,0,0,0,0
1,201392386,2170660915,57029,36895,2024-10-04 19:40:18,0,0,0,0,0,0
1,201392386,2170660915,0,0,2024-10-04 19:40:18,0,0,0,0,0,0
1,201392386,2170660915,37534,36895,2024-10-04 19:40:18,0,0,0,0,0,0
1,201392386,2170660915,57029,36895,2024-10-04 19:40:19,0,0,0,0,0,0
1,201392386,2170660915,0,0,2024-10-04 19:40:19,0,0,0,0,0,0
1,201392386,2170660915,37534,36895,2024-10-04 19:40:19,0,0,0,0,0,0
1,201392386,2170660915,57029,36895,2024-10-04 19:40:20,0,0,0,0,0,0
1,201392386,2170660915,0,0,2024-10-04 19:40:20,0,0,0,0,0,0
1,201392386,2170660915,37534,36895,2024-10-04 19:40:20,0,0,0,0,0,0
1,201392386,2170660915,57029,36895,2024-10-04 19:40:21,0,0,0,0,0,0
1,201392386,2170660915,0,0,2024-10-04 19:40:21,128,0,128,1,0,1
1,201392386,2170660915,37534,36895,2024-10-04 19:40:21,0,0,0,0,0,0
1,201392386,2170660915,57029,36895,2024-10-04 19:40:22,0,0,0,0,0,0
1,201392386,2170660915,0,0,2024-10-04 19:40:22,128,84,212,1,1,2
1,201392386,2170660915,37534,36895,2024-10-04 19:40:22,0,0,0,0,0,0
1,201392386,2170660915,57029,36895,2024-10-04 19:40:23,0,0,0,0,0,0
1,201392386,2170660915,0,0,2024-10-04 19:40:23,128,84,212,1,1,2
1,201392386,2170660915,37534,36895,2024-10-04 19:40:23,0,0,0,0,0,0
1,201392386,2170660915,57029,36895,2024-10-04 19:40:24,0,0,0,0,0,0
1,201392386,2170660915,0,0,2024-10-04 19:40:24,128,84,212,1,1,2
1,201392386,2170660915,37534,36895,2024-10-04 19:40:24,0,0,0,0,0,0
1,201392386,2170660915,57029,36895,2024-10-04 19:40:25,0,0,0,0,0,0
1,201392386,2170660915,0,0,2024-10-04 19:40:25,128,84,212,1,1,2
1,201392386,2170660915,37534,36895,2024-10-04 19:40:25,0,0,0,0,0,0
1,201392386,2170660915,57029,36895,2024-10-04 19:40:26,0,0,0,0,0,0
1,201392386,2170660915,0,0,2024-10-04 19:40:26,128,84,212,1,1,2
1,201392386,2170660915,37534,36895,2024-10-04 19:40:26,0,0,0,0,0,0
1,201392386,2170660915,57029,36895,2024-10-04 19:40:27,0,0,0,0,0,0
1,201392386,2170660915,0,0,2024-10-04 19:40:27,128,84,212,1,1,2
1,201392386,2170660915,37534,36895,2024-10-04 19:40:27,0,0,0,0,0,0
1,201392386,2170660915,57029,36895,2024-10-04 19:40:28,0,0,0,0,0,0
1,201392386,2170660915,0,0,2024-10-04 19:40:28,128,84,212,1,1,2
1,201392386,2170660915,37534,36895,2024-10-04 19:40:28,0,0,0,0,0,0
1,201392386,2170660915,57029,36895,2024-10-04 19:40:29,0,0,0,0,0,0
1,201392386,2170660915,0,0,2024-10-04 19:40:29,128,84,212,1,1,2
1,201392386,2170660915,37534,36895,2024-10-04 19:40:29,0,0,0,0,0,0
1,201392386,2170660915,57029,36895,2024-10-04 19:40:30,0,0,0,0,0,0
1,201392386,2170660915,0,0,2024-10-04 19:40:30,0,84,84,0,1,1
1,201392386,2170660915,37534,36895,2024-10-04 19:40:30,0,0,0,0,0,0
1,201392386,2170660915,57029,36895,2024-10-04 19:40:31,0,0,0,0,0,0
1,201392386,2170660915,0,0,2024-10-04 19:40:31,128,84,212,1,1,2
1,201392386,2170660915,37534,36895,2024-10-04 19:40:31,0,0,0,0,0,0
1,201392386,2170660915,57029,36895,2024-10-04 19:40:32,0,0,0,0,0,0
1,201392386,2170660915,0,0,2024-10-04 19:40:32,0,0,0,0,0,0
1,201392386,2170660915,37534,36895,2024-10-04 19:40:32,0,0,0,0,0,0
1,201392386,2170660915,57029,36895,2024-10-04 19:40:33,0,0,0,0,0,0
1,201392386,2170660915,41106,36895,2024-10-04 19:40:33,666,507,1173,6,6,12
1,201392386,2170660915,0,0,2024-10-04 19:40:33,128,0,128,1,0,1
1,201392386,2170660915,37534,36895,2024-10-04 19:40:33,0,0,0,0,0,0
1,201392386,2170660915,57029,36895,2024-10-04 19:40:34,0,0,0,0,0,0
1,201392386,2170660915,41106,36895,2024-10-04 19:40:34,0,0,0,0,0,0
1,201392386,2170660915,0,0,2024-10-04 19:40:34,128,84,212,1,1,2
1,201392386,2170660915,37534,36895,2024-10-04 19:40:34,0,0,0,0,0,0
1,201392386,2170660915,57029,36895,2024-10-04 19:40:35,0,0,0,0,0,0
1,201392386,2170660915,41106,36895,2024-10-04 19:40:35,0,0,0,0,0,0
1,201392386,2170660915,0,0,2024-10-04 19:40:35,128,84,212,1,1,2
1,201392386,2170660915,37534,36895,2024-10-04 19:40:35,0,0,0,0,0,0
1,201392386,2170660915,57029,36895,2024-10-04 19:40:36,0,0,0,0,0,0
1,201392386,2170660915,41106,36895,2024-10-04 19:40:36,0,0,0,0,0,0
1,201392386,2170660915,0,0,2024-10-04 19:40:36,0,0,0,0,0,0
1,201392386,2170660915,37534,36895,2024-10-04 19:40:36,0,0,0,0,0,0
1,201392386,2170660915,57029,36895,2024-10-04 19:40:37,0,0,0,0,0,0
1,201392386,2170660915,0,0,2024-10-04 19:40:37,0,84,84,0,1,1
1,201392386,2170660915,37534,36895,2024-10-04 19:40:37,0,0,0,0,0,0
1,201392386,2170660915,57029,36895,2024-10-04 19:40:38,0,0,0,0,0,0
1,201392386,2170660915,0,0,2024-10-04 19:40:38,0,0,0,0,0,0
1,201392386,2170660915,37534,36895,2024-10-04 19:40:38,0,0,0,0,0,0
1,201392386,2170660915,57029,36895,2024-10-04 19:40:39,0,0,0,0,0,0
1,201392386,2170660915,0,0,2024-10-04 19:40:39,128,84,212,1,1,2
1,201392386,2170660915,37534,36895,2024-10-04 19:40:39,0,0,0,0,0,0
1,201392386,2170660915,57029,36895,2024-10-04 19:40:40,0,0,0,0,0,0
1,201392386,2170660915,0,0,2024-10-04 19:40:40,128,84,212,1,1,2
1,201392386,2170660915,37534,36895,2024-10-04 19:40:40,0,0,0,0,0,0
1,201392386,2170660915,57029,36895,2024-10-04 19:40:41,0,0,0,0,0,0
1,201392386,1145490691,29338,47873,2024-10-04 19:40:41,3156,32755,35911,23,31,54
1,201392386,2170660915,0,0,2024-10-04 19:40:41,128,84,212,1,1,2
1,201392386,2170660915,37534,36895,2024-10-04 19:40:41,0,0,0,0,0,0
1,201392386,2170660915,57029,36895,2024-10-04 19:40:42,0,0,0,0,0,0
1,201392386,1145490691,29338,47873,2024-10-04 19:40:42,1236,34924,36160,12,22,34
1,201392386,2170660915,0,0,2024-10-04 19:40:42,0,0,0,0,0,0
1,201392386,2170660915,37534,36895,2024-10-04 19:40:42,0,0,0,0,0,0
1,201392386,2170660915,57029,36895,2024-10-04 19:40:43,0,0,0,0,0,0
1,201392386,1145490691,29338,47873,2024-10-04 19:40:43,0,0,0,0,0,0
1,201392386,2170660915,0,0,2024-10-04 19:40:43,0,0,0,0,0,0
1,201392386,2170660915,37534,36895,2024-10-04 19:40:43,0,0,0,0,0,0
1,201392386,2170660915,57029,36895,2024-10-04 19:40:44,0,0,0,0,0,0
1,201392386,1145490691,29338,47873,2024-10-04 19:40:44,2496,35691,38187,25,27,52
1,201392386,2170660915,0,0,2024-10-04 19:40:44,0,0,0,0,0,0
1,201392386,2170660915,37534,36895,2024-10-04 19:40:44,0,0,0,0,0,0
1,201392386,2170660915,57029,36895,2024-10-04 19:40:45,0,0,0,0,0,0
1,201392386,1145490691,29338,47873,2024-10-04 19:40:45,0,0,0,0,0,0
1,201392386,2170660915,0,0,2024-10-04 19:40:45,0,0,0,0,0,0
1,201392386,2170660915,37534,36895,2024-10-04 19:40:45,0,0,0,0,0,0
1,201392386,2170660915,57029,36895,2024-10-04 19:40:46,0,0,0,0,0,0
1,201392386,1145490691,29338,47873,2024-10-04 19:40:46,0,0,0,0,0,0
1,201392386,2170660915,0,0,2024-10-04 19:40:46,0,0,0,0,0,0
1,201392386,2170660915,37534,36895,2024-10-04 19:40:46,0,0,0,0,0,0
1,201392386,2170660915,57029,36895,2024-10-04 19:40:47,0,0,0,0,0,0
1,201392386,1145490691,29338,47873,2024-10-04 19:40:47,0,0,0,0,0,0
1,201392386,2170660915,0,0,2024-10-04 19:40:47,0,0,0,0,0,0
1,201392386,2170660915,37534,36895,2024-10-04 19:40:47,0,0,0,0,0,0
1,201392386,2170660915,57029,36895,2024-10-04 19:40:48,0,0,0,0,0,0
1,201392386,1145490691,29338,47873,2024-10-04 19:40:48,0,0,0,0,0,0
1,201392386,2170660915,0,0,2024-10-04 19:40:48,0,0,0,0,0,0
1,201392386,2170660915,37534,36895,2024-10-04 19:40:48,0,0,0,0,0,0
1,201392386,2170660915,57029,36895,2024-10-04 19:40:49,0,0,0,0,0,0
1,201392386,1145490691,29338,47873,2024-10-04 19:40:49,0,0,0,0,0,0
1,201392386,2170660915,0,0,2024-10-04 19:40:49,0,0,0,0,0,0
1,201392386,2170660915,37534,36895,2024-10-04 19:40:49,0,0,0,0,0,0
1,201392386,2170660915,57029,36895,2024-10-04 19:40:50,0,0,0,0,0,0
1,201392386,1145490691,29338,47873,2024-10-04 19:40:50,0,0,0,0,0,0
1,201392386,2170660915,0,0,2024-10-04 19:40:50,0,0,0,0,0,0
1,201392386,2170660915,37534,36895,2024-10-04 19:40:50,0,0,0,0,0,0
1,201392386,2170660915,57029,36895,2024-10-04 19:40:51,0,0,0,0,0,0
1,201392386,1145490691,29338,47873,2024-10-04 19:40:51,0,0,0,0,0,0
1,201392386,2170660915,0,0,2024-10-04 19:40:51,0,0,0,0,0,0
1,201392386,2170660915,37534,36895,2024-10-04 19:40:51,0,0,0,0,0,0
1,201392386,2170660915,57029,36895,2024-10-04 19:40:52,0,0,0,0,0,0
1,201392386,1145490691,29338,47873,2024-10-04 19:40:52,0,0,0,0,0,0
1,201392386,2170660915,0,0,2024-10-04 19:40:52,0,0,0,0,0,0
1,201392386,2170660915,37534,36895,2024-10-04 19:40:52,0,0,0,0,0,0
1,201392386,2170660915,57029,36895,2024-10-04 19:40:53,0,0,0,0,0,0
1,201392386,1145490691,29338,47873,2024-10-04 19:40:53,0,0,0,0,0,0
1,201392386,2170660915,0,0,2024-10-04 19:40:53,0,0,0,0,0,0
1,201392386,2170660915,37534,36895,2024-10-04 19:40:53,0,0,0,0,0,0
1,201392386,2170660915,57029,36895,2024-10-04 19:40:54,0,0,0,0,0,0
1,201392386,1145490691,29338,47873,2024-10-04 19:40:54,0,0,0,0,0,0
1,201392386,2170660915,0,0,2024-10-04 19:40:54,128,84,212,1,1,2
1,201392386,2170660915,37534,36895,2024-10-04 19:40:54,0,0,0,0,0,0
1,201392386,2170660915,57029,36895,2024-10-04 19:40:55,0,0,0,0,0,0
1,201392386,1145490691,29338,47873,2024-10-04 19:40:55,0,0,0,0,0,0
1,201392386,2170660915,0,0,2024-10-04 19:40:55,256,168,424,2,2,4
1,201392386,2170660915,37534,36895,2024-10-04 19:40:55,0,0,0,0,0,0
1,201392386,2170660915,57029,36895,2024-10-04 19:40:56,0,0,0,0,0,0
1,201392386,1145490691,29338,47873,2024-10-04 19:40:56,0,0,0,0,0,0
1,201392386,2170660915,0,0,2024-10-04 19:40:56,128,84,212,1,1,2
1,201392386,2170660915,37534,36895,2024-10-04 19:40:56,0,0,0,0,0,0
1,201392386,2170660915,57029,36895,2024-10-04 19:40:57,0,0,0,0,0,0
1,201392386,1145490691,29338,47873,2024-10-04 19:40:57,0,0,0,0,0,0
1,201392386,2170660915,0,0,2024-10-04 19:40:57,128,84,212,1,1,2
1,201392386,2170660915,37534,36895,2024-10-04 19:40:57,0,0,0,0,0,0
1,201392386,2170660915,57029,36895,2024-10-04 19:40:58,0,0,0,0,0,0
1,201392386,1145490691,29338,47873,2024-10-04 19:40:58,0,0,0,0,0,0
1,201392386,2170660915,0,0,2024-10-04 19:40:58,128,84,212,1,1,2
1,201392386,2170660915,37534,36895,2024-10-04 19:40:58,0,0,0,0,0,0
1,201392386,2170660915,57029,36895,2024-10-04 19:40:59,0,0,0,0,0,0
1,201392386,1145490691,29338,47873,2024-10-04 19:40:59,0,0,0,0,0,0
1,201392386,2170660915,0,0,2024-10-04 19:40:59,128,84,212,1,1,2
1,201392386,2170660915,37534,36895,2024-10-04 19:40:59,0,0,0,0,0,0
1,201392386,2170660915,57029,36895,2024-10-04 19:41:00,0,0,0,0,0,0
1,201392386,1145490691,29338,47873,2024-10-04 19:41:00,0,0,0,0,0,0
1,201392386,2170660915,0,0,2024-10-04 19:41:00,128,84,212,1,1,2
1,201392386,2170660915,37534,36895,2024-10-04 19:41:00,0,0,0,0,0,0
1,201392386,2170660915,57029,36895,2024-10-04 19:41:01,0,0,0,0,0,0
1,201392386,1145490691,29338,47873,2024-10-04 19:41:01,0,0,0,0,0,0
1,201392386,2170660915,0,0,2024-10-04 19:41:01,128,84,212,1,1,2
1,201392386,2170660915,37534,36895,2024-10-04 19:41:01,0,0,0,0,0,0
1,201392386,2170660915,57029,36895,2024-10-04 19:41:02,0,0,0,0,0,0
1,201392386,2170660915,0,0,2024-10-04 19:41:02,128,84,212,1,1,2
1,201392386,2170660915,37534,36895,2024-10-04 19:41:02,0,0,0,0,0,0
1,201392386,2170660915,57029,36895,2024-10-04 19:41:03,0,0,0,0,0,0
1,201392386,2170660915,0,0,2024-10-04 19:41:03,0,0,0,0,0,0
1,201392386,2170660915,37534,36895,2024-10-04 19:41:03,0,0,0,0,0,0
1,201392386,2170660915,57029,36895,2024-10-04 19:41:04,0,0,0,0,0,0
1,201392386,2170660915,51862,36895,2024-10-04 19:41:04,570,455,1025,5,5,10
1,201392386,2170660915,0,0,2024-10-04 19:41:04,0,0,0,0,0,0
1,201392386,2170660915,37534,36895,2024-10-04 19:41:04,0,0,0,0,0,0
1,201392386,2170660915,57029,36895,2024-10-04 19:41:05,0,0,0,0,0,0
1,201392386,2170660915,51862,36895,2024-10-04 19:41:05,0,0,0,0,0,0
1,201392386,2170660915,0,0,2024-10-04 19:41:05,128,84,212,1,1,2
1,201392386,2170660915,37534,36895,2024-10-04 19:41:05,0,0,0,0,0,0
1,201392386,2170660915,57029,36895,2024-10-04 19:41:06,0,0,0,0,0,0
1,201392386,2170660915,51862,36895,2024-10-04 19:41:06,0,0,0,0,0,0
1,201392386,2170660915,0,0,2024-10-04 19:41:06,0,0,0,0,0,0
1,201392386,2170660915,37534,36895,2024-10-04 19:41:06,0,0,0,0,0,0
1,201392386,2170660915,57029,36895,2024-10-04 19:41:07,0,0,0,0,0,0
1,201392386,2170660915,51862,36895,2024-10-04 19:41:07,0,0,0,0,0,0
1,201392386,2170660915,0,0,2024-10-04 19:41:07,256,84,340,2,1,3
1,201392386,2170660915,37534,36895,2024-10-04 19:41:07,0,0,0,0,0,0
1,201392386,2170660915,57029,36895,2024-10-04 19:41:08,0,0,0,0,0,0
1,201392386,2170660915,51862,36895,2024-10-04 19:41:08,0,0,0,0,0,0
1,201392386,2170660915,0,0,2024-10-04 19:41:08,0,84,84,0,1,1
1,201392386,2170660915,37534,36895,2024-10-04 19:41:08,0,0,0,0,0,0
1,201392386,2170660915,57029,36895,2024-10-04 19:41:09,0,0,0,0,0,0
1,201392386,2170660915,51862,36895,2024-10-04 19:41:09,0,0,0,0,0,0
1,201392386,2170660915,0,0,2024-10-04 19:41:09,0,0,0,0,0,0
1,201392386,2170660915,37534,36895,2024-10-04 19:41:09,0,0,0,0,0,0
1,201392386,2170660915,57029,36895,2024-10-04 19:41:10,0,0,0,0,0,0
1,201392386,2170660915,51862,36895,2024-10-04 19:41:10,0,0,0,0,0,0
1,201392386,2170660915,0,0,2024-10-04 19:41:10,0,0,0,0,0,0
1,201392386,2170660915,37534,36895,2024-10-04 19:41:10,0,0,0,0,0,0
1,201392386,2170660915,57029,36895,2024-10-04 19:41:11,0,0,0,0,0,0
1,201392386,2170660915,51862,36895,2024-10-04 19:41:11,0,0,0,0,0,0
1,201392386,2170660915,0,0,2024-10-04 19:41:11,128,84,212,1,1,2
1,201392386,2170660915,37534,36895,2024-10-04 19:41:11,0,0,0,0,0,0
1,201392386,2170660915,57029,36895,2024-10-04 19:41:12,0,0,0,0,0,0
1,201392386,2170660915,51862,36895,2024-10-04 19:41:12,0,0,0,0,0,0
1,201392386,2170660915,0,0,2024-10-04 19:41:12,128,84,212,1,1,2
1,201392386,2170660915,37534,36895,2024-10-04 19:41:12,0,0,0,0,0,0
1,201392386,2170660915,57029,36895,2024-10-04 19:41:13,0,0,0,0,0,0
1,201392386,2170660915,51862,36895,2024-10-04 19:41:13,0,0,0,0,0,0
1,201392386,1145490689,33940,47873,2024-10-04 19:41:13,4788,69008,73796,39,55,94
1,201392386,2170660915,0,0,2024-10-04 19:41:13,128,84,212,1,1,2
1,201392386,2170660915,37534,36895,2024-10-04 19:41:13,0,0,0,0,0,0
1,201392386,2170660915,57029,36895,2024-10-04 19:41:14,0,0,0,0,0,0
1,201392386,2170660915,51862,36895,2024-10-04 19:41:14,0,0,0,0,0,0
1,201392386,1145490689,33940,47873,2024-10-04 19:41:14,0,0,0,0,0,0
1,201392386,2170660915,0,0,2024-10-04 19:41:14,0,0,0,0,0,0
1,201392386,2170660915,37534,36895,2024-10-04 19:41:14,0,0,0,0,0,0
1,201392386,2170660915,57029,36895,2024-10-04 19:41:15,0,0,0,0,0,0
1,201392386,2170660915,51862,36895,2024-10-04 19:41:15,0,0,0,0,0,0
1,201392386,1145490689,33940,47873,2024-10-04 19:41:15,1632,24140,25772,16,19,35
1,201392386,2170660915,0,0,2024-10-04 19:41:15,0,0,0,0,0,0
1,201392386,2170660915,37534,36895,2024-10-04 19:41:15,0,0,0,0,0,0
1,201392386,2170660915,57029,36895,2024-10-04 19:41:16,0,0,0,0,0,0
1,201392386,2170660915,51862,36895,2024-10-04 19:41:16,0,0,0,0,0,0
1,201392386,1145490689,33940,47873,2024-10-04 19:41:16,0,0,0,0,0,0
1,201392386,2170660915,0,0,2024-10-04 19:41:16,0,0,0,0,0,0
1,201392386,2170660915,37534,36895,2024-10-04 19:41:16,0,0,0,0,0,0
1,201392386,2170660915,57029,36895,2024-10-04 19:41:17,0,0,0,0,0,0
1,201392386,2170660915,51862,36895,2024-10-04 19:41:17,0,0,0,0,0,0
1,201392386,1145490689,33940,47873,2024-10-04 19:41:17,0,0,0,0,0,0
1,201392386,2170660915,0,0,2024-10-04 19:41:17,0,0,0,0,0,0
1,201392386,2170660915,37534,36895,2024-10-04 19:41:17,0,0,0,0,0,0
1,201392386,2170660915,57029,36895,2024-10-04 19:41:18,0,0,0,0,0,0
1,201392386,2170660915,51862,36895,2024-10-04 19:41:18,0,0,0,0,0,0
1,201392386,1145490689,33940,47873,2024-10-04 19:41:18,0,0,0,0,0,0
1,201392386,2170660915,0,0,2024-10-04 19:41:18,0,0,0,0,0,0
1,201392386,2170660915,37534,36895,2024-10-04 19:41:18,0,0,0,0,0,0
1,201392386,2170660915,57029,36895,2024-10-04 19:41:19,0,0,0,0,0,0
1,201392386,2170660915,51862,36895,2024-10-04 19:41:19,0,0,0,0,0,0
1,201392386,1145490689,33940,47873,2024-10-04 19:41:19,0,0,0,0,0,0
1,201392386,2170660915,0,0,2024-10-04 19:41:19,0,0,0,0,0,0
1,201392386,2170660915,37534,36895,2024-10-04 19:41:19,0,0,0,0,0,0
1,201392386,2170660915,57029,36895,2024-10-04 19:41:20,0,0,0,0,0,0
1,201392386,2170660915,51862,36895,2024-10-04 19:41:20,0,0,0,0,0,0
1,201392386,1145490689,33940,47873,2024-10-04 19:41:20,0,0,0,0,0,0
1,201392386,2170660915,0,0,2024-10-04 19:41:20,0,0,0,0,0,0
1,201392386,2170660915,37534,36895,2024-10-04 19:41:20,0,0,0,0,0,0
1,201392386,2170660915,57029,36895,2024-10-04 19:41:21,0,0,0,0,0,0
1,201392386,2170660915,51862,36895,2024-10-04 19:41:21,0,0,0,0,0,0
1,201392386,1145490689,33940,47873,2024-10-04 19:41:21,0,0,0,0,0,0
1,201392386,2170660915,0,0,2024-10-04 19:41:21,0,0,0,0,0,0
1,201392386,2170660915,37534,36895,2024-10-04 19:41:21,0,0,0,0,0,0
1,201392386,2170660915,57029,36895,2024-10-04 19:41:22,0,0,0,0,0,0
1,201392386,2170660915,51862,36895,2024-10-04 19:41:22,0,0,0,0,0,0
1,201392386,1145490689,33940,47873,2024-10-04 19:41:22,0,0,0,0,0,0
1,201392386,2170660915,0,0,2024-10-04 19:41:22,0,0,0,0,0,0
1,201392386,2170660915,37534,36895,2024-10-04 19:41:22,0,0,0,0,0,0
1,201392386,2170660915,57029,36895,2024-10-04 19:41:23,0,0,0,0,0,0
1,201392386,2170660915,51862,36895,2024-10-04 19:41:23,0,0,0,0,0,0
1,201392386,1145490689,33940,47873,2024-10-04 19:41:23,0,0,0,0,0,0
1,201392386,2170660915,0,0,2024-10-04 19:41:23,128,0,128,1,0,1
1,201392386,2170660915,37534,36895,2024-10-04 19:41:23,0,0,0,0,0,0
1,201392386,2170660915,57029,36895,2024-10-04 19:41:24,0,0,0,0,0,0
1,201392386,2170660915,51862,36895,2024-10-04 19:41:24,0,0,0,0,0,0
1,201392386,1145490689,33940,47873,2024-10-04 19:41:24,0,0,0,0,0,0
1,201392386,2170660915,0,0,2024-10-04 19:41:24,128,84,212,1,1,2
1,201392386,2170660915,37534,36895,2024-10-04 19:41:24,0,0,0,0,0,0
1,201392386,2170660915,57029,36895,2024-10-04 19:41:25,0,0,0,0,0,0
1,201392386,2170660915,51862,36895,2024-10-04 19:41:25,0,0,0,0,0,0
1,201392386,1145490689,33940,47873,2024-10-04 19:41:25,0,0,0,0,0,0
1,201392386,2170660915,0,0,2024-10-04 19:41:25,128,84,212,1,1,2
1,201392386,2170660915,37534,36895,2024-10-04 19:41:25,0,0,0,0,0,0
1,201392386,2170660915,57029,36895,2024-10-04 19:41:26,0,0,0,0,0,0
1,201392386,2170660915,51862,36895,2024-10-04 19:41:26,0,0,0,0,0,0
1,201392386,1145490689,33940,47873,2024-10-04 19:41:26,0,0,0,0,0,0
1,201392386,2170660915,0,0,2024-10-04 19:41:26,128,84,212,1,1,2
1,201392386,2170660915,37534,36895,2024-10-04 19:41:26,0,0,0,0,0,0
1,201392386,2170660915,57029,36895,2024-10-04 19:41:27,0,0,0,0,0,0
1,201392386,2170660915,51862,36895,2024-10-04 19:41:27,0,0,0,0,0,0
1,201392386,1145490689,33940,47873,2024-10-04 19:41:27,0,0,0,0,0,0
1,201392386,2170660915,0,0,2024-10-04 19:41:27,128,84,212,1,1,2
1,201392386,2170660915,37534,36895,2024-10-04 19:41:27,0,0,0,0,0,0
1,201392386,2170660915,57029,36895,2024-10-04 19:41:28,0,0,0,0,0,0
1,201392386,2170660915,51862,36895,2024-10-04 19:41:28,0,0,0,0,0,0
1,201392386,1145490689,33940,47873,2024-10-04 19:41:28,0,0,0,0,0,0
1,201392386,2170660915,0,0,2024-10-04 19:41:28,128,84,212,1,1,2
1,201392386,2170660915,37534,36895,2024-10-04 19:41:28,0,0,0,0,0,0
1,201392386,2170660915,57029,36895,2024-10-04 19:41:29,0,0,0,0,0,0
1,201392386,2170660915,51862,36895,2024-10-04 19:41:29,0,0,0,0,0,0
1,201392386,1145490689,33940,47873,2024-10-04 19:41:29,0,0,0,0,0,0
1,201392386,2170660915,0,0,2024-10-04 19:41:29,0,0,0,0,0,0
1,201392386,2170660915,37534,36895,2024-10-04 19:41:29,0,0,0,0,0,0
1,201392386,2170660915,57029,36895,2024-10-04 19:41:30,0,0,0,0,0,0
1,201392386,2170660915,51862,36895,2024-10-04 19:41:30,0,0,0,0,0,0
1,201392386,1145490689,33940,47873,2024-10-04 19:41:30,0,0,0,0,0,0
1,201392386,2170660915,0,0,2024-10-04 19:41:30,128,84,212,1,1,2
1,201392386,2170660915,37534,36895,2024-10-04 19:41:30,0,0,0,0,0,0
1,201392386,2170660915,57029,36895,2024-10-04 19:41:31,0,0,0,0,0,0
1,201392386,2170660915,51862,36895,2024-10-04 19:41:31,0,0,0,0,0,0
1,201392386,1145490689,33940,47873,2024-10-04 19:41:31,0,0,0,0,0,0
1,201392386,2170660915,0,0,2024-10-04 19:41:31,128,84,212,1,1,2
1,201392386,2170660915,37534,36895,2024-10-04 19:41:31,0,0,0,0,0,0
1,201392386,2170660915,57029,36895,2024-10-04 19:41:32,0,0,0,0,0,0
1,201392386,2170660915,51862,36895,2024-10-04 19:41:32,0,0,0,0,0,0
1,201392386,1145490689,33940,47873,2024-10-04 19:41:32,0,0,0,0,0,0
1,201392386,2170660915,0,0,2024-10-04 19:41:32,128,84,212,1,1,2
1,201392386,2170660915,37534,36895,2024-10-04 19:41:32,0,0,0,0,0,0
1,201392386,2170660915,57029,36895,2024-10-04 19:41:33,0,0,0,0,0,0
1,201392386,2170660915,51862,36895,2024-10-04 19:41:33,0,0,0,0,0,0
1,201392386,1145490689,33940,47873,2024-10-04 19:41:33,0,0,0,0,0,0
1,201392386,2170660915,0,0,2024-10-04 19:41:33,128,168,296,1,2,3
1,201392386,2170660915,37534,36895,2024-10-04 19:41:33,0,0,0,0,0,0
1,201392386,2170660915,57029,36895,2024-10-04 19:41:34,0,0,0,0,0,0
1,201392386,2170660915,51862,36895,2024-10-04 19:41:34,0,0,0,0,0,0
1,201392386,2170660915,0,0,2024-10-04 19:41:34,0,0,0,0,0,0
1,201392386,2170660915,37534,36895,2024-10-04 19:41:34,0,0,0,0,0,0
1,201392386,2170660915,697,36895,2024-10-04 19:41:35,570,455,1025,5,5,10
1,201392386,2170660915,57029,36895,2024-10-04 19:41:35,0,0,0,0,0,0
1,201392386,2170660915,51862,36895,2024-10-04 19:41:35,0,0,0,0,0,0
1,201392386,2170660915,0,0,2024-10-04 19:41:35,128,0,128,1,0,1
1,201392386,2170660915,37534,36895,2024-10-04 19:41:35,0,0,0,0,0,0
1,201392386,2170660915,697,36895,2024-10-04 19:41:36,0,0,0,0,0,0
1,201392386,2170660915,57029,36895,2024-10-04 19:41:36,0,0,0,0,0,0
1,201392386,2170660915,0,0,2024-10-04 19:41:36,0,84,84,0,1,1
1,201392386,2170660915,37534,36895,2024-10-04 19:41:36,0,0,0,0,0,0
1,201392386,2170660915,697,36895,2024-10-04 19:41:37,0,0,0,0,0,0
1,201392386,2170660915,57029,36895,2024-10-04 19:41:37,0,0,0,0,0,0
1,201392386,2170660915,0,0,2024-10-04 19:41:37,256,84,340,2,1,3
1,201392386,2170660915,37534,36895,2024-10-04 19:41:37,0,0,0,0,0,0
1,201392386,2170660915,697,36895,2024-10-04 19:41:38,0,0,0,0,0,0
1,201392386,2170660915,57029,36895,2024-10-04 19:41:38,0,0,0,0,0,0
1,201392386,2170660915,0,0,2024-10-04 19:41:38,0,84,84,0,1,1
1,201392386,2170660915,37534,36895,2024-10-04 19:41:38,0,0,0,0,0,0
1,201392386,2170660915,697,36895,2024-10-04 19:41:39,0,0,0,0,0,0
1,201392386,2170660915,57029,36895,2024-10-04 19:41:39,0,0,0,0,0,0
1,201392386,2170660915,0,0,2024-10-04 19:41:39,0,0,0,0,0,0
1,201392386,2170660915,37534,36895,2024-10-04 19:41:39,0,0,0,0,0,0
1,201392386,2170660915,697,36895,2024-10-04 19:41:40,0,0,0,0,0,0
1,201392386,2170660915,57029,36895,2024-10-04 19:41:40,0,0,0,0,0,0
1,201392386,2170660915,0,0,2024-10-04 19:41:40,0,0,0,0,0,0
1,201392386,2170660915,37534,36895,2024-10-04 19:41:40,0,0,0,0,0,0
1,201392386,2170660915,697,36895,2024-10-04 19:41:41,0,0,0,0,0,0
1,201392386,2170660915,57029,36895,2024-10-04 19:41:41,0,0,0,0,0,0
1,201392386,2170660915,0,0,2024-10-04 19:41:41,128,84,212,1,1,2
1,201392386,2170660915,37534,36895,2024-10-04 19:41:41,0,0,0,0,0,0
1,201392386,2170660915,697,36895,2024-10-04 19:41:42,0,0,0,0,0,0
1,201392386,2170660915,57029,36895,2024-10-04 19:41:42,0,0,0,0,0,0
1,201392386,2170660915,0,0,2024-10-04 19:41:42,128,84,212,1,1,2
1,201392386,2170660915,37534,36895,2024-10-04 19:41:42,0,0,0,0,0,0
1,201392386,2170660915,697,36895,2024-10-04 19:41:43,0,0,0,0,0,0
1,201392386,2170660915,57029,36895,2024-10-04 19:41:43,0,0,0,0,0,0
1,201392386,1145490691,53419,47873,2024-10-04 19:41:43,2724,29671,32395,19,27,46
1,201392386,2170660915,0,0,2024-10-04 19:41:43,128,84,212,1,1,2
1,201392386,2170660915,37534,36895,2024-10-04 19:41:43,0,0,0,0,0,0
1,201392386,2170660915,697,36895,2024-10-04 19:41:44,0,0,0,0,0,0
1,201392386,2170660915,57029,36895,2024-10-04 19:41:44,0,0,0,0,0,0
1,201392386,1145490691,53419,47873,2024-10-04 19:41:44,2760,60906,63666,27,39,66
1,201392386,2170660915,0,0,2024-10-04 19:41:44,0,0,0,0,0,0
1,201392386,2170660915,37534,36895,2024-10-04 19:41:44,0,0,0,0,0,0
1,201392386,2170660915,697,36895,2024-10-04 19:41:45,0,0,0,0,0,0
1,201392386,2170660915,57029,36895,2024-10-04 19:41:45,0,0,0,0,0,0
1,201392386,1145490691,53419,47873,2024-10-04 19:41:45,1428,20825,22253,14,16,30
1,201392386,2170660915,0,0,2024-10-04 19:41:45,0,0,0,0,0,0
1,201392386,2170660915,37534,36895,2024-10-04 19:41:45,0,0,0,0,0,0
1,201392386,2170660915,697,36895,2024-10-04 19:41:46,0,0,0,0,0,0
1,201392386,2170660915,57029,36895,2024-10-04 19:41:46,0,0,0,0,0,0
1,201392386,1145490691,53419,47873,2024-10-04 19:41:46,0,0,0,0,0,0
1,201392386,2170660915,0,0,2024-10-04 19:41:46,0,0,0,0,0,0
1,201392386,2170660915,37534,36895,2024-10-04 19:41:46,0,0,0,0,0,0
1,201392386,2170660915,697,36895,2024-10-04 19:41:47,0,0,0,0,0,0
1,201392386,2170660915,57029,36895,2024-10-04 19:41:47,0,0,0,0,0,0
1,201392386,1145490691,53419,47873,2024-10-04 19:41:47,0,0,0,0,0,0
1,201392386,2170660915,0,0,2024-10-04 19:41:47,0,0,0,0,0,0
1,201392386,2170660915,37534,36895,2024-10-04 19:41:47,0,0,0,0,0,0
1,201392386,2170660915,697,36895,2024-10-04 19:41:48,0,0,0,0,0,0
1,201392386,2170660915,57029,36895,2024-10-04 19:41:48,0,0,0,0,0,0
1,201392386,1145490691,53419,47873,2024-10-04 19:41:48,0,0,0,0,0,0
1,201392386,2170660915,0,0,2024-10-04 19:41:48,0,0,0,0,0,0
1,201392386,2170660915,37534,36895,2024-10-04 19:41:48,0,0,0,0,0,0
1,201392386,2170660915,697,36895,2024-10-04 19:41:49,0,0,0,0,0,0
1,201392386,2170660915,57029,36895,2024-10-04 19:41:49,0,0,0,0,0,0
1,201392386,1145490691,53419,47873,2024-10-04 19:41:49,0,0,0,0,0,0
1,201392386,2170660915,0,0,2024-10-04 19:41:49,0,0,0,0,0,0
1,201392386,2170660915,37534,36895,2024-10-04 19:41:49,0,0,0,0,0,0
1,201392386,2170660915,697,36895,2024-10-04 19:41:50,0,0,0,0,0,0
1,201392386,2170660915,57029,36895,2024-10-04 19:41:50,0,0,0,0,0,0
1,201392386,1145490691,53419,47873,2024-10-04 19:41:50,0,0,0,0,0,0
1,201392386,2170660915,0,0,2024-10-04 19:41:50,0,0,0,0,0,0
1,201392386,2170660915,37534,36895,2024-10-04 19:41:50,0,0,0,0,0,0
1,201392386,2170660915,697,36895,2024-10-04 19:41:51,0,0,0,0,0,0
1,201392386,2170660915,57029,36895,2024-10-04 19:41:51,0,0,0,0,0,0
1,201392386,1145490691,53419,47873,2024-10-04 19:41:51,0,0,0,0,0,0
1,201392386,2170660915,0,0,2024-10-04 19:41:51,0,0,0,0,0,0
1,201392386,2170660915,37534,36895,2024-10-04 19:41:51,0,0,0,0,0,0
1,201392386,2170660915,697,36895,2024-10-04 19:41:52,0,0,0,0,0,0
1,201392386,2170660915,57029,36895,2024-10-04 19:41:52,0,0,0,0,0,0
1,201392386,1145490691,53419,47873,2024-10-04 19:41:52,0,0,0,0,0,0
1,201392386,2170660915,0,0,2024-10-04 19:41:52,0,0,0,0,0,0
1,201392386,2170660915,37534,36895,2024-10-04 19:41:52,0,0,0,0,0,0
1,201392386,2170660915,697,36895,2024-10-04 19:41:53,0,0,0,0,0,0
1,201392386,2170660915,57029,36895,2024-10-04 19:41:53,0,0,0,0,0,0
1,201392386,1145490691,53419,47873,2024-10-04 19:41:53,0,0,0,0,0,0
1,201392386,2170660915,0,0,2024-10-04 19:41:53,0,0,0,0,0,0
1,201392386,2170660915,37534,36895,2024-10-04 19:41:53,0,0,0,0,0,0
1,201392386,2170660915,697,36895,2024-10-04 19:41:54,0,0,0,0,0,0
1,201392386,2170660915,57029,36895,2024-10-04 19:41:54,0,0,0,0,0,0
1,201392386,1145490691,53419,47873,2024-10-04 19:41:54,0,0,0,0,0,0
1,201392386,2170660915,0,0,2024-10-04 19:41:54,0,0,0,0,0,0
1,201392386,2170660915,37534,36895,2024-10-04 19:41:54,0,0,0,0,0,0
1,201392386,2170660915,697,36895,2024-10-04 19:41:55,0,0,0,0,0,0
1,201392386,2170660915,57029,36895,2024-10-04 19:41:55,0,0,0,0,0,0
1,201392386,1145490691,53419,47873,2024-10-04 19:41:55,0,0,0,0,0,0
1,201392386,2170660915,0,0,2024-10-04 19:41:55,128,84,212,1,1,2
1,201392386,2170660915,37534,36895,2024-10-04 19:41:55,0,0,0,0,0,0
1,201392386,2170660915,697,36895,2024-10-04 19:41:56,0,0,0,0,0,0
1,201392386,2170660915,57029,36895,2024-10-04 19:41:56,0,0,0,0,0,0
1,201392386,1145490691,53419,47873,2024-10-04 19:41:56,0,0,0,0,0,0
1,201392386,2170660915,0,0,2024-10-04 19:41:56,128,84,212,1,1,2
1,201392386,2170660915,37534,36895,2024-10-04 19:41:56,0,0,0,0,0,0
1,201392386,2170660915,697,36895,2024-10-04 19:41:57,0,0,0,0,0,0
1,201392386,2170660915,57029,36895,2024-10-04 19:41:57,0,0,0,0,0,0
1,201392386,1145490691,53419,47873,2024-10-04 19:41:57,0,0,0,0,0,0
1,201392386,2170660915,0,0,2024-10-04 19:41:57,128,84,212,1,1,2
1,201392386,2170660915,37534,36895,2024-10-04 19:41:57,0,0,0,0,0,0
1,201392386,2170660915,697,36895,2024-10-04 19:41:58,0,0,0,0,0,0
1,201392386,2170660915,57029,36895,2024-10-04 19:41:58,0,0,0,0,0,0
1,201392386,1145490691,53419,47873,2024-10-04 19:41:58,0,0,0,0,0,0
1,201392386,2170660915,0,0,2024-10-04 19:41:58,128,84,212,1,1,2
1,201392386,2170660915,37534,36895,2024-10-04 19:41:58,0,0,0,0,0,0
1,201392386,2170660915,697,36895,2024-10-04 19:41:59,0,0,0,0,0,0
1,201392386,2170660915,57029,36895,2024-10-04 19:41:59,0,0,0,0,0,0
1,201392386,1145490691,53419,47873,2024-10-04 19:41:59,0,0,0,0,0,0
1,201392386,2170660915,0,0,2024-10-04 19:41:59,128,84,212,1,1,2
1,201392386,2170660915,37534,36895,2024-10-04 19:41:59,0,0,0,0,0,0
1,201392386,2170660915,697,36895,2024-10-04 19:42:00,0,0,0,0,0,0
1,201392386,2170660915,57029,36895,2024-10-04 19:42:00,0,0,0,0,0,0
1,201392386,1145490691,53419,47873,2024-10-04 19:42:00,0,0,0,0,0,0
1,201392386,2170660915,0,0,2024-10-04 19:42:00,128,84,212,1,1,2
1,201392386,2170660915,37534,36895,2024-10-04 19:42:00,0,0,0,0,0,0
1,201392386,2170660915,697,36895,2024-10-04 19:42:01,0,0,0,0,0,0
1,201392386,2170660915,57029,36895,2024-10-04 19:42:01,0,0,0,0,0,0
1,201392386,1145490691,53419,47873,2024-10-04 19:42:01,0,0,0,0,0,0
1,201392386,2170660915,0,0,2024-10-04 19:42:01,128,84,212,1,1,2
1,201392386,2170660915,37534,36895,2024-10-04 19:42:01,0,0,0,0,0,0
1,201392386,2170660915,697,36895,2024-10-04 19:42:02,0,0,0,0,0,0
1,201392386,2170660915,57029,36895,2024-10-04 19:42:02,0,0,0,0,0,0
1,201392386,1145490691,53419,47873,2024-10-04 19:42:02,0,0,0,0,0,0
1,201392386,2170660915,0,0,2024-10-04 19:42:02,128,84,212,1,1,2
1,201392386,2170660915,37534,36895,2024-10-04 19:42:02,0,0,0,0,0,0
1,201392386,2170660915,697,36895,2024-10-04 19:42:03,0,0,0,0,0,0
1,201392386,2170660915,57029,36895,2024-10-04 19:42:03,0,0,0,0,0,0
1,201392386,1145490691,53419,47873,2024-10-04 19:42:03,0,0,0,0,0,0
1,201392386,2170660915,0,0,2024-10-04 19:42:03,128,84,212,1,1,2
1,201392386,2170660915,37534,36895,2024-10-04 19:42:03,0,0,0,0,0,0
1,201392386,2170660915,697,36895,2024-10-04 19:42:04,0,0,0,0,0,0
1,201392386,2170660915,57029,36895,2024-10-04 19:42:04,0,0,0,0,0,0
1,201392386,2170660915,0,0,2024-10-04 19:42:04,128,84,212,1,1,2
1,201392386,2170660915,37534,36895,2024-10-04 19:42:04,0,0,0,0,0,0
1,201392386,2170660915,697,36895,2024-10-04 19:42:05,0,0,0,0,0,0
1,201392386,2170660915,57029,36895,2024-10-04 19:42:05,0,0,0,0,0,0
1,201392386,2170660915,0,0,2024-10-04 19:42:05,0,0,0,0,0,0
1,201392386,2170660915,37534,36895,2024-10-04 19:42:05,0,0,0,0,0,0
1,201392386,2170660915,57029,36895,2024-10-04 19:42:06,0,0,0,0,0,0
1,201392386,2170660915,48857,36895,2024-10-04 19:42:06,666,507,1173,6,6,12
1,201392386,2170660915,0,0,2024-10-04 19:42:06,0,0,0,0,0,0
1,201392386,2170660915,37534,36895,2024-10-04 19:42:06,0,0,0,0,0,0
1,201392386,2170660915,57029,36895,2024-10-04 19:42:07,0,0,0,0,0,0
1,201392386,2170660915,48857,36895,2024-10-04 19:42:07,0,0,0,0,0,0
1,201392386,2170660915,0,0,2024-10-04 19:42:07,256,84,340,2,1,3
1,201392386,2170660915,37534,36895,2024-10-04 19:42:07,0,0,0,0,0,0
1,201392386,2170660915,57029,36895,2024-10-04 19:42:08,0,0,0,0,0,0
1,201392386,2170660915,48857,36895,2024-10-04 19:42:08,0,0,0,0,0,0
1,201392386,2170660915,0,0,2024-10-04 19:42:08,128,84,212,1,1,2
1,201392386,2170660915,37534,36895,2024-10-04 19:42:08,0,0,0,0,0,0
1,201392386,2170660915,57029,36895,2024-10-04 19:42:09,0,0,0,0,0,0
1,201392386,2170660915,48857,36895,2024-10-04 19:42:09,0,0,0,0,0,0
1,201392386,2170660915,0,0,2024-10-04 19:42:09,0,0,0,0,0,0
1,201392386,2170660915,37534,36895,2024-10-04 19:42:09,0,0,0,0,0,0
1,201392386,2170660915,57029,36895,2024-10-04 19:42:10,0,0,0,0,0,0
1,201392386,2170660915,48857,36895,2024-10-04 19:42:10,0,0,0,0,0,0
1,201392386,2170660915,0,0,2024-10-04 19:42:10,0,84,84,0,1,1
1,201392386,2170660915,37534,36895,2024-10-04 19:42:10,0,0,0,0,0,0
1,201392386,2170660915,57029,36895,2024-10-04 19:42:11,0,0,0,0,0,0
1,201392386,2170660915,48857,36895,2024-10-04 19:42:11,0,0,0,0,0,0
1,201392386,2170660915,0,0,2024-10-04 19:42:11,0,0,0,0,0,0
1,201392386,2170660915,37534,36895,2024-10-04 19:42:11,0,0,0,0,0,0
1,201392386,2170660915,57029,36895,2024-10-04 19:42:12,0,0,0,0,0,0
1,201392386,2170660915,48857,36895,2024-10-04 19:42:12,0,0,0,0,0,0
1,201392386,2170660915,0,0,2024-10-04 19:42:12,0,0,0,0,0,0
1,201392386,2170660915,37534,36895,2024-10-04 19:42:12,0,0,0,0,0,0
1,201392386,2170660915,57029,36895,2024-10-04 19:42:13,0,0,0,0,0,0
1,201392386,2170660915,48857,36895,2024-10-04 19:42:13,0,0,0,0,0,0
1,201392386,2170660915,0,0,2024-10-04 19:42:13,256,168,424,2,2,4
1,201392386,2170660915,37534,36895,2024-10-04 19:42:13,0,0,0,0,0,0
1,201392386,2170660915,57029,36895,2024-10-04 19:42:14,0,0,0,0,0,0
1,201392386,1145490691,60646,47873,2024-10-04 19:42:14,1877,5533,7410,11,8,19
1,201392386,2170660915,48857,36895,2024-10-04 19:42:14,0,0,0,0,0,0
1,201392386,2170660915,0,0,2024-10-04 19:42:14,128,84,212,1,1,2
1,201392386,2170660915,37534,36895,2024-10-04 19:42:14,0,0,0,0,0,0
1,201392386,2170660915,57029,36895,2024-10-04 19:42:15,0,0,0,0,0,0
1,201392386,1145490691,60646,47873,2024-10-04 19:42:15,3031,68336,71367,29,47,76
1,201392386,2170660915,48857,36895,2024-10-04 19:42:15,0,0,0,0,0,0
1,201392386,2170660915,0,0,2024-10-04 19:42:15,0,0,0,0,0,0
1,201392386,2170660915,37534,36895,2024-10-04 19:42:15,0,0,0,0,0,0
1,201392386,2170660915,57029,36895,2024-10-04 19:42:16,0,0,0,0,0,0
1,201392386,1145490691,60646,47873,2024-10-04 19:42:16,0,0,0,0,0,0
1,201392386,2170660915,48857,36895,2024-10-04 19:42:16,0,0,0,0,0,0
1,201392386,2170660915,0,0,2024-10-04 19:42:16,0,0,0,0,0,0
1,201392386,2170660915,37534,36895,2024-10-04 19:42:16,0,0,0,0,0,0
1,201392386,2170660915,57029,36895,2024-10-04 19:42:17,0,0,0,0,0,0
1,201392386,1145490691,60646,47873,2024-10-04 19:42:17,0,0,0,0,0,0
1,201392386,2170660915,48857,36895,2024-10-04 19:42:17,0,0,0,0,0,0
1,201392386,2170660915,0,0,2024-10-04 19:42:17,0,0,0,0,0,0
1,201392386,2170660915,37534,36895,2024-10-04 19:42:17,0,0,0,0,0,0
1,201392386,2170660915,57029,36895,2024-10-04 19:42:18,0,0,0,0,0,0
1,201392386,1145490691,60646,47873,2024-10-04 19:42:18,0,0,0,0,0,0
1,201392386,2170660915,48857,36895,2024-10-04 19:42:18,0,0,0,0,0,0
1,201392386,2170660915,0,0,2024-10-04 19:42:18,0,0,0,0,0,0
1,201392386,2170660915,37534,36895,2024-10-04 19:42:18,0,0,0,0,0,0
1,201392386,2170660915,57029,36895,2024-10-04 19:42:19,0,0,0,0,0,0
1,201392386,1145490691,60646,47873,2024-10-04 19:42:19,0,0,0,0,0,0
1,201392386,2170660915,48857,36895,2024-10-04 19:42:19,0,0,0,0,0,0
1,201392386,2170660915,0,0,2024-10-04 19:42:19,0,0,0,0,0,0
1,201392386,2170660915,37534,36895,2024-10-04 19:42:19,0,0,0,0,0,0
1,201392386,2170660915,57029,36895,2024-10-04 19:42:20,0,0,0,0,0,0
1,201392386,1145490691,60646,47873,2024-10-04 19:42:20,0,0,0,0,0,0
1,201392386,2170660915,48857,36895,2024-10-04 19:42:20,0,0,0,0,0,0
1,201392386,2170660915,0,0,2024-10-04 19:42:20,0,0,0,0,0,0
1,201392386,2170660915,37534,36895,2024-10-04 19:42:20,0,0,0,0,0,0
1,201392386,2170660915,57029,36895,2024-10-04 19:42:21,0,0,0,0,0,0
1,201392386,1145490691,60646,47873,2024-10-04 19:42:21,0,0,0,0,0,0
1,201392386,2170660915,48857,36895,2024-10-04 19:42:21,0,0,0,0,0,0
1,201392386,2170660915,0,0,2024-10-04 19:42:21,0,0,0,0,0,0
1,201392386,2170660915,37534,36895,2024-10-04 19:42:21,0,0,0,0,0,0
1,201392386,2170660915,57029,36895,2024-10-04 19:42:22,0,0,0,0,0,0
1,201392386,1145490691,60646,47873,2024-10-04 19:42:22,0,0,0,0,0,0
1,201392386,2170660915,48857,36895,2024-10-04 19:42:22,0,0,0,0,0,0
1,201392386,2170660915,0,0,2024-10-04 19:42:22,0,0,0,0,0,0
1,201392386,2170660915,37534,36895,2024-10-04 19:42:22,0,0,0,0,0,0
1,201392386,2170660915,57029,36895,2024-10-04 19:42:23,0,0,0,0,0,0
1,201392386,1145490691,60646,47873,2024-10-04 19:42:23,0,0,0,0,0,0
1,201392386,2170660915,48857,36895,2024-10-04 19:42:23,0,0,0,0,0,0
1,201392386,2170660915,0,0,2024-10-04 19:42:23,0,0,0,0,0,0
1,201392386,2170660915,37534,36895,2024-10-04 19:42:23,0,0,0,0,0,0
1,201392386,2170660915,57029,36895,2024-10-04 19:42:24,0,0,0,0,0,0
1,201392386,1145490691,60646,47873,2024-10-04 19:42:24,1860,29397,31257,18,23,41
1,201392386,2170660915,48857,36895,2024-10-04 19:42:24,0,0,0,0,0,0
1,201392386,2170660915,0,0,2024-10-04 19:42:24,0,0,0,0,0,0
1,201392386,2170660915,37534,36895,2024-10-04 19:42:24,0,0,0,0,0,0
1,201392386,2170660915,57029,36895,2024-10-04 19:42:25,0,0,0,0,0,0
1,201392386,1145490691,60646,47873,2024-10-04 19:42:25,0,0,0,0,0,0
1,201392386,2170660915,48857,36895,2024-10-04 19:42:25,0,0,0,0,0,0
1,201392386,2170660915,0,0,2024-10-04 19:42:25,128,0,128,1,0,1
1,201392386,2170660915,37534,36895,2024-10-04 19:42:25,0,0,0,0,0,0
1,201392386,2170660915,57029,36895,2024-10-04 19:42:26,0,0,0,0,0,0
1,201392386,1145490691,60646,47873,2024-10-04 19:42:26,0,0,0,0,0,0
1,201392386,2170660915,48857,36895,2024-10-04 19:42:26,0,0,0,0,0,0
1,201392386,2170660915,0,0,2024-10-04 19:42:26,128,84,212,1,1,2
1,201392386,2170660915,37534,36895,2024-10-04 19:42:26,0,0,0,0,0,0
1,201392386,2170660915,57029,36895,2024-10-04 19:42:27,0,0,0,0,0,0
1,201392386,1145490691,60646,47873,2024-10-04 19:42:27,0,0,0,0,0,0
1,201392386,2170660915,48857,36895,2024-10-04 19:42:27,0,0,0,0,0,0
1,201392386,2170660915,0,0,2024-10-04 19:42:27,128,84,212,1,1,2
1,201392386,2170660915,37534,36895,2024-10-04 19:42:27,0,0,0,0,0,0
1,201392386,2170660915,57029,36895,2024-10-04 19:42:28,0,0,0,0,0,0
1,201392386,1145490691,60646,47873,2024-10-04 19:42:28,0,0,0,0,0,0
1,201392386,2170660915,48857,36895,2024-10-04 19:42:28,0,0,0,0,0,0
1,201392386,2170660915,0,0,2024-10-04 19:42:28,0,84,84,0,1,1
1,201392386,2170660915,37534,36895,2024-10-04 19:42:28,0,0,0,0,0,0
1,201392386,2170660915,57029,36895,2024-10-04 19:42:29,0,0,0,0,0,0
1,201392386,1145490691,60646,47873,2024-10-04 19:42:29,0,0,0,0,0,0
1,201392386,2170660915,48857,36895,2024-10-04 19:42:29,0,0,0,0,0,0
1,201392386,2170660915,0,0,2024-10-04 19:42:29,128,84,212,1,1,2
1,201392386,2170660915,37534,36895,2024-10-04 19:42:29,0,0,0,0,0,0
1,201392386,2170660915,57029,36895,2024-10-04 19:42:30,0,0,0,0,0,0
1,201392386,1145490691,60646,47873,2024-10-04 19:42:30,0,0,0,0,0,0
1,201392386,2170660915,48857,36895,2024-10-04 19:42:30,0,0,0,0,0,0
1,201392386,2170660915,0,0,2024-10-04 19:42:30,128,84,212,1,1,2
1,201392386,2170660915,37534,36895,2024-10-04 19:42:30,0,0,0,0,0,0
1,201392386,2170660915,57029,36895,2024-10-04 19:42:31,0,0,0,0,0,0
1,201392386,1145490691,60646,47873,2024-10-04 19:42:31,0,0,0,0,0,0
1,201392386,2170660915,48857,36895,2024-10-04 19:42:31,0,0,0,0,0,0
1,201392386,2170660915,0,0,2024-10-04 19:42:31,128,84,212,1,1,2
1,201392386,2170660915,37534,36895,2024-10-04 19:42:31,0,0,0,0,0,0
1,201392386,2170660915,57029,36895,2024-10-04 19:42:32,0,0,0,0,0,0
1,201392386,1145490691,60646,47873,2024-10-04 19:42:32,0,0,0,0,0,0
1,201392386,2170660915,48857,36895,2024-10-04 19:42:32,0,0,0,0,0,0
1,201392386,2170660915,0,0,2024-10-04 19:42:32,128,84,212,1,1,2
1,201392386,2170660915,37534,36895,2024-10-04 19:42:32,0,0,0,0,0,0
1,201392386,2170660915,57029,36895,2024-10-04 19:42:33,0,0,0,0,0,0
1,201392386,1145490691,60646,47873,2024-10-04 19:42:33,0,0,0,0,0,0
1,201392386,2170660915,48857,36895,2024-10-04 19:42:33,0,0,0,0,0,0
1,201392386,2170660915,0,0,2024-10-04 19:42:33,128,84,212,1,1,2
1,201392386,2170660915,37534,36895,2024-10-04 19:42:33,0,0,0,0,0,0
1,201392386,2170660915,57029,36895,2024-10-04 19:42:34,0,0,0,0,0,0
1,201392386,1145490691,60646,47873,2024-10-04 19:42:34,0,0,0,0,0,0
1,201392386,2170660915,48857,36895,2024-10-04 19:42:34,0,0,0,0,0,0
1,201392386,2170660915,0,0,2024-10-04 19:42:34,128,84,212,1,1,2
1,201392386,2170660915,37534,36895,2024-10-04 19:42:34,0,0,0,0,0,0
1,201392386,2170660915,57029,36895,2024-10-04 19:42:35,0,0,0,0,0,0
1,201392386,2170660915,48857,36895,2024-10-04 19:42:35,0,0,0,0,0,0
1,201392386,2170660915,0,0,2024-10-04 19:42:35,128,84,212,1,1,2
1,201392386,2170660915,37534,36895,2024-10-04 19:42:35,0,0,0,0,0,0
1,201392386,2170660915,57029,36895,2024-10-04 19:42:36,0,0,0,0,0,0
1,201392386,2170660915,48857,36895,2024-10-04 19:42:36,0,0,0,0,0,0
1,201392386,2170660915,0,0,2024-10-04 19:42:36,0,0,0,0,0,0
1,201392386,2170660915,37534,36895,2024-10-04 19:42:36,0,0,0,0,0,0
1,201392386,2170660915,57029,36895,2024-10-04 19:42:37,0,0,0,0,0,0
1,201392386,2170660915,48796,36895,2024-10-04 19:42:37,666,507,1173,6,6,12
1,201392386,2170660915,0,0,2024-10-04 19:42:37,128,0,128,1,0,1
1,201392386,2170660915,37534,36895,2024-10-04 19:42:37,0,0,0,0,0,0
1,201392386,2170660915,57029,36895,2024-10-04 19:42:38,0,0,0,0,0,0
1,201392386,2170660915,48796,36895,2024-10-04 19:42:38,0,0,0,0,0,0
1,201392386,2170660915,0,0,2024-10-04 19:42:38,128,84,212,1,1,2
1,201392386,2170660915,37534,36895,2024-10-04 19:42:38,0,0,0,0,0,0
1,201392386,2170660915,57029,36895,2024-10-04 19:42:39,0,0,0,0,0,0
1,201392386,2170660915,48796,36895,2024-10-04 19:42:39,0,0,0,0,0,0
1,201392386,2170660915,0,0,2024-10-04 19:42:39,128,84,212,1,1,2
1,201392386,2170660915,37534,36895,2024-10-04 19:42:39,0,0,0,0,0,0
1,201392386,2170660915,57029,36895,2024-10-04 19:42:40,0,0,0,0,0,0
1,201392386,2170660915,48796,36895,2024-10-04 19:42:40,0,0,0,0,0,0
1,201392386,2170660915,0,0,2024-10-04 19:42:40,0,0,0,0,0,0
1,201392386,2170660915,37534,36895,2024-10-04 19:42:40,0,0,0,0,0,0
1,201392386,2170660915,57029,36895,2024-10-04 19:42:41,0,0,0,0,0,0
1,201392386,2170660915,48796,36895,2024-10-04 19:42:41,0,0,0,0,0,0
1,201392386,2170660915,0,0,2024-10-04 19:42:41,0,84,84,0,1,1
1,201392386,2170660915,37534,36895,2024-10-04 19:42:41,0,0,0,0,0,0
1,201392386,2170660915,57029,36895,2024-10-04 19:42:42,0,0,0,0,0,0
1,201392386,2170660915,48796,36895,2024-10-04 19:42:42,0,0,0,0,0,0
1,201392386,2170660915,0,0,2024-10-04 19:42:42,0,0,0,0,0,0
1,201392386,2170660915,37534,36895,2024-10-04 19:42:42,0,0,0,0,0,0
1,201392386,2170660915,57029,36895,2024-10-04 19:42:43,0,0,0,0,0,0
1,201392386,2170660915,48796,36895,2024-10-04 19:42:43,0,0,0,0,0,0
1,201392386,2170660915,0,0,2024-10-04 19:42:43,128,84,212,1,1,2
1,201392386,2170660915,37534,36895,2024-10-04 19:42:43,0,0,0,0,0,0
1,201392386,2170660915,57029,36895,2024-10-04 19:42:44,0,0,0,0,0,0
1,201392386,2170660915,48796,36895,2024-10-04 19:42:44,0,0,0,0,0,0
1,201392386,2170660915,0,0,2024-10-04 19:42:44,128,84,212,1,1,2
1,201392386,2170660915,37534,36895,2024-10-04 19:42:44,0,0,0,0,0,0
1,201392386,1145490691,44201,47873,2024-10-04 19:42:45,2304,18695,20999,15,21,36
1,201392386,2170660915,57029,36895,2024-10-04 19:42:45,0,0,0,0,0,0
1,201392386,2170660915,48796,36895,2024-10-04 19:42:45,0,0,0,0,0,0
1,201392386,2170660915,0,0,2024-10-04 19:42:45,128,84,212,1,1,2
1,201392386,2170660915,37534,36895,2024-10-04 19:42:45,0,0,0,0,0,0
1,201392386,1145490691,44201,47873,2024-10-04 19:42:46,2268,51158,53426,22,33,55
1,201392386,2170660915,57029,36895,2024-10-04 19:42:46,0,0,0,0,0,0
1,201392386,2170660915,48796,36895,2024-10-04 19:42:46,0,0,0,0,0,0
1,201392386,2170660915,0,0,2024-10-04 19:42:46,0,0,0,0,0,0
1,201392386,2170660915,37534,36895,2024-10-04 19:42:46,0,0,0,0,0,0
1,201392386,1145490691,44201,47873,2024-10-04 19:42:47,1848,37429,39277,18,25,43
1,201392386,2170660915,57029,36895,2024-10-04 19:42:47,0,0,0,0,0,0
1,201392386,2170660915,48796,36895,2024-10-04 19:42:47,0,0,0,0,0,0
1,201392386,2170660915,0,0,2024-10-04 19:42:47,0,0,0,0,0,0
1,201392386,2170660915,37534,36895,2024-10-04 19:42:47,0,0,0,0,0,0
1,201392386,1145490691,44201,47873,2024-10-04 19:42:48,0,0,0,0,0,0
1,201392386,2170660915,57029,36895,2024-10-04 19:42:48,0,0,0,0,0,0
1,201392386,2170660915,48796,36895,2024-10-04 19:42:48,0,0,0,0,0,0
1,201392386,2170660915,0,0,2024-10-04 19:42:48,0,0,0,0,0,0
1,201392386,2170660915,37534,36895,2024-10-04 19:42:48,0,0,0,0,0,0
1,201392386,1145490691,44201,47873,2024-10-04 19:42:49,0,0,0,0,0,0
1,201392386,2170660915,57029,36895,2024-10-04 19:42:49,0,0,0,0,0,0
1,201392386,2170660915,48796,36895,2024-10-04 19:42:49,0,0,0,0,0,0
1,201392386,2170660915,0,0,2024-10-04 19:42:49,0,0,0,0,0,0
1,201392386,2170660915,37534,36895,2024-10-04 19:42:49,0,0,0,0,0,0
1,201392386,1145490691,44201,47873,2024-10-04 19:42:50,0,0,0,0,0,0
1,201392386,2170660915,57029,36895,2024-10-04 19:42:50,0,0,0,0,0,0
1,201392386,2170660915,48796,36895,2024-10-04 19:42:50,0,0,0,0,0,0
1,201392386,2170660915,0,0,2024-10-04 19:42:50,0,0,0,0,0,0
1,201392386,2170660915,37534,36895,2024-10-04 19:42:50,0,0,0,0,0,0
1,201392386,1145490691,44201,47873,2024-10-04 19:42:51,0,0,0,0,0,0
1,201392386,2170660915,57029,36895,2024-10-04 19:42:51,0,0,0,0,0,0
1,201392386,2170660915,48796,36895,2024-10-04 19:42:51,0,0,0,0,0,0
1,201392386,2170660915,0,0,2024-10-04 19:42:51,0,0,0,0,0,0
1,201392386,2170660915,37534,36895,2024-10-04 19:42:51,0,0,0,0,0,0
1,201392386,1145490691,44201,47873,2024-10-04 19:42:52,0,0,0,0,0,0
1,201392386,2170660915,57029,36895,2024-10-04 19:42:52,0,0,0,0,0,0
1,201392386,2170660915,48796,36895,2024-10-04 19:42:52,0,0,0,0,0,0
1,201392386,2170660915,0,0,2024-10-04 19:42:52,0,0,0,0,0,0
1,201392386,2170660915,37534,36895,2024-10-04 19:42:52,0,0,0,0,0,0
1,201392386,1145490691,44201,47873,2024-10-04 19:42:53,0,0,0,0,0,0
1,201392386,2170660915,57029,36895,2024-10-04 19:42:53,0,0,0,0,0,0
1,201392386,2170660915,48796,36895,2024-10-04 19:42:53,0,0,0,0,0,0
1,201392386,2170660915,0,0,2024-10-04 19:42:53,0,0,0,0,0,0
1,201392386,2170660915,37534,36895,2024-10-04 19:42:53,0,0,0,0,0,0
1,201392386,1145490691,44201,47873,2024-10-04 19:42:54,0,0,0,0,0,0
1,201392386,2170660915,57029,36895,2024-10-04 19:42:54,0,0,0,0,0,0
1,201392386,2170660915,48796,36895,2024-10-04 19:42:54,0,0,0,0,0,0
1,201392386,2170660915,0,0,2024-10-04 19:42:54,0,0,0,0,0,0
1,201392386,2170660915,37534,36895,2024-10-04 19:42:54,0,0,0,0,0,0
1,201392386,1145490691,44201,47873,2024-10-04 19:42:55,0,0,0,0,0,0
1,201392386,2170660915,57029,36895,2024-10-04 19:42:55,0,0,0,0,0,0
1,201392386,2170660915,48796,36895,2024-10-04 19:42:55,0,0,0,0,0,0
1,201392386,2170660915,0,0,2024-10-04 19:42:55,0,0,0,0,0,0
1,201392386,2170660915,37534,36895,2024-10-04 19:42:55,0,0,0,0,0,0
1,201392386,1145490691,44201,47873,2024-10-04 19:42:56,0,0,0,0,0,0
1,201392386,2170660915,57029,36895,2024-10-04 19:42:56,0,0,0,0,0,0
1,201392386,2170660915,48796,36895,2024-10-04 19:42:56,0,0,0,0,0,0
1,201392386,2170660915,0,0,2024-10-04 19:42:56,0,0,0,0,0,0
1,201392386,2170660915,37534,36895,2024-10-04 19:42:56,0,0,0,0,0,0
1,201392386,1145490691,44201,47873,2024-10-04 19:42:57,0,0,0,0,0,0
1,201392386,2170660915,57029,36895,2024-10-04 19:42:57,0,0,0,0,0,0
1,201392386,2170660915,48796,36895,2024-10-04 19:42:57,0,0,0,0,0,0
1,201392386,2170660915,0,0,2024-10-04 19:42:57,128,84,212,1,1,2
1,201392386,2170660915,37534,36895,2024-10-04 19:42:57,0,0,0,0,0,0
1,201392386,1145490691,44201,47873,2024-10-04 19:42:58,0,0,0,0,0,0
1,201392386,2170660915,57029,36895,2024-10-04 19:42:58,0,0,0,0,0,0
1,201392386,2170660915,48796,36895,2024-10-04 19:42:58,0,0,0,0,0,0
1,201392386,2170660915,0,0,2024-10-04 19:42:58,128,84,212,1,1,2
1,201392386,2170660915,37534,36895,2024-10-04 19:42:58,0,0,0,0,0,0
1,201392386,1145490691,44201,47873,2024-10-04 19:42:59,0,0,0,0,0,0
1,201392386,2170660915,57029,36895,2024-10-04 19:42:59,0,0,0,0,0,0
1,201392386,2170660915,48796,36895,2024-10-04 19:42:59,0,0,0,0,0,0
1,201392386,2170660915,0,0,2024-10-04 19:42:59,128,84,212,1,1,2
1,201392386,2170660915,37534,36895,2024-10-04 19:42:59,0,0,0,0,0,0
1,201392386,1145490691,44201,47873,2024-10-04 19:43:00,0,0,0,0,0,0
1,201392386,2170660915,57029,36895,2024-10-04 19:43:00,0,0,0,0,0,0
1,201392386,2170660915,48796,36895,2024-10-04 19:43:00,0,0,0,0,0,0
1,201392386,2170660915,0,0,2024-10-04 19:43:00,128,84,212,1,1,2
1,201392386,2170660915,37534,36895,2024-10-04 19:43:00,0,0,0,0,0,0
1,201392386,1145490691,44201,47873,2024-10-04 19:43:01,0,0,0,0,0,0
1,201392386,2170660915,57029,36895,2024-10-04 19:43:01,0,0,0,0,0,0
1,201392386,2170660915,48796,36895,2024-10-04 19:43:01,0,0,0,0,0,0
1,201392386,2170660915,0,0,2024-10-04 19:43:01,128,84,212,1,1,2
1,201392386,2170660915,37534,36895,2024-10-04 19:43:01,0,0,0,0,0,0
1,201392386,1145490691,44201,47873,2024-10-04 19:43:02,0,0,0,0,0,0
1,201392386,2170660915,57029,36895,2024-10-04 19:43:02,0,0,0,0,0,0
1,201392386,2170660915,48796,36895,2024-10-04 19:43:02,0,0,0,0,0,0
1,201392386,2170660915,0,0,2024-10-04 19:43:02,128,84,212,1,1,2
1,201392386,2170660915,37534,36895,2024-10-04 19:43:02,0,0,0,0,0,0
1,201392386,1145490691,44201,47873,2024-10-04 19:43:03,0,0,0,0,0,0
1,201392386,2170660915,57029,36895,2024-10-04 19:43:03,0,0,0,0,0,0
1,201392386,2170660915,48796,36895,2024-10-04 19:43:03,0,0,0,0,0,0
1,201392386,2170660915,0,0,2024-10-04 19:43:03,128,84,212,1,1,2
1,201392386,2170660915,37534,36895,2024-10-04 19:43:03,0,0,0,0,0,0
1,201392386,1145490691,44201,47873,2024-10-04 19:43:04,0,0,0,0,0,0
1,201392386,2170660915,57029,36895,2024-10-04 19:43:04,0,0,0,0,0,0
1,201392386,2170660915,48796,36895,2024-10-04 19:43:04,0,0,0,0,0,0
1,201392386,2170660915,0,0,2024-10-04 19:43:04,128,0,128,1,0,1
1,201392386,2170660915,37534,36895,2024-10-04 19:43:04,0,0,0,0,0,0
1,201392386,1145490691,44201,47873,2024-10-04 19:43:05,0,0,0,0,0,0
1,201392386,2170660915,57029,36895,2024-10-04 19:43:05,0,0,0,0,0,0
1,201392386,2170660915,48796,36895,2024-10-04 19:43:05,0,0,0,0,0,0
1,201392386,2170660915,0,0,2024-10-04 19:43:05,128,84,212,1,1,2
1,201392386,2170660915,37534,36895,2024-10-04 19:43:05,0,0,0,0,0,0
1,201392386,2170660915,57029,36895,2024-10-04 19:43:06,0,0,0,0,0,0
1,201392386,2170660915,48796,36895,2024-10-04 19:43:06,0,0,0,0,0,0
1,201392386,2170660915,0,0,2024-10-04 19:43:06,128,84,212,1,1,2
1,201392386,2170660915,37534,36895,2024-10-04 19:43:06,0,0,0,0,0,0
1,201392386,2170660915,57029,36895,2024-10-04 19:43:07,0,0,0,0,0,0
1,201392386,2170660915,48796,36895,2024-10-04 19:43:07,0,0,0,0,0,0
1,201392386,2170660915,0,0,2024-10-04 19:43:07,0,84,84,0,1,1
1,201392386,2170660915,37534,36895,2024-10-04 19:43:07,0,0,0,0,0,0
1,201392386,2170660915,57029,36895,2024-10-04 19:43:08,0,0,0,0,0,0
1,201392386,2170660915,48796,36895,2024-10-04 19:43:08,0,0,0,0,0,0
1,201392386,2170660915,0,0,2024-10-04 19:43:08,0,0,0,0,0,0
1,201392386,2170660915,37534,36895,2024-10-04 19:43:08,0,0,0,0,0,0
1,201392386,2170660915,57029,36895,2024-10-04 19:43:09,0,0,0,0,0,0
1,201392386,2170660915,2282,36895,2024-10-04 19:43:09,666,507,1173,6,6,12
1,201392386,2170660915,0,0,2024-10-04 19:43:09,0,0,0,0,0,0
1,201392386,2170660915,37534,36895,2024-10-04 19:43:09,0,0,0,0,0,0
1,201392386,2170660915,57029,36895,2024-10-04 19:43:10,0,0,0,0,0,0
1,201392386,2170660915,2282,36895,2024-10-04 19:43:10,0,0,0,0,0,0
1,201392386,2170660915,0,0,2024-10-04 19:43:10,256,84,340,2,1,3
1,201392386,2170660915,37534,36895,2024-10-04 19:43:10,0,0,0,0,0,0
1,201392386,2170660915,57029,36895,2024-10-04 19:43:11,0,0,0,0,0,0
1,201392386,2170660915,2282,36895,2024-10-04 19:43:11,0,0,0,0,0,0
1,201392386,2170660915,0,0,2024-10-04 19:43:11,128,84,212,1,1,2
1,201392386,2170660915,37534,36895,2024-10-04 19:43:11,0,0,0,0,0,0
1,201392386,2170660915,57029,36895,2024-10-04 19:43:12,0,0,0,0,0,0
1,201392386,2170660915,2282,36895,2024-10-04 19:43:12,0,0,0,0,0,0
1,201392386,2170660915,0,0,2024-10-04 19:43:12,0,84,84,0,1,1
1,201392386,2170660915,37534,36895,2024-10-04 19:43:12,0,0,0,0,0,0
1,201392386,2170660915,57029,36895,2024-10-04 19:43:13,0,0,0,0,0,0
1,201392386,2170660915,2282,36895,2024-10-04 19:43:13,0,0,0,0,0,0
1,201392386,2170660915,0,0,2024-10-04 19:43:13,0,0,0,0,0,0
1,201392386,2170660915,37534,36895,2024-10-04 19:43:13,0,0,0,0,0,0
1,201392386,2170660915,57029,36895,2024-10-04 19:43:14,0,0,0,0,0,0
1,201392386,2170660915,2282,36895,2024-10-04 19:43:14,0,0,0,0,0,0
1,201392386,2170660915,0,0,2024-10-04 19:43:14,0,0,0,0,0,0
1,201392386,2170660915,37534,36895,2024-10-04 19:43:14,0,0,0,0,0,0
1,201392386,2170660915,57029,36895,2024-10-04 19:43:15,0,0,0,0,0,0
1,201392386,2170660915,2282,36895,2024-10-04 19:43:15,0,0,0,0,0,0
1,201392386,2170660915,0,0,2024-10-04 19:43:15,128,84,212,1,1,2
1,201392386,2170660915,37534,36895,2024-10-04 19:43:15,0,0,0,0,0,0
1,201392386,2170660915,57029,36895,2024-10-04 19:43:16,0,0,0,0,0,0
1,201392386,2170660915,2282,36895,2024-10-04 19:43:16,0,0,0,0,0,0
1,201392386,2170660915,0,0,2024-10-04 19:43:16,0,0,0,0,0,0
1,201392386,2170660915,37534,36895,2024-10-04 19:43:16,0,0,0,0,0,0
1,201392386,2170660915,57029,36895,2024-10-04 19:43:17,0,0,0,0,0,0
1,201392386,1145490689,24217,47873,2024-10-04 19:43:17,4176,53863,58039,33,45,78
1,201392386,2170660915,2282,36895,2024-10-04 19:43:17,0,0,0,0,0,0
1,201392386,2170660915,0,0,2024-10-04 19:43:17,256,168,424,2,2,4
1,201392386,2170660915,37534,36895,2024-10-04 19:43:17,0,0,0,0,0,0
1,201392386,2170660915,57029,36895,2024-10-04 19:43:18,0,0,0,0,0,0
1,201392386,1145490689,24217,47873,2024-10-04 19:43:18,1536,39184,40720,15,25,40
1,201392386,2170660915,2282,36895,2024-10-04 19:43:18,0,0,0,0,0,0
1,201392386,2170660915,0,0,2024-10-04 19:43:18,0,0,0,0,0,0
1,201392386,2170660915,37534,36895,2024-10-04 19:43:18,0,0,0,0,0,0
1,201392386,2170660915,57029,36895,2024-10-04 19:43:19,0,0,0,0,0,0
1,201392386,1145490689,24217,47873,2024-10-04 19:43:19,0,0,0,0,0,0
1,201392386,2170660915,2282,36895,2024-10-04 19:43:19,0,0,0,0,0,0
1,201392386,2170660915,0,0,2024-10-04 19:43:19,0,0,0,0,0,0
1,201392386,2170660915,37534,36895,2024-10-04 19:43:19,0,0,0,0,0,0
1,201392386,2170660915,57029,36895,2024-10-04 19:43:20,0,0,0,0,0,0
1,201392386,1145490689,24217,47873,2024-10-04 19:43:20,0,0,0,0,0,0
1,201392386,2170660915,2282,36895,2024-10-04 19:43:20,0,0,0,0,0,0
1,201392386,2170660915,0,0,2024-10-04 19:43:20,0,0,0,0,0,0
1,201392386,2170660915,37534,36895,2024-10-04 19:43:20,0,0,0,0,0,0
1,201392386,2170660915,57029,36895,2024-10-04 19:43:21,0,0,0,0,0,0
1,201392386,1145490689,24217,47873,2024-10-04 19:43:21,0,0,0,0,0,0
1,201392386,2170660915,2282,36895,2024-10-04 19:43:21,0,0,0,0,0,0
1,201392386,2170660915,0,0,2024-10-04 19:43:21,0,0,0,0,0,0
1,201392386,2170660915,37534,36895,2024-10-04 19:43:21,0,0,0,0,0,0
1,201392386,2170660915,57029,36895,2024-10-04 19:43:22,0,0,0,0,0,0
1,201392386,1145490689,24217,47873,2024-10-04 19:43:22,0,0,0,0,0,0
1,201392386,2170660915,2282,36895,2024-10-04 19:43:22,0,0,0,0,0,0
1,201392386,2170660915,0,0,2024-10-04 19:43:22,0,0,0,0,0,0
1,201392386,2170660915,37534,36895,2024-10-04 19:43:22,0,0,0,0,0,0
1,201392386,2170660915,57029,36895,2024-10-04 19:43:23,0,0,0,0,0,0
1,201392386,1145490689,24217,47873,2024-10-04 19:43:23,0,0,0,0,0,0
1,201392386,2170660915,2282,36895,2024-10-04 19:43:23,0,0,0,0,0,0
1,201392386,2170660915,0,0,2024-10-04 19:43:23,0,0,0,0,0,0
1,201392386,2170660915,37534,36895,2024-10-04 19:43:23,0,0,0,0,0,0
1,201392386,2170660915,57029,36895,2024-10-04 19:43:24,0,0,0,0,0,0
1,201392386,1145490689,24217,47873,2024-10-04 19:43:24,0,0,0,0,0,0
1,201392386,2170660915,2282,36895,2024-10-04 19:43:24,0,0,0,0,0,0
1,201392386,2170660915,0,0,2024-10-04 19:43:24,0,0,0,0,0,0
1,201392386,2170660915,37534,36895,2024-10-04 19:43:24,0,0,0,0,0,0
1,201392386,2170660915,57029,36895,2024-10-04 19:43:25,0,0,0,0,0,0
1,201392386,1145490689,24217,47873,2024-10-04 19:43:25,1032,10323,11355,10,10,20
1,201392386,2170660915,2282,36895,2024-10-04 19:43:25,0,0,0,0,0,0
1,201392386,2170660915,0,0,2024-10-04 19:43:25,0,0,0,0,0,0
1,201392386,2170660915,37534,36895,2024-10-04 19:43:25,0,0,0,0,0,0
1,201392386,2170660915,57029,36895,2024-10-04 19:43:26,0,0,0,0,0,0
1,201392386,1145490689,24217,47873,2024-10-04 19:43:26,0,0,0,0,0,0
1,201392386,2170660915,2282,36895,2024-10-04 19:43:26,0,0,0,0,0,0
1,201392386,2170660915,0,0,2024-10-04 19:43:26,0,0,0,0,0,0
1,201392386,2170660915,37534,36895,2024-10-04 19:43:26,0,0,0,0,0,0
1,201392386,2170660915,57029,36895,2024-10-04 19:43:27,0,0,0,0,0,0
1,201392386,1145490689,24217,47873,2024-10-04 19:43:27,0,0,0,0,0,0
1,201392386,2170660915,2282,36895,2024-10-04 19:43:27,0,0,0,0,0,0
1,201392386,2170660915,0,0,2024-10-04 19:43:27,0,0,0,0,0,0
1,201392386,2170660915,37534,36895,2024-10-04 19:43:27,0,0,0,0,0,0
1,201392386,2170660915,57029,36895,2024-10-04 19:43:28,0,0,0,0,0,0
1,201392386,1145490689,24217,47873,2024-10-04 19:43:28,0,0,0,0,0,0
1,201392386,2170660915,2282,36895,2024-10-04 19:43:28,0,0,0,0,0,0
1,201392386,2170660915,0,0,2024-10-04 19:43:28,128,0,128,1,0,1
1,201392386,2170660915,37534,36895,2024-10-04 19:43:28,0,0,0,0,0,0
1,201392386,2170660915,57029,36895,2024-10-04 19:43:29,0,0,0,0,0,0
1,201392386,1145490689,24217,47873,2024-10-04 19:43:29,0,0,0,0,0,0
1,201392386,2170660915,2282,36895,2024-10-04 19:43:29,0,0,0,0,0,0
1,201392386,2170660915,0,0,2024-10-04 19:43:29,128,84,212,1,1,2
1,201392386,2170660915,37534,36895,2024-10-04 19:43:29,0,0,0,0,0,0
1,201392386,2170660915,57029,36895,2024-10-04 19:43:30,0,0,0,0,0,0
1,201392386,1145490689,24217,47873,2024-10-04 19:43:30,0,0,0,0,0,0
1,201392386,2170660915,2282,36895,2024-10-04 19:43:30,0,0,0,0,0,0
1,201392386,2170660915,0,0,2024-10-04 19:43:30,128,84,212,1,1,2
1,201392386,2170660915,37534,36895,2024-10-04 19:43:30,0,0,0,0,0,0
1,201392386,2170660915,57029,36895,2024-10-04 19:43:31,0,0,0,0,0,0
1,201392386,1145490689,24217,47873,2024-10-04 19:43:31,0,0,0,0,0,0
1,201392386,2170660915,2282,36895,2024-10-04 19:43:31,0,0,0,0,0,0
1,201392386,2170660915,0,0,2024-10-04 19:43:31,128,84,212,1,1,2
1,201392386,2170660915,37534,36895,2024-10-04 19:43:31,0,0,0,0,0,0
1,201392386,2170660915,57029,36895,2024-10-04 19:43:32,0,0,0,0,0,0
1,201392386,1145490689,24217,47873,2024-10-04 19:43:32,0,0,0,0,0,0
1,201392386,2170660915,2282,36895,2024-10-04 19:43:32,0,0,0,0,0,0
1,201392386,2170660915,0,0,2024-10-04 19:43:32,128,84,212,1,1,2
1,201392386,2170660915,37534,36895,2024-10-04 19:43:32,0,0,0,0,0,0
1,201392386,2170660915,57029,36895,2024-10-04 19:43:33,0,0,0,0,0,0
1,201392386,1145490689,24217,47873,2024-10-04 19:43:33,0,0,0,0,0,0
1,201392386,2170660915,2282,36895,2024-10-04 19:43:33,0,0,0,0,0,0
1,201392386,2170660915,0,0,2024-10-04 19:43:33,128,84,212,1,1,2
1,201392386,2170660915,37534,36895,2024-10-04 19:43:33,0,0,0,0,0,0
1,201392386,2170660915,57029,36895,2024-10-04 19:43:34,0,0,0,0,0,0
1,201392386,1145490689,24217,47873,2024-10-04 19:43:34,0,0,0,0,0,0
1,201392386,2170660915,2282,36895,2024-10-04 19:43:34,0,0,0,0,0,0
1,201392386,2170660915,0,0,2024-10-04 19:43:34,128,84,212,1,1,2
1,201392386,2170660915,37534,36895,2024-10-04 19:43:34,0,0,0,0,0,0
1,201392386,2170660915,57029,36895,2024-10-04 19:43:35,0,0,0,0,0,0
1,201392386,1145490689,24217,47873,2024-10-04 19:43:35,0,0,0,0,0,0
1,201392386,2170660915,2282,36895,2024-10-04 19:43:35,0,0,0,0,0,0
1,201392386,2170660915,0,0,2024-10-04 19:43:35,128,84,212,1,1,2
1,201392386,2170660915,37534,36895,2024-10-04 19:43:35,0,0,0,0,0,0
1,201392386,2170660915,57029,36895,2024-10-04 19:43:36,0,0,0,0,0,0
1,201392386,2170660915,2282,36895,2024-10-04 19:43:36,0,0,0,0,0,0
1,201392386,2170660915,0,0,2024-10-04 19:43:36,0,84,84,0,1,1
1,201392386,2170660915,37534,36895,2024-10-04 19:43:36,0,0,0,0,0,0
1,201392386,2170660915,57029,36895,2024-10-04 19:43:37,0,0,0,0,0,0
1,201392386,2170660915,2282,36895,2024-10-04 19:43:37,0,0,0,0,0,0
1,201392386,2170660915,0,0,2024-10-04 19:43:37,256,84,340,2,1,3
1,201392386,2170660915,37534,36895,2024-10-04 19:43:37,0,0,0,0,0,0
1,201392386,2170660915,57029,36895,2024-10-04 19:43:38,0,0,0,0,0,0
1,201392386,2170660915,0,0,2024-10-04 19:43:38,0,84,84,0,1,1
1,201392386,2170660915,37534,36895,2024-10-04 19:43:38,0,0,0,0,0,0
1,201392386,2170660915,55517,36895,2024-10-04 19:43:39,666,507,1173,6,6,12
1,201392386,2170660915,57029,36895,2024-10-04 19:43:39,0,0,0,0,0,0
1,201392386,2170660915,0,0,2024-10-04 19:43:39,0,0,0,0,0,0
1,201392386,2170660915,37534,36895,2024-10-04 19:43:39,0,0,0,0,0,0
1,201392386,2170660915,55517,36895,2024-10-04 19:43:40,0,0,0,0,0,0
1,201392386,2170660915,57029,36895,2024-10-04 19:43:40,0,0,0,0,0,0
1,201392386,2170660915,0,0,2024-10-04 19:43:40,0,0,0,0,0,0
1,201392386,2170660915,37534,36895,2024-10-04 19:43:40,0,0,0,0,0,0
1,201392386,2170660915,55517,36895,2024-10-04 19:43:41,0,0,0,0,0,0
1,201392386,2170660915,57029,36895,2024-10-04 19:43:41,0,0,0,0,0,0
1,201392386,2170660915,0,0,2024-10-04 19:43:41,128,84,212,1,1,2
1,201392386,2170660915,37534,36895,2024-10-04 19:43:41,0,0,0,0,0,0
1,201392386,2170660915,55517,36895,2024-10-04 19:43:42,0,0,0,0,0,0
1,201392386,2170660915,57029,36895,2024-10-04 19:43:42,0,0,0,0,0,0
1,201392386,2170660915,0,0,2024-10-04 19:43:42,256,84,340,2,1,3
1,201392386,2170660915,37534,36895,2024-10-04 19:43:42,0,0,0,0,0,0
1,201392386,2170660915,55517,36895,2024-10-04 19:43:43,0,0,0,0,0,0
1,201392386,2170660915,57029,36895,2024-10-04 19:43:43,0,0,0,0,0,0
1,201392386,2170660915,0,0,2024-10-04 19:43:43,0,0,0,0,0,0
1,201392386,2170660915,37534,36895,2024-10-04 19:43:43,0,0,0,0,0,0
1,201392386,2170660915,55517,36895,2024-10-04 19:43:44,0,0,0,0,0,0
1,201392386,2170660915,57029,36895,2024-10-04 19:43:44,0,0,0,0,0,0
1,201392386,2170660915,0,0,2024-10-04 19:43:44,0,84,84,0,1,1
1,201392386,2170660915,37534,36895,2024-10-04 19:43:44,0,0,0,0,0,0
1,201392386,2170660915,55517,36895,2024-10-04 19:43:45,0,0,0,0,0,0
1,201392386,2170660915,57029,36895,2024-10-04 19:43:45,0,0,0,0,0,0
1,201392386,2170660915,0,0,2024-10-04 19:43:45,0,0,0,0,0,0
1,201392386,2170660915,37534,36895,2024-10-04 19:43:45,0,0,0,0,0,0
1,201392386,2170660915,55517,36895,2024-10-04 19:43:46,0,0,0,0,0,0
1,201392386,2170660915,57029,36895,2024-10-04 19:43:46,0,0,0,0,0,0
1,201392386,2170660915,0,0,2024-10-04 19:43:46,0,0,0,0,0,0
1,201392386,2170660915,37534,36895,2024-10-04 19:43:46,0,0,0,0,0,0
1,201392386,2170660915,55517,36895,2024-10-04 19:43:47,0,0,0,0,0,0
1,201392386,2170660915,57029,36895,2024-10-04 19:43:47,0,0,0,0,0,0
1,201392386,2170660915,0,0,2024-10-04 19:43:47,256,168,424,2,2,4
1,201392386,2170660915,37534,36895,2024-10-04 19:43:47,0,0,0,0,0,0
1,201392386,2170660915,55517,36895,2024-10-04 19:43:48,0,0,0,0,0,0
1,201392386,2170660915,57029,36895,2024-10-04 19:43:48,0,0,0,0,0,0
1,201392386,1145490691,48292,47873,2024-10-04 19:43:48,4000,66089,70089,30,51,81
1,201392386,2170660915,0,0,2024-10-04 19:43:48,128,84,212,1,1,2
1,201392386,2170660915,37534,36895,2024-10-04 19:43:48,0,0,0,0,0,0
1,201392386,2170660915,55517,36895,2024-10-04 19:43:49,0,0,0,0,0,0
1,201392386,2170660915,57029,36895,2024-10-04 19:43:49,0,0,0,0,0,0
1,201392386,1145490691,48292,47873,2024-10-04 19:43:49,0,0,0,0,0,0
1,201392386,2170660915,0,0,2024-10-04 19:43:49,0,0,0,0,0,0
1,201392386,2170660915,37534,36895,2024-10-04 19:43:49,0,0,0,0,0,0
1,201392386,2170660915,55517,36895,2024-10-04 19:43:50,0,0,0,0,0,0
1,201392386,2170660915,57029,36895,2024-10-04 19:43:50,0,0,0,0,0,0
1,201392386,1145490691,48292,47873,2024-10-04 19:43:50,0,0,0,0,0,0
1,201392386,2170660915,0,0,2024-10-04 19:43:50,0,0,0,0,0,0
1,201392386,2170660915,37534,36895,2024-10-04 19:43:50,0,0,0,0,0,0
1,201392386,2170660915,55517,36895,2024-10-04 19:43:51,0,0,0,0,0,0
1,201392386,2170660915,57029,36895,2024-10-04 19:43:51,0,0,0,0,0,0
1,201392386,1145490691,48292,47873,2024-10-04 19:43:51,0,0,0,0,0,0
1,201392386,2170660915,0,0,2024-10-04 19:43:51,0,0,0,0,0,0
1,201392386,2170660915,37534,36895,2024-10-04 19:43:51,0,0,0,0,0,0
1,201392386,2170660915,55517,36895,2024-10-04 19:43:52,0,0,0,0,0,0
1,201392386,2170660915,57029,36895,2024-10-04 19:43:52,0,0,0,0,0,0
1,201392386,1145490691,48292,47873,2024-10-04 19:43:52,0,0,0,0,0,0
1,201392386,2170660915,0,0,2024-10-04 19:43:52,0,0,0,0,0,0
1,201392386,2170660915,37534,36895,2024-10-04 19:43:52,0,0,0,0,0,0
1,201392386,2170660915,55517,36895,2024-10-04 19:43:53,0,0,0,0,0,0
1,201392386,2170660915,57029,36895,2024-10-04 19:43:53,0,0,0,0,0,0
1,201392386,1145490691,48292,47873,2024-10-04 19:43:53,0,0,0,0,0,0
1,201392386,2170660915,0,0,2024-10-04 19:43:53,0,0,0,0,0,0
1,201392386,2170660915,37534,36895,2024-10-04 19:43:53,0,0,0,0,0,0
1,201392386,2170660915,55517,36895,2024-10-04 19:43:54,0,0,0,0,0,0
1,201392386,2170660915,57029,36895,2024-10-04 19:43:54,0,0,0,0,0,0
1,201392386,1145490691,48292,47873,2024-10-04 19:43:54,0,0,0,0,0,0
1,201392386,2170660915,0,0,2024-10-04 19:43:54,0,0,0,0,0,0
1,201392386,2170660915,37534,36895,2024-10-04 19:43:54,0,0,0,0,0,0
1,201392386,2170660915,55517,36895,2024-10-04 19:43:55,0,0,0,0,0,0
1,201392386,2170660915,57029,36895,2024-10-04 19:43:55,0,0,0,0,0,0
1,201392386,1145490691,48292,47873,2024-10-04 19:43:55,0,0,0,0,0,0
1,201392386,2170660915,0,0,2024-10-04 19:43:55,0,0,0,0,0,0
1,201392386,2170660915,37534,36895,2024-10-04 19:43:55,0,0,0,0,0,0
1,201392386,2170660915,55517,36895,2024-10-04 19:43:56,0,0,0,0,0,0
1,201392386,2170660915,57029,36895,2024-10-04 19:43:56,0,0,0,0,0,0
1,201392386,1145490691,48292,47873,2024-10-04 19:43:56,2564,47473,50037,24,34,58
1,201392386,2170660915,0,0,2024-10-04 19:43:56,0,0,0,0,0,0
1,201392386,2170660915,37534,36895,2024-10-04 19:43:56,0,0,0,0,0,0
1,201392386,2170660915,55517,36895,2024-10-04 19:43:57,0,0,0,0,0,0
1,201392386,2170660915,57029,36895,2024-10-04 19:43:57,0,0,0,0,0,0
1,201392386,1145490691,48292,47873,2024-10-04 19:43:57,0,0,0,0,0,0
1,201392386,2170660915,0,0,2024-10-04 19:43:57,0,0,0,0,0,0
1,201392386,2170660915,37534,36895,2024-10-04 19:43:57,0,0,0,0,0,0
1,201392386,2170660915,55517,36895,2024-10-04 19:43:58,0,0,0,0,0,0
1,201392386,2170660915,57029,36895,2024-10-04 19:43:58,0,0,0,0,0,0
1,201392386,1145490691,48292,47873,2024-10-04 19:43:58,0,0,0,0,0,0
1,201392386,2170660915,0,0,2024-10-04 19:43:58,128,0,128,1,0,1
1,201392386,2170660915,37534,36895,2024-10-04 19:43:58,0,0,0,0,0,0
1,201392386,2170660915,55517,36895,2024-10-04 19:43:59,0,0,0,0,0,0
1,201392386,2170660915,57029,36895,2024-10-04 19:43:59,0,0,0,0,0,0
1,201392386,1145490691,48292,47873,2024-10-04 19:43:59,0,0,0,0,0,0
1,201392386,2170660915,0,0,2024-10-04 19:43:59,128,84,212,1,1,2
1,201392386,2170660915,37534,36895,2024-10-04 19:43:59,0,0,0,0,0,0
1,201392386,2170660915,55517,36895,2024-10-04 19:44:00,0,0,0,0,0,0
1,201392386,2170660915,57029,36895,2024-10-04 19:44:00,0,0,0,0,0,0
1,201392386,1145490691,48292,47873,2024-10-04 19:44:00,0,0,0,0,0,0
1,201392386,2170660915,0,0,2024-10-04 19:44:00,128,84,212,1,1,2
1,201392386,2170660915,37534,36895,2024-10-04 19:44:00,0,0,0,0,0,0
1,201392386,2170660915,55517,36895,2024-10-04 19:44:01,0,0,0,0,0,0
1,201392386,2170660915,57029,36895,2024-10-04 19:44:01,0,0,0,0,0,0
1,201392386,1145490691,48292,47873,2024-10-04 19:44:01,0,0,0,0,0,0
1,201392386,2170660915,0,0,2024-10-04 19:44:01,128,84,212,1,1,2
1,201392386,2170660915,37534,36895,2024-10-04 19:44:01,0,0,0,0,0,0
1,201392386,2170660915,55517,36895,2024-10-04 19:44:02,0,0,0,0,0,0
1,201392386,2170660915,57029,36895,2024-10-04 19:44:02,0,0,0,0,0,0
1,201392386,1145490691,48292,47873,2024-10-04 19:44:02,0,0,0,0,0,0
1,201392386,2170660915,0,0,2024-10-04 19:44:02,128,84,212,1,1,2
1,201392386,2170660915,37534,36895,2024-10-04 19:44:02,0,0,0,0,0,0
1,201392386,2170660915,55517,36895,2024-10-04 19:44:03,0,0,0,0,0,0
1,201392386,2170660915,57029,36895,2024-10-04 19:44:03,0,0,0,0,0,0
1,201392386,1145490691,48292,47873,2024-10-04 19:44:03,0,0,0,0,0,0
1,201392386,2170660915,0,0,2024-10-04 19:44:03,128,84,212,1,1,2
1,201392386,2170660915,37534,36895,2024-10-04 19:44:03,0,0,0,0,0,0
1,201392386,2170660915,55517,36895,2024-10-04 19:44:04,0,0,0,0,0,0
1,201392386,2170660915,57029,36895,2024-10-04 19:44:04,0,0,0,0,0,0
1,201392386,1145490691,48292,47873,2024-10-04 19:44:04,0,0,0,0,0,0
1,201392386,2170660915,0,0,2024-10-04 19:44:04,128,84,212,1,1,2
1,201392386,2170660915,37534,36895,2024-10-04 19:44:04,0,0,0,0,0,0
1,201392386,2170660915,55517,36895,2024-10-04 19:44:05,0,0,0,0,0,0
1,201392386,2170660915,57029,36895,2024-10-04 19:44:05,0,0,0,0,0,0
1,201392386,1145490691,48292,47873,2024-10-04 19:44:05,0,0,0,0,0,0
1,201392386,2170660915,0,0,2024-10-04 19:44:05,128,84,212,1,1,2
1,201392386,2170660915,37534,36895,2024-10-04 19:44:05,0,0,0,0,0,0
1,201392386,2170660915,55517,36895,2024-10-04 19:44:06,0,0,0,0,0,0
1,201392386,2170660915,57029,36895,2024-10-04 19:44:06,0,0,0,0,0,0
1,201392386,1145490691,48292,47873,2024-10-04 19:44:06,0,0,0,0,0,0
1,201392386,2170660915,0,0,2024-10-04 19:44:06,0,84,84,0,1,1
1,201392386,2170660915,37534,36895,2024-10-04 19:44:06,0,0,0,0,0,0
1,201392386,2170660915,55517,36895,2024-10-04 19:44:07,0,0,0,0,0,0
1,201392386,2170660915,57029,36895,2024-10-04 19:44:07,0,0,0,0,0,0
1,201392386,2170660915,0,0,2024-10-04 19:44:07,256,84,340,2,1,3
1,201392386,2170660915,37534,36895,2024-10-04 19:44:07,0,0,0,0,0,0
1,201392386,2170660915,55517,36895,2024-10-04 19:44:08,0,0,0,0,0,0
1,201392386,2170660915,57029,36895,2024-10-04 19:44:08,0,0,0,0,0,0
1,201392386,2170660915,0,0,2024-10-04 19:44:08,0,84,84,0,1,1
1,201392386,2170660915,37534,36895,2024-10-04 19:44:08,0,0,0,0,0,0
1,201392386,2170660915,57029,36895,2024-10-04 19:44:09,0,0,0,0,0,0
1,201392386,2170660915,0,0,2024-10-04 19:44:09,0,0,0,0,0,0
1,201392386,2170660915,37534,36895,2024-10-04 19:44:09,0,0,0,0,0,0
1,201392386,2170660915,57029,36895,2024-10-04 19:44:10,0,0,0,0,0,0
1,201392386,2170660915,0,0,2024-10-04 19:44:10,0,0,0,0,0,0
1,201392386,2170660915,37534,36895,2024-10-04 19:44:10,0,0,0,0,0,0
1,201392386,2170660915,57029,36895,2024-10-04 19:44:11,0,0,0,0,0,0
1,201392386,2170660915,31922,36895,2024-10-04 19:44:11,666,507,1173,6,6,12
1,201392386,2170660915,0,0,2024-10-04 19:44:11,128,0,128,1,0,1
1,201392386,2170660915,37534,36895,2024-10-04 19:44:11,0,0,0,0,0,0
1,201392386,2170660915,57029,36895,2024-10-04 19:44:12,0,0,0,0,0,0
1,201392386,2170660915,31922,36895,2024-10-04 19:44:12,0,0,0,0,0,0
1,201392386,2170660915,0,0,2024-10-04 19:44:12,128,84,212,1,1,2
1,201392386,2170660915,37534,36895,2024-10-04 19:44:12,0,0,0,0,0,0
1,201392386,2170660915,57029,36895,2024-10-04 19:44:13,0,0,0,0,0,0
1,201392386,2170660915,31922,36895,2024-10-04 19:44:13,0,0,0,0,0,0
1,201392386,2170660915,0,0,2024-10-04 19:44:13,128,84,212,1,1,2
1,201392386,2170660915,37534,36895,2024-10-04 19:44:13,0,0,0,0,0,0
1,201392386,2170660915,57029,36895,2024-10-04 19:44:14,0,0,0,0,0,0
1,201392386,2170660915,31922,36895,2024-10-04 19:44:14,0,0,0,0,0,0
1,201392386,2170660915,0,0,2024-10-04 19:44:14,0,84,84,0,1,1
1,201392386,2170660915,37534,36895,2024-10-04 19:44:14,0,0,0,0,0,0
1,201392386,2170660915,57029,36895,2024-10-04 19:44:15,0,0,0,0,0,0
1,201392386,2170660915,31922,36895,2024-10-04 19:44:15,0,0,0,0,0,0
1,201392386,2170660915,0,0,2024-10-04 19:44:15,0,0,0,0,0,0
1,201392386,2170660915,37534,36895,2024-10-04 19:44:15,0,0,0,0,0,0
1,201392386,2170660915,57029,36895,2024-10-04 19:44:16,0,0,0,0,0,0
1,201392386,2170660915,31922,36895,2024-10-04 19:44:16,0,0,0,0,0,0
1,201392386,2170660915,0,0,2024-10-04 19:44:16,128,0,128,1,0,1
1,201392386,2170660915,37534,36895,2024-10-04 19:44:16,0,0,0,0,0,0
1,201392386,2170660915,57029,36895,2024-10-04 19:44:17,0,0,0,0,0,0
1,201392386,2170660915,31922,36895,2024-10-04 19:44:17,0,0,0,0,0,0
1,201392386,2170660915,0,0,2024-10-04 19:44:17,128,84,212,1,1,2
1,201392386,2170660915,37534,36895,2024-10-04 19:44:17,0,0,0,0,0,0
1,201392386,2170660915,57029,36895,2024-10-04 19:44:18,0,0,0,0,0,0
1,201392386,2170660915,31922,36895,2024-10-04 19:44:18,0,0,0,0,0,0
1,201392386,2170660915,0,0,2024-10-04 19:44:18,128,84,212,1,1,2
1,201392386,2170660915,37534,36895,2024-10-04 19:44:18,0,0,0,0,0,0
1,201392386,2170660915,57029,36895,2024-10-04 19:44:19,0,0,0,0,0,0
1,201392386,2170660915,31922,36895,2024-10-04 19:44:19,0,0,0,0,0,0
1,201392386,1145490691,19166,47873,2024-10-04 19:44:19,3420,48257,51677,26,42,68
1,201392386,2170660915,0,0,2024-10-04 19:44:19,0,84,84,0,1,1
1,201392386,2170660915,37534,36895,2024-10-04 19:44:19,0,0,0,0,0,0
1,201392386,2170660915,57029,36895,2024-10-04 19:44:20,0,0,0,0,0,0
1,201392386,2170660915,31922,36895,2024-10-04 19:44:20,0,0,0,0,0,0
1,201392386,1145490691,19166,47873,2024-10-04 19:44:20,2376,53611,55987,23,35,58
1,201392386,2170660915,0,0,2024-10-04 19:44:20,0,0,0,0,0,0
1,201392386,2170660915,37534,36895,2024-10-04 19:44:20,0,0,0,0,0,0
1,201392386,2170660915,57029,36895,2024-10-04 19:44:21,0,0,0,0,0,0
1,201392386,2170660915,31922,36895,2024-10-04 19:44:21,0,0,0,0,0,0
1,201392386,1145490691,19166,47873,2024-10-04 19:44:21,0,0,0,0,0,0
1,201392386,2170660915,0,0,2024-10-04 19:44:21,0,0,0,0,0,0
1,201392386,2170660915,37534,36895,2024-10-04 19:44:21,0,0,0,0,0,0
1,201392386,2170660915,57029,36895,2024-10-04 19:44:22,0,0,0,0,0,0
1,201392386,2170660915,31922,36895,2024-10-04 19:44:22,0,0,0,0,0,0
1,201392386,1145490691,19166,47873,2024-10-04 19:44:22,0,0,0,0,0,0
1,201392386,2170660915,0,0,2024-10-04 19:44:22,0,0,0,0,0,0
1,201392386,2170660915,37534,36895,2024-10-04 19:44:22,0,0,0,0,0,0
1,201392386,2170660915,57029,36895,2024-10-04 19:44:23,0,0,0,0,0,0
1,201392386,2170660915,31922,36895,2024-10-04 19:44:23,0,0,0,0,0,0
1,201392386,1145490691,19166,47873,2024-10-04 19:44:23,0,0,0,0,0,0
1,201392386,2170660915,0,0,2024-10-04 19:44:23,0,0,0,0,0,0
1,201392386,2170660915,37534,36895,2024-10-04 19:44:23,0,0,0,0,0,0
1,201392386,2170660915,57029,36895,2024-10-04 19:44:24,0,0,0,0,0,0
1,201392386,2170660915,31922,36895,2024-10-04 19:44:24,0,0,0,0,0,0
1,201392386,1145490691,19166,47873,2024-10-04 19:44:24,0,0,0,0,0,0
1,201392386,2170660915,0,0,2024-10-04 19:44:24,0,0,0,0,0,0
1,201392386,2170660915,37534,36895,2024-10-04 19:44:24,0,0,0,0,0,0
1,201392386,2170660915,57029,36895,2024-10-04 19:44:25,0,0,0,0,0,0
1,201392386,2170660915,31922,36895,2024-10-04 19:44:25,0,0,0,0,0,0
1,201392386,1145490691,19166,47873,2024-10-04 19:44:25,0,0,0,0,0,0
1,201392386,2170660915,0,0,2024-10-04 19:44:25,0,0,0,0,0,0
1,201392386,2170660915,37534,36895,2024-10-04 19:44:25,0,0,0,0,0,0
1,201392386,2170660915,57029,36895,2024-10-04 19:44:26,0,0,0,0,0,0
1,201392386,2170660915,31922,36895,2024-10-04 19:44:26,0,0,0,0,0,0
1,201392386,1145490691,19166,47873,2024-10-04 19:44:26,0,0,0,0,0,0
1,201392386,2170660915,0,0,2024-10-04 19:44:26,0,0,0,0,0,0
1,201392386,2170660915,37534,36895,2024-10-04 19:44:26,0,0,0,0,0,0
1,201392386,2170660915,57029,36895,2024-10-04 19:44:27,0,0,0,0,0,0
1,201392386,2170660915,31922,36895,2024-10-04 19:44:27,0,0,0,0,0,0
1,201392386,1145490691,19166,47873,2024-10-04 19:44:27,516,1576,2092,5,4,9
1,201392386,2170660915,0,0,2024-10-04 19:44:27,0,0,0,0,0,0
1,201392386,2170660915,37534,36895,2024-10-04 19:44:27,0,0,0,0,0,0
1,201392386,2170660915,57029,36895,2024-10-04 19:44:28,0,0,0,0,0,0
1,201392386,2170660915,31922,36895,2024-10-04 19:44:28,0,0,0,0,0,0
1,201392386,1145490691,19166,47873,2024-10-04 19:44:28,0,0,0,0,0,0
1,201392386,2170660915,0,0,2024-10-04 19:44:28,0,0,0,0,0,0
1,201392386,2170660915,37534,36895,2024-10-04 19:44:28,0,0,0,0,0,0
1,201392386,2170660915,57029,36895,2024-10-04 19:44:29,0,0,0,0,0,0
1,201392386,2170660915,31922,36895,2024-10-04 19:44:29,0,0,0,0,0,0
1,201392386,1145490691,19166,47873,2024-10-04 19:44:29,0,0,0,0,0,0
1,201392386,2170660915,0,0,2024-10-04 19:44:29,0,0,0,0,0,0
1,201392386,2170660915,37534,36895,2024-10-04 19:44:29,0,0,0,0,0,0
1,201392386,2170660915,57029,36895,2024-10-04 19:44:30,0,0,0,0,0,0
1,201392386,2170660915,31922,36895,2024-10-04 19:44:30,0,0,0,0,0,0
1,201392386,1145490691,19166,47873,2024-10-04 19:44:30,0,0,0,0,0,0
1,201392386,2170660915,0,0,2024-10-04 19:44:30,0,0,0,0,0,0
1,201392386,2170660915,37534,36895,2024-10-04 19:44:30,0,0,0,0,0,0
1,201392386,2170660915,57029,36895,2024-10-04 19:44:31,0,0,0,0,0,0
1,201392386,2170660915,31922,36895,2024-10-04 19:44:31,0,0,0,0,0,0
1,201392386,1145490691,19166,47873,2024-10-04 19:44:31,0,0,0,0,0,0
1,201392386,2170660915,0,0,2024-10-04 19:44:31,128,84,212,1,1,2
1,201392386,2170660915,37534,36895,2024-10-04 19:44:31,0,0,0,0,0,0
1,201392386,2170660915,57029,36895,2024-10-04 19:44:32,0,0,0,0,0,0
1,201392386,2170660915,31922,36895,2024-10-04 19:44:32,0,0,0,0,0,0
1,201392386,1145490691,19166,47873,2024-10-04 19:44:32,0,0,0,0,0,0
1,201392386,2170660915,0,0,2024-10-04 19:44:32,128,84,212,1,1,2
1,201392386,2170660915,37534,36895,2024-10-04 19:44:32,0,0,0,0,0,0
1,201392386,2170660915,57029,36895,2024-10-04 19:44:33,0,0,0,0,0,0
1,201392386,2170660915,31922,36895,2024-10-04 19:44:33,0,0,0,0,0,0
1,201392386,1145490691,19166,47873,2024-10-04 19:44:33,0,0,0,0,0,0
1,201392386,2170660915,0,0,2024-10-04 19:44:33,128,84,212,1,1,2
1,201392386,2170660915,37534,36895,2024-10-04 19:44:33,0,0,0,0,0,0
1,201392386,2170660915,57029,36895,2024-10-04 19:44:34,0,0,0,0,0,0
1,201392386,2170660915,31922,36895,2024-10-04 19:44:34,0,0,0,0,0,0
1,201392386,1145490691,19166,47873,2024-10-04 19:44:34,0,0,0,0,0,0
1,201392386,2170660915,0,0,2024-10-04 19:44:34,128,84,212,1,1,2
1,201392386,2170660915,37534,36895,2024-10-04 19:44:34,0,0,0,0,0,0
1,201392386,2170660915,57029,36895,2024-10-04 19:44:35,0,0,0,0,0,0
1,201392386,2170660915,31922,36895,2024-10-04 19:44:35,0,0,0,0,0,0
1,201392386,1145490691,19166,47873,2024-10-04 19:44:35,0,0,0,0,0,0
1,201392386,2170660915,0,0,2024-10-04 19:44:35,128,84,212,1,1,2
1,201392386,2170660915,37534,36895,2024-10-04 19:44:35,0,0,0,0,0,0
1,201392386,2170660915,57029,36895,2024-10-04 19:44:36,0,0,0,0,0,0
1,201392386,2170660915,31922,36895,2024-10-04 19:44:36,0,0,0,0,0,0
1,201392386,1145490691,19166,47873,2024-10-04 19:44:36,0,0,0,0,0,0
1,201392386,2170660915,0,0,2024-10-04 19:44:36,128,84,212,1,1,2
1,201392386,2170660915,37534,36895,2024-10-04 19:44:36,0,0,0,0,0,0
1,201392386,2170660915,57029,36895,2024-10-04 19:44:37,0,0,0,0,0,0
1,201392386,2170660915,31922,36895,2024-10-04 19:44:37,0,0,0,0,0,0
1,201392386,1145490691,19166,47873,2024-10-04 19:44:37,0,0,0,0,0,0
1,201392386,2170660915,0,0,2024-10-04 19:44:37,128,84,212,1,1,2
1,201392386,2170660915,37534,36895,2024-10-04 19:44:37,0,0,0,0,0,0
1,201392386,2170660915,57029,36895,2024-10-04 19:44:38,0,0,0,0,0,0
1,201392386,2170660915,31922,36895,2024-10-04 19:44:38,0,0,0,0,0,0
1,201392386,2170660915,0,0,2024-10-04 19:44:38,128,84,212,1,1,2
1,201392386,2170660915,37534,36895,2024-10-04 19:44:38,0,0,0,0,0,0
1,201392386,2170660915,57029,36895,2024-10-04 19:44:39,0,0,0,0,0,0
1,201392386,2170660915,31922,36895,2024-10-04 19:44:39,0,0,0,0,0,0
1,201392386,2170660915,0,0,2024-10-04 19:44:39,128,84,212,1,1,2
1,201392386,2170660915,37534,36895,2024-10-04 19:44:39,0,0,0,0,0,0
1,201392386,2170660915,57029,36895,2024-10-04 19:44:40,0,0,0,0,0,0
1,201392386,2170660915,31922,36895,2024-10-04 19:44:40,0,0,0,0,0,0
1,201392386,2170660915,0,0,2024-10-04 19:44:40,128,84,212,1,1,2
1,201392386,2170660915,37534,36895,2024-10-04 19:44:40,0,0,0,0,0,0
1,201392386,2170660915,57029,36895,2024-10-04 19:44:41,0,0,0,0,0,0
1,201392386,2170660915,0,0,2024-10-04 19:44:41,0,0,0,0,0,0
1,201392386,2170660915,37534,36895,2024-10-04 19:44:41,0,0,0,0,0,0
1,201392386,2170660915,57029,36895,2024-10-04 19:44:42,0,0,0,0,0,0
1,201392386,2170660915,27841,36895,2024-10-04 19:44:42,666,507,1173,6,6,12
1,201392386,2170660915,0,0,2024-10-04 19:44:42,0,0,0,0,0,0
1,201392386,2170660915,37534,36895,2024-10-04 19:44:42,0,0,0,0,0,0
1,201392386,2170660915,57029,36895,2024-10-04 19:44:43,0,0,0,0,0,0
1,201392386,2170660915,27841,36895,2024-10-04 19:44:43,0,0,0,0,0,0
1,201392386,2170660915,0,0,2024-10-04 19:44:43,128,84,212,1,1,2
1,201392386,2170660915,37534,36895,2024-10-04 19:44:43,0,0,0,0,0,0
1,201392386,2170660915,57029,36895,2024-10-04 19:44:44,0,0,0,0,0,0
1,201392386,2170660915,27841,36895,2024-10-04 19:44:44,0,0,0,0,0,0
1,201392386,2170660915,0,0,2024-10-04 19:44:44,0,0,0,0,0,0
1,201392386,2170660915,37534,36895,2024-10-04 19:44:44,0,0,0,0,0,0
1,201392386,2170660915,57029,36895,2024-10-04 19:44:45,0,0,0,0,0,0
1,201392386,2170660915,27841,36895,2024-10-04 19:44:45,0,0,0,0,0,0
1,201392386,2170660915,0,0,2024-10-04 19:44:45,128,84,212,1,1,2
1,201392386,2170660915,37534,36895,2024-10-04 19:44:45,0,0,0,0,0,0
1,201392386,2170660915,57029,36895,2024-10-04 19:44:46,0,0,0,0,0,0
1,201392386,2170660915,27841,36895,2024-10-04 19:44:46,0,0,0,0,0,0
1,201392386,2170660915,0,0,2024-10-04 19:44:46,128,84,212,1,1,2
1,201392386,2170660915,37534,36895,2024-10-04 19:44:46,0,0,0,0,0,0
1,201392386,2170660915,57029,36895,2024-10-04 19:44:47,0,0,0,0,0,0
1,201392386,2170660915,27841,36895,2024-10-04 19:44:47,0,0,0,0,0,0
1,201392386,2170660915,0,0,2024-10-04 19:44:47,0,0,0,0,0,0
1,201392386,2170660915,37534,36895,2024-10-04 19:44:47,0,0,0,0,0,0
1,201392386,2170660915,57029,36895,2024-10-04 19:44:48,0,0,0,0,0,0
1,201392386,2170660915,27841,36895,2024-10-04 19:44:48,0,0,0,0,0,0
1,201392386,2170660915,0,0,2024-10-04 19:44:48,128,0,128,1,0,1
1,201392386,2170660915,37534,36895,2024-10-04 19:44:48,0,0,0,0,0,0
1,201392386,2170660915,57029,36895,2024-10-04 19:44:49,0,0,0,0,0,0
1,201392386,2170660915,27841,36895,2024-10-04 19:44:49,0,0,0,0,0,0
1,201392386,2170660915,0,0,2024-10-04 19:44:49,0,84,84,0,1,1
1,201392386,2170660915,37534,36895,2024-10-04 19:44:49,0,0,0,0,0,0
1,201392386,2170660915,57029,36895,2024-10-04 19:44:50,0,0,0,0,0,0
1,201392386,2170660915,27841,36895,2024-10-04 19:44:50,0,0,0,0,0,0
1,201392386,2170660915,0,0,2024-10-04 19:44:50,256,84,340,2,1,3
1,201392386,2170660915,37534,36895,2024-10-04 19:44:50,0,0,0,0,0,0
1,201392386,2170660915,57029,36895,2024-10-04 19:44:51,0,0,0,0,0,0
1,201392386,1145490692,37026,47873,2024-10-04 19:44:51,4356,60859,65215,35,48,83
1,201392386,2170660915,0,0,2024-10-04 19:44:51,0,84,84,0,1,1
1,201392386,2170660915,37534,36895,2024-10-04 19:44:51,0,0,0,0,0,0
1,201392386,2170660915,57029,36895,2024-10-04 19:44:52,0,0,0,0,0,0
1,201392386,1145490692,37026,47873,2024-10-04 19:44:52,0,0,0,0,0,0
1,201392386,2170660915,0,0,2024-10-04 19:44:52,0,0,0,0,0,0
1,201392386,2170660915,37534,36895,2024-10-04 19:44:52,0,0,0,0,0,0
1,201392386,2170660915,57029,36895,2024-10-04 19:44:53,0,0,0,0,0,0
1,201392386,1145490692,37026,47873,2024-10-04 19:44:53,0,0,0,0,0,0
1,201392386,2170660915,0,0,2024-10-04 19:44:53,0,0,0,0,0,0
1,201392386,2170660915,37534,36895,2024-10-04 19:44:53,0,0,0,0,0,0
1,201392386,2170660915,57029,36895,2024-10-04 19:44:54,0,0,0,0,0,0
1,201392386,1145490692,37026,47873,2024-10-04 19:44:54,0,0,0,0,0,0
1,201392386,2170660915,0,0,2024-10-04 19:44:54,0,0,0,0,0,0
1,201392386,2170660915,37534,36895,2024-10-04 19:44:54,0,0,0,0,0,0
1,201392386,2170660915,57029,36895,2024-10-04 19:44:55,0,0,0,0,0,0
1,201392386,1145490692,37026,47873,2024-10-04 19:44:55,0,0,0,0,0,0
1,201392386,2170660915,0,0,2024-10-04 19:44:55,0,0,0,0,0,0
1,201392386,2170660915,37534,36895,2024-10-04 19:44:55,0,0,0,0,0,0
1,201392386,2170660915,57029,36895,2024-10-04 19:44:56,0,0,0,0,0,0
1,201392386,1145490692,37026,47873,2024-10-04 19:44:56,0,0,0,0,0,0
1,201392386,2170660915,0,0,2024-10-04 19:44:56,0,0,0,0,0,0
1,201392386,2170660915,37534,36895,2024-10-04 19:44:56,0,0,0,0,0,0
1,201392386,2170660915,57029,36895,2024-10-04 19:44:57,0,0,0,0,0,0
1,201392386,1145490692,37026,47873,2024-10-04 19:44:57,1608,30099,31707,16,22,38
1,201392386,2170660915,0,0,2024-10-04 19:44:57,0,0,0,0,0,0
1,201392386,2170660915,37534,36895,2024-10-04 19:44:57,0,0,0,0,0,0
1,201392386,2170660915,57029,36895,2024-10-04 19:44:58,0,0,0,0,0,0
1,201392386,1145490692,37026,47873,2024-10-04 19:44:58,0,0,0,0,0,0
1,201392386,2170660915,0,0,2024-10-04 19:44:58,0,0,0,0,0,0
1,201392386,2170660915,37534,36895,2024-10-04 19:44:58,0,0,0,0,0,0
1,201392386,2170660915,57029,36895,2024-10-04 19:44:59,0,0,0,0,0,0
1,201392386,1145490692,37026,47873,2024-10-04 19:44:59,0,0,0,0,0,0
1,201392386,2170660915,0,0,2024-10-04 19:44:59,0,0,0,0,0,0
1,201392386,2170660915,37534,36895,2024-10-04 19:44:59,0,0,0,0,0,0
1,201392386,2170660915,57029,36895,2024-10-04 19:45:00,0,0,0,0,0,0
1,201392386,1145490692,37026,47873,2024-10-04 19:45:00,0,0,0,0,0,0
1,201392386,2170660915,0,0,2024-10-04 19:45:00,0,0,0,0,0,0
1,201392386,2170660915,37534,36895,2024-10-04 19:45:00,0,0,0,0,0,0
1,201392386,2170660915,57029,36895,2024-10-04 19:45:01,0,0,0,0,0,0
1,201392386,1145490692,37026,47873,2024-10-04 19:45:01,0,0,0,0,0,0
1,201392386,2170660915,0,0,2024-10-04 19:45:01,0,0,0,0,0,0
1,201392386,2170660915,37534,36895,2024-10-04 19:45:01,0,0,0,0,0,0
1,201392386,2170660915,57029,36895,2024-10-04 19:45:02,0,0,0,0,0,0
1,201392386,1145490692,37026,47873,2024-10-04 19:45:02,0,0,0,0,0,0
1,201392386,2170660915,0,0,2024-10-04 19:45:02,128,84,212,1,1,2
1,201392386,2170660915,37534,36895,2024-10-04 19:45:02,0,0,0,0,0,0
1,201392386,2170660915,57029,36895,2024-10-04 19:45:03,0,0,0,0,0,0
1,201392386,1145490692,37026,47873,2024-10-04 19:45:03,0,0,0,0,0,0
1,201392386,2170660915,0,0,2024-10-04 19:45:03,128,84,212,1,1,2
1,201392386,2170660915,37534,36895,2024-10-04 19:45:03,0,0,0,0,0,0
1,201392386,2170660915,57029,36895,2024-10-04 19:45:04,0,0,0,0,0,0
1,201392386,1145490692,37026,47873,2024-10-04 19:45:04,0,0,0,0,0,0
1,201392386,2170660915,0,0,2024-10-04 19:45:04,128,84,212,1,1,2
1,201392386,2170660915,37534,36895,2024-10-04 19:45:04,0,0,0,0,0,0
1,201392386,2170660915,57029,36895,2024-10-04 19:45:05,0,0,0,0,0,0
1,201392386,1145490692,37026,47873,2024-10-04 19:45:05,0,0,0,0,0,0
1,201392386,2170660915,0,0,2024-10-04 19:45:05,128,84,212,1,1,2
1,201392386,2170660915,37534,36895,2024-10-04 19:45:05,0,0,0,0,0,0
1,201392386,2170660915,57029,36895,2024-10-04 19:45:06,0,0,0,0,0,0
1,201392386,1145490692,37026,47873,2024-10-04 19:45:06,0,0,0,0,0,0
1,201392386,2170660915,0,0,2024-10-04 19:45:06,128,84,212,1,1,2
1,201392386,2170660915,37534,36895,2024-10-04 19:45:06,0,0,0,0,0,0
1,201392386,2170660915,57029,36895,2024-10-04 19:45:07,0,0,0,0,0,0
1,201392386,1145490692,37026,47873,2024-10-04 19:45:07,0,0,0,0,0,0
1,201392386,2170660915,0,0,2024-10-04 19:45:07,128,84,212,1,1,2
1,201392386,2170660915,37534,36895,2024-10-04 19:45:07,0,0,0,0,0,0
1,201392386,2170660915,57029,36895,2024-10-04 19:45:08,0,0,0,0,0,0
1,201392386,2170660915,0,0,2024-10-04 19:45:08,128,84,212,1,1,2
1,201392386,2170660915,37534,36895,2024-10-04 19:45:08,0,0,0,0,0,0
1,201392386,2170660915,57029,36895,2024-10-04 19:45:09,0,0,0,0,0,0
1,201392386,2170660915,0,0,2024-10-04 19:45:09,128,84,212,1,1,2
1,201392386,2170660915,37534,36895,2024-10-04 19:45:09,0,0,0,0,0,0
1,201392386,2170660915,57029,36895,2024-10-04 19:45:10,0,0,0,0,0,0
1,201392386,2170660915,0,0,2024-10-04 19:45:10,128,84,212,1,1,2
1,201392386,2170660915,37534,36895,2024-10-04 19:45:10,0,0,0,0,0,0
1,201392386,2170660915,57029,36895,2024-10-04 19:45:11,0,0,0,0,0,0
1,201392386,2170660915,0,0,2024-10-04 19:45:11,128,84,212,1,1,2
1,201392386,2170660915,37534,36895,2024-10-04 19:45:11,0,0,0,0,0,0
1,201392386,2170660915,57029,36895,2024-10-04 19:45:12,0,0,0,0,0,0
1,201392386,2170660915,0,0,2024-10-04 19:45:12,0,0,0,0,0,0
1,201392386,2170660915,37534,36895,2024-10-04 19:45:12,0,0,0,0,0,0
1,201392386,2170660915,57029,36895,2024-10-04 19:45:13,0,0,0,0,0,0
1,201392386,2170660915,0,0,2024-10-04 19:45:13,0,0,0,0,0,0
1,201392386,2170660915,37534,36895,2024-10-04 19:45:13,0,0,0,0,0,0
1,201392386,2170660915,57029,36895,2024-10-04 19:45:14,0,0,0,0,0,0
1,201392386,2170660915,62137,36895,2024-10-04 19:45:14,570,455,1025,5,5,10
1,201392386,2170660915,0,0,2024-10-04 19:45:14,128,0,128,1,0,1
1,201392386,2170660915,37534,36895,2024-10-04 19:45:14,0,0,0,0,0,0
1,201392386,2170660915,57029,36895,2024-10-04 19:45:15,0,0,0,0,0,0
1,201392386,2170660915,62137,36895,2024-10-04 19:45:15,0,0,0,0,0,0
1,201392386,2170660915,0,0,2024-10-04 19:45:15,128,168,296,1,2,3
1,201392386,2170660915,37534,36895,2024-10-04 19:45:15,0,0,0,0,0,0
1,201392386,2170660915,57029,36895,2024-10-04 19:45:16,0,0,0,0,0,0
1,201392386,2170660915,62137,36895,2024-10-04 19:45:16,0,0,0,0,0,0
1,201392386,2170660915,0,0,2024-10-04 19:45:16,128,84,212,1,1,2
1,201392386,2170660915,37534,36895,2024-10-04 19:45:16,0,0,0,0,0,0
1,201392386,2170660915,57029,36895,2024-10-04 19:45:17,0,0,0,0,0,0
1,201392386,2170660915,62137,36895,2024-10-04 19:45:17,0,0,0,0,0,0
1,201392386,2170660915,0,0,2024-10-04 19:45:17,0,0,0,0,0,0
1,201392386,2170660915,37534,36895,2024-10-04 19:45:17,0,0,0,0,0,0
1,201392386,2170660915,57029,36895,2024-10-04 19:45:18,0,0,0,0,0,0
1,201392386,2170660915,0,0,2024-10-04 19:45:18,0,0,0,0,0,0
1,201392386,2170660915,37534,36895,2024-10-04 19:45:18,0,0,0,0,0,0
1,201392386,2170660915,57029,36895,2024-10-04 19:45:19,0,0,0,0,0,0
1,201392386,2170660915,0,0,2024-10-04 19:45:19,128,0,128,1,0,1
1,201392386,2170660915,37534,36895,2024-10-04 19:45:19,0,0,0,0,0,0
1,201392386,2170660915,57029,36895,2024-10-04 19:45:20,0,0,0,0,0,0
1,201392386,2170660915,0,0,2024-10-04 19:45:20,128,84,212,1,1,2
1,201392386,2170660915,37534,36895,2024-10-04 19:45:20,0,0,0,0,0,0
1,201392386,2170660915,57029,36895,2024-10-04 19:45:21,0,0,0,0,0,0
1,201392386,2170660915,0,0,2024-10-04 19:45:21,128,84,212,1,1,2
1,201392386,2170660915,37534,36895,2024-10-04 19:45:21,0,0,0,0,0,0
1,201392386,2170660915,57029,36895,2024-10-04 19:45:22,0,0,0,0,0,0
1,201392386,1145490689,5335,47873,2024-10-04 19:45:22,3960,57317,61277,31,47,78
1,201392386,2170660915,0,0,2024-10-04 19:45:22,0,84,84,0,1,1
1,201392386,2170660915,37534,36895,2024-10-04 19:45:22,0,0,0,0,0,0
1,201392386,2170660915,57029,36895,2024-10-04 19:45:23,0,0,0,0,0,0
1,201392386,1145490689,5335,47873,2024-10-04 19:45:23,0,0,0,0,0,0
1,201392386,2170660915,0,0,2024-10-04 19:45:23,0,0,0,0,0,0
1,201392386,2170660915,37534,36895,2024-10-04 19:45:23,0,0,0,0,0,0
1,201392386,2170660915,57029,36895,2024-10-04 19:45:24,0,0,0,0,0,0
1,201392386,1145490689,5335,47873,2024-10-04 19:45:24,0,0,0,0,0,0
1,201392386,2170660915,0,0,2024-10-04 19:45:24,0,0,0,0,0,0
1,201392386,2170660915,37534,36895,2024-10-04 19:45:24,0,0,0,0,0,0
1,201392386,2170660915,57029,36895,2024-10-04 19:45:25,0,0,0,0,0,0
1,201392386,1145490689,5335,47873,2024-10-04 19:45:25,0,0,0,0,0,0
1,201392386,2170660915,0,0,2024-10-04 19:45:25,0,0,0,0,0,0
1,201392386,2170660915,37534,36895,2024-10-04 19:45:25,0,0,0,0,0,0
1,201392386,2170660915,57029,36895,2024-10-04 19:45:26,0,0,0,0,0,0
1,201392386,1145490689,5335,47873,2024-10-04 19:45:26,0,0,0,0,0,0
1,201392386,2170660915,0,0,2024-10-04 19:45:26,0,0,0,0,0,0
1,201392386,2170660915,37534,36895,2024-10-04 19:45:26,0,0,0,0,0,0
1,201392386,2170660915,57029,36895,2024-10-04 19:45:27,0,0,0,0,0,0
1,201392386,1145490689,5335,47873,2024-10-04 19:45:27,0,0,0,0,0,0
1,201392386,2170660915,0,0,2024-10-04 19:45:27,0,0,0,0,0,0
1,201392386,2170660915,37534,36895,2024-10-04 19:45:27,0,0,0,0,0,0
1,201392386,2170660915,57029,36895,2024-10-04 19:45:28,0,0,0,0,0,0
1,201392386,1145490689,5335,47873,2024-10-04 19:45:28,2652,41985,44637,26,31,57
1,201392386,2170660915,0,0,2024-10-04 19:45:28,0,0,0,0,0,0
1,201392386,2170660915,37534,36895,2024-10-04 19:45:28,0,0,0,0,0,0
1,201392386,2170660915,57029,36895,2024-10-04 19:45:29,0,0,0,0,0,0
1,201392386,1145490689,5335,47873,2024-10-04 19:45:29,0,0,0,0,0,0
1,201392386,2170660915,0,0,2024-10-04 19:45:29,0,0,0,0,0,0
1,201392386,2170660915,37534,36895,2024-10-04 19:45:29,0,0,0,0,0,0
1,201392386,2170660915,57029,36895,2024-10-04 19:45:30,0,0,0,0,0,0
1,201392386,1145490689,5335,47873,2024-10-04 19:45:30,0,0,0,0,0,0
1,201392386,2170660915,0,0,2024-10-04 19:45:30,0,0,0,0,0,0
1,201392386,2170660915,37534,36895,2024-10-04 19:45:30,0,0,0,0,0,0
1,201392386,2170660915,57029,36895,2024-10-04 19:45:31,0,0,0,0,0,0
1,201392386,1145490689,5335,47873,2024-10-04 19:45:31,0,0,0,0,0,0
1,201392386,2170660915,0,0,2024-10-04 19:45:31,0,0,0,0,0,0
1,201392386,2170660915,37534,36895,2024-10-04 19:45:31,0,0,0,0,0,0
1,201392386,2170660915,57029,36895,2024-10-04 19:45:32,0,0,0,0,0,0
1,201392386,1145490689,5335,47873,2024-10-04 19:45:32,0,0,0,0,0,0
1,201392386,2170660915,0,0,2024-10-04 19:45:32,0,0,0,0,0,0
1,201392386,2170660915,37534,36895,2024-10-04 19:45:32,0,0,0,0,0,0
1,201392386,2170660915,57029,36895,2024-10-04 19:45:33,0,0,0,0,0,0
1,201392386,1145490689,5335,47873,2024-10-04 19:45:33,0,0,0,0,0,0
1,201392386,2170660915,0,0,2024-10-04 19:45:33,0,0,0,0,0,0
1,201392386,2170660915,37534,36895,2024-10-04 19:45:33,0,0,0,0,0,0
1,201392386,2170660915,57029,36895,2024-10-04 19:45:34,0,0,0,0,0,0
1,201392386,1145490689,5335,47873,2024-10-04 19:45:34,0,0,0,0,0,0
1,201392386,2170660915,0,0,2024-10-04 19:45:34,128,84,212,1,1,2
1,201392386,2170660915,37534,36895,2024-10-04 19:45:34,0,0,0,0,0,0
1,201392386,2170660915,57029,36895,2024-10-04 19:45:35,0,0,0,0,0,0
1,201392386,1145490689,5335,47873,2024-10-04 19:45:35,0,0,0,0,0,0
1,201392386,2170660915,0,0,2024-10-04 19:45:35,128,84,212,1,1,2
1,201392386,2170660915,37534,36895,2024-10-04 19:45:35,0,0,0,0,0,0
1,201392386,2170660915,57029,36895,2024-10-04 19:45:36,0,0,0,0,0,0
1,201392386,1145490689,5335,47873,2024-10-04 19:45:36,0,0,0,0,0,0
1,201392386,2170660915,0,0,2024-10-04 19:45:36,128,84,212,1,1,2
1,201392386,2170660915,37534,36895,2024-10-04 19:45:36,0,0,0,0,0,0
1,201392386,2170660915,57029,36895,2024-10-04 19:45:37,0,0,0,0,0,0
1,201392386,1145490689,5335,47873,2024-10-04 19:45:37,0,0,0,0,0,0
1,201392386,2170660915,0,0,2024-10-04 19:45:37,128,84,212,1,1,2
1,201392386,2170660915,37534,36895,2024-10-04 19:45:37,0,0,0,0,0,0
1,201392386,2170660915,57029,36895,2024-10-04 19:45:38,0,0,0,0,0,0
1,201392386,2170660915,0,0,2024-10-04 19:45:38,256,168,424,2,2,4
1,201392386,2170660915,37534,36895,2024-10-04 19:45:38,0,0,0,0,0,0
1,201392386,2170660915,57029,36895,2024-10-04 19:45:39,0,0,0,0,0,0
1,201392386,2170660915,0,0,2024-10-04 19:45:39,128,84,212,1,1,2
1,201392386,2170660915,37534,36895,2024-10-04 19:45:39,0,0,0,0,0,0
1,201392386,2170660915,57029,36895,2024-10-04 19:45:40,0,0,0,0,0,0
1,201392386,2170660915,0,0,2024-10-04 19:45:40,128,84,212,1,1,2
1,201392386,2170660915,37534,36895,2024-10-04 19:45:40,0,0,0,0,0,0
1,201392386,2170660915,57029,36895,2024-10-04 19:45:41,0,0,0,0,0,0
1,201392386,2170660915,0,0,2024-10-04 19:45:41,128,84,212,1,1,2
1,201392386,2170660915,37534,36895,2024-10-04 19:45:41,0,0,0,0,0,0
1,201392386,2170660915,57029,36895,2024-10-04 19:45:42,0,0,0,0,0,0
1,201392386,2170660915,0,0,2024-10-04 19:45:42,128,84,212,1,1,2
1,201392386,2170660915,37534,36895,2024-10-04 19:45:42,0,0,0,0,0,0
1,201392386,2170660915,57029,36895,2024-10-04 19:45:43,0,0,0,0,0,0
1,201392386,2170660915,0,0,2024-10-04 19:45:43,0,0,0,0,0,0
1,201392386,2170660915,37534,36895,2024-10-04 19:45:43,0,0,0,0,0,0
1,201392386,2170660915,57029,36895,2024-10-04 19:45:44,0,0,0,0,0,0
1,201392386,2170660915,0,0,2024-10-04 19:45:44,0,0,0,0,0,0
1,201392386,2170660915,37534,36895,2024-10-04 19:45:44,0,0,0,0,0,0
1,201392386,2170660915,57029,36895,2024-10-04 19:45:45,0,0,0,0,0,0
1,201392386,2170660915,60044,36895,2024-10-04 19:45:45,666,507,1173,6,6,12
1,201392386,2170660915,0,0,2024-10-04 19:45:45,128,0,128,1,0,1
1,201392386,2170660915,37534,36895,2024-10-04 19:45:45,0,0,0,0,0,0
1,201392386,2170660915,57029,36895,2024-10-04 19:45:46,0,0,0,0,0,0
1,201392386,2170660915,60044,36895,2024-10-04 19:45:46,0,0,0,0,0,0
1,201392386,2170660915,0,0,2024-10-04 19:45:46,128,84,212,1,1,2
1,201392386,2170660915,37534,36895,2024-10-04 19:45:46,0,0,0,0,0,0
1,201392386,2170660915,57029,36895,2024-10-04 19:45:47,0,0,0,0,0,0
1,201392386,2170660915,0,0,2024-10-04 19:45:47,128,168,296,1,2,3
1,201392386,2170660915,37534,36895,2024-10-04 19:45:47,0,0,0,0,0,0
1,201392386,2170660915,57029,36895,2024-10-04 19:45:48,0,0,0,0,0,0
1,201392386,2170660915,0,0,2024-10-04 19:45:48,0,0,0,0,0,0
1,201392386,2170660915,37534,36895,2024-10-04 19:45:48,0,0,0,0,0,0
1,201392386,2170660915,57029,36895,2024-10-04 19:45:49,0,0,0,0,0,0
1,201392386,2170660915,0,0,2024-10-04 19:45:49,0,0,0,0,0,0
1,201392386,2170660915,37534,36895,2024-10-04 19:45:49,0,0,0,0,0,0
1,201392386,2170660915,57029,36895,2024-10-04 19:45:50,0,0,0,0,0,0
1,201392386,2170660915,0,0,2024-10-04 19:45:50,128,0,128,1,0,1
1,201392386,2170660915,37534,36895,2024-10-04 19:45:50,0,0,0,0,0,0
1,201392386,2170660915,57029,36895,2024-10-04 19:45:51,0,0,0,0,0,0
1,201392386,2170660915,0,0,2024-10-04 19:45:51,128,84,212,1,1,2
1,201392386,2170660915,37534,36895,2024-10-04 19:45:51,0,0,0,0,0,0
1,201392386,2170660915,57029,36895,2024-10-04 19:45:52,0,0,0,0,0,0
1,201392386,2170660915,0,0,2024-10-04 19:45:52,128,84,212,1,1,2
1,201392386,2170660915,37534,36895,2024-10-04 19:45:52,0,0,0,0,0,0
1,201392386,1145490692,33510,47873,2024-10-04 19:45:53,3708,43383,47091,28,39,67
1,201392386,2170660915,57029,36895,2024-10-04 19:45:53,0,0,0,0,0,0
1,201392386,2170660915,0,0,2024-10-04 19:45:53,0,84,84,0,1,1
1,201392386,2170660915,37534,36895,2024-10-04 19:45:53,0,0,0,0,0,0
1,201392386,1145490692,33510,47873,2024-10-04 19:45:54,2856,55993,58849,28,40,68
1,201392386,2170660915,57029,36895,2024-10-04 19:45:54,0,0,0,0,0,0
1,201392386,2170660915,0,0,2024-10-04 19:45:54,0,0,0,0,0,0
1,201392386,2170660915,37534,36895,2024-10-04 19:45:54,0,0,0,0,0,0
1,201392386,1145490692,33510,47873,2024-10-04 19:45:55,0,0,0,0,0,0
1,201392386,2170660915,57029,36895,2024-10-04 19:45:55,0,0,0,0,0,0
1,201392386,2170660915,0,0,2024-10-04 19:45:55,0,0,0,0,0,0
1,201392386,2170660915,37534,36895,2024-10-04 19:45:55,0,0,0,0,0,0
1,201392386,1145490692,33510,47873,2024-10-04 19:45:56,0,0,0,0,0,0
1,201392386,2170660915,57029,36895,2024-10-04 19:45:56,0,0,0,0,0,0
1,201392386,2170660915,0,0,2024-10-04 19:45:56,0,0,0,0,0,0
1,201392386,2170660915,37534,36895,2024-10-04 19:45:56,0,0,0,0,0,0
1,201392386,1145490692,33510,47873,2024-10-04 19:45:57,0,0,0,0,0,0
1,201392386,2170660915,57029,36895,2024-10-04 19:45:57,0,0,0,0,0,0
1,201392386,2170660915,0,0,2024-10-04 19:45:57,0,0,0,0,0,0
1,201392386,2170660915,37534,36895,2024-10-04 19:45:57,0,0,0,0,0,0
1,201392386,1145490692,33510,47873,2024-10-04 19:45:58,0,0,0,0,0,0
1,201392386,2170660915,57029,36895,2024-10-04 19:45:58,0,0,0,0,0,0
1,201392386,2170660915,0,0,2024-10-04 19:45:58,0,0,0,0,0,0
1,201392386,2170660915,37534,36895,2024-10-04 19:45:58,0,0,0,0,0,0
1,201392386,1145490692,33510,47873,2024-10-04 19:45:59,0,0,0,0,0,0
1,201392386,2170660915,57029,36895,2024-10-04 19:45:59,0,0,0,0,0,0
1,201392386,2170660915,0,0,2024-10-04 19:45:59,0,0,0,0,0,0
1,201392386,2170660915,37534,36895,2024-10-04 19:45:59,0,0,0,0,0,0
1,201392386,1145490692,33510,47873,2024-10-04 19:46:00,0,0,0,0,0,0
1,201392386,2170660915,57029,36895,2024-10-04 19:46:00,0,0,0,0,0,0
1,201392386,2170660915,0,0,2024-10-04 19:46:00,0,0,0,0,0,0
1,201392386,2170660915,37534,36895,2024-10-04 19:46:00,0,0,0,0,0,0
1,201392386,1145490692,33510,47873,2024-10-04 19:46:01,0,0,0,0,0,0
1,201392386,2170660915,57029,36895,2024-10-04 19:46:01,0,0,0,0,0,0
1,201392386,2170660915,0,0,2024-10-04 19:46:01,0,0,0,0,0,0
1,201392386,2170660915,37534,36895,2024-10-04 19:46:01,0,0,0,0,0,0
1,201392386,1145490692,33510,47873,2024-10-04 19:46:02,0,0,0,0,0,0
1,201392386,2170660915,57029,36895,2024-10-04 19:46:02,0,0,0,0,0,0
1,201392386,2170660915,0,0,2024-10-04 19:46:02,0,0,0,0,0,0
1,201392386,2170660915,37534,36895,2024-10-04 19:46:02,0,0,0,0,0,0
1,201392386,1145490692,33510,47873,2024-10-04 19:46:03,0,0,0,0,0,0
1,201392386,2170660915,57029,36895,2024-10-04 19:46:03,0,0,0,0,0,0
1,201392386,2170660915,0,0,2024-10-04 19:46:03,0,0,0,0,0,0
1,201392386,2170660915,37534,36895,2024-10-04 19:46:03,0,0,0,0,0,0
1,201392386,1145490692,33510,47873,2024-10-04 19:46:04,0,0,0,0,0,0
1,201392386,2170660915,57029,36895,2024-10-04 19:46:04,0,0,0,0,0,0
1,201392386,2170660915,0,0,2024-10-04 19:46:04,128,84,212,1,1,2
1,201392386,2170660915,37534,36895,2024-10-04 19:46:04,0,0,0,0,0,0
1,201392386,1145490692,33510,47873,2024-10-04 19:46:05,0,0,0,0,0,0
1,201392386,2170660915,57029,36895,2024-10-04 19:46:05,0,0,0,0,0,0
1,201392386,2170660915,0,0,2024-10-04 19:46:05,128,84,212,1,1,2
1,201392386,2170660915,37534,36895,2024-10-04 19:46:05,0,0,0,0,0,0
1,201392386,1145490692,33510,47873,2024-10-04 19:46:06,0,0,0,0,0,0
1,201392386,2170660915,57029,36895,2024-10-04 19:46:06,0,0,0,0,0,0
1,201392386,2170660915,0,0,2024-10-04 19:46:06,128,84,212,1,1,2
1,201392386,2170660915,37534,36895,2024-10-04 19:46:06,0,0,0,0,0,0
1,201392386,1145490692,33510,47873,2024-10-04 19:46:07,0,0,0,0,0,0
1,201392386,2170660915,57029,36895,2024-10-04 19:46:07,0,0,0,0,0,0
1,201392386,2170660915,0,0,2024-10-04 19:46:07,128,84,212,1,1,2
1,201392386,2170660915,37534,36895,2024-10-04 19:46:07,0,0,0,0,0,0
1,201392386,1145490692,33510,47873,2024-10-04 19:46:08,0,0,0,0,0,0
1,201392386,2170660915,57029,36895,2024-10-04 19:46:08,0,0,0,0,0,0
1,201392386,2170660915,0,0,2024-10-04 19:46:08,128,84,212,1,1,2
1,201392386,2170660915,37534,36895,2024-10-04 19:46:08,0,0,0,0,0,0
1,201392386,1145490692,33510,47873,2024-10-04 19:46:09,0,0,0,0,0,0
1,201392386,2170660915,57029,36895,2024-10-04 19:46:09,0,0,0,0,0,0
1,201392386,2170660915,0,0,2024-10-04 19:46:09,128,84,212,1,1,2
1,201392386,2170660915,37534,36895,2024-10-04 19:46:09,0,0,0,0,0,0
1,201392386,2170660915,57029,36895,2024-10-04 19:46:10,0,0,0,0,0,0
1,201392386,2170660915,0,0,2024-10-04 19:46:10,128,84,212,1,1,2
1,201392386,2170660915,37534,36895,2024-10-04 19:46:10,0,0,0,0,0,0
1,201392386,2170660915,57029,36895,2024-10-04 19:46:11,0,0,0,0,0,0
1,201392386,2170660915,0,0,2024-10-04 19:46:11,128,84,212,1,1,2
1,201392386,2170660915,37534,36895,2024-10-04 19:46:11,0,0,0,0,0,0
1,201392386,2170660915,57029,36895,2024-10-04 19:46:12,0,0,0,0,0,0
1,201392386,2170660915,0,0,2024-10-04 19:46:12,128,0,128,1,0,1
1,201392386,2170660915,37534,36895,2024-10-04 19:46:12,0,0,0,0,0,0
1,201392386,2170660915,57029,36895,2024-10-04 19:46:13,0,0,0,0,0,0
1,201392386,2170660915,0,0,2024-10-04 19:46:13,128,84,212,1,1,2
1,201392386,2170660915,37534,36895,2024-10-04 19:46:13,0,0,0,0,0,0
1,201392386,2170660915,57029,36895,2024-10-04 19:46:14,0,0,0,0,0,0
1,201392386,2170660915,0,0,2024-10-04 19:46:14,0,84,84,0,1,1
1,201392386,2170660915,37534,36895,2024-10-04 19:46:14,0,0,0,0,0,0
1,201392386,2170660915,57029,36895,2024-10-04 19:46:15,0,0,0,0,0,0
1,201392386,2170660915,12433,36895,2024-10-04 19:46:15,666,507,1173,6,6,12
1,201392386,2170660915,0,0,2024-10-04 19:46:15,0,0,0,0,0,0
1,201392386,2170660915,37534,36895,2024-10-04 19:46:15,0,0,0,0,0,0
1,201392386,2170660915,57029,36895,2024-10-04 19:46:16,0,0,0,0,0,0
1,201392386,2170660915,12433,36895,2024-10-04 19:46:16,0,0,0,0,0,0
1,201392386,2170660915,0,0,2024-10-04 19:46:16,0,0,0,0,0,0
1,201392386,2170660915,37534,36895,2024-10-04 19:46:16,0,0,0,0,0,0
1,201392386,2170660915,57029,36895,2024-10-04 19:46:17,0,0,0,0,0,0
1,201392386,2170660915,12433,36895,2024-10-04 19:46:17,0,0,0,0,0,0
1,201392386,2170660915,0,0,2024-10-04 19:46:17,256,84,340,2,1,3
1,201392386,2170660915,37534,36895,2024-10-04 19:46:17,0,0,0,0,0,0
1,201392386,2170660915,57029,36895,2024-10-04 19:46:18,0,0,0,0,0,0
1,201392386,2170660915,0,0,2024-10-04 19:46:18,128,168,296,1,2,3
1,201392386,2170660915,37534,36895,2024-10-04 19:46:18,0,0,0,0,0,0
1,201392386,2170660915,57029,36895,2024-10-04 19:46:19,0,0,0,0,0,0
1,201392386,2170660915,0,0,2024-10-04 19:46:19,0,0,0,0,0,0
1,201392386,2170660915,37534,36895,2024-10-04 19:46:19,0,0,0,0,0,0
1,201392386,2170660915,57029,36895,2024-10-04 19:46:20,0,0,0,0,0,0
1,201392386,2170660915,0,0,2024-10-04 19:46:20,0,0,0,0,0,0
1,201392386,2170660915,37534,36895,2024-10-04 19:46:20,0,0,0,0,0,0
1,201392386,2170660915,57029,36895,2024-10-04 19:46:21,0,0,0,0,0,0
1,201392386,2170660915,0,0,2024-10-04 19:46:21,128,0,128,1,0,1
1,201392386,2170660915,37534,36895,2024-10-04 19:46:21,0,0,0,0,0,0
1,201392386,2170660915,57029,36895,2024-10-04 19:46:22,0,0,0,0,0,0
1,201392386,2170660915,0,0,2024-10-04 19:46:22,128,84,212,1,1,2
1,201392386,2170660915,37534,36895,2024-10-04 19:46:22,0,0,0,0,0,0
1,201392386,2170660915,57029,36895,2024-10-04 19:46:23,0,0,0,0,0,0
1,201392386,2170660915,0,0,2024-10-04 19:46:23,128,84,212,1,1,2
1,201392386,2170660915,37534,36895,2024-10-04 19:46:23,0,0,0,0,0,0
1,201392386,2170660915,57029,36895,2024-10-04 19:46:24,0,0,0,0,0,0
1,201392386,1145490691,48775,47873,2024-10-04 19:46:24,4044,49625,53669,31,42,73
1,201392386,2170660915,0,0,2024-10-04 19:46:24,0,84,84,0,1,1
1,201392386,2170660915,37534,36895,2024-10-04 19:46:24,0,0,0,0,0,0
1,201392386,2170660915,57029,36895,2024-10-04 19:46:25,0,0,0,0,0,0
1,201392386,1145490691,48775,47873,2024-10-04 19:46:25,2748,49595,52343,27,34,61
1,201392386,2170660915,0,0,2024-10-04 19:46:25,0,0,0,0,0,0
1,201392386,2170660915,37534,36895,2024-10-04 19:46:25,0,0,0,0,0,0
1,201392386,2170660915,57029,36895,2024-10-04 19:46:26,0,0,0,0,0,0
1,201392386,1145490691,48775,47873,2024-10-04 19:46:26,0,0,0,0,0,0
1,201392386,2170660915,0,0,2024-10-04 19:46:26,0,0,0,0,0,0
1,201392386,2170660915,37534,36895,2024-10-04 19:46:26,0,0,0,0,0,0
1,201392386,2170660915,57029,36895,2024-10-04 19:46:27,0,0,0,0,0,0
1,201392386,1145490691,48775,47873,2024-10-04 19:46:27,0,0,0,0,0,0
1,201392386,2170660915,0,0,2024-10-04 19:46:27,0,0,0,0,0,0
1,201392386,2170660915,37534,36895,2024-10-04 19:46:27,0,0,0,0,0,0
1,201392386,2170660915,57029,36895,2024-10-04 19:46:28,0,0,0,0,0,0
1,201392386,1145490691,48775,47873,2024-10-04 19:46:28,0,0,0,0,0,0
1,201392386,2170660915,0,0,2024-10-04 19:46:28,0,0,0,0,0,0
1,201392386,2170660915,37534,36895,2024-10-04 19:46:28,0,0,0,0,0,0
1,201392386,2170660915,57029,36895,2024-10-04 19:46:29,0,0,0,0,0,0
1,201392386,1145490691,48775,47873,2024-10-04 19:46:29,0,0,0,0,0,0
1,201392386,2170660915,0,0,2024-10-04 19:46:29,0,0,0,0,0,0
1,201392386,2170660915,37534,36895,2024-10-04 19:46:29,0,0,0,0,0,0
1,201392386,2170660915,57029,36895,2024-10-04 19:46:30,0,0,0,0,0,0
1,201392386,1145490691,48775,47873,2024-10-04 19:46:30,0,0,0,0,0,0
1,201392386,2170660915,0,0,2024-10-04 19:46:30,0,0,0,0,0,0
1,201392386,2170660915,37534,36895,2024-10-04 19:46:30,0,0,0,0,0,0
1,201392386,2170660915,57029,36895,2024-10-04 19:46:31,0,0,0,0,0,0
1,201392386,1145490691,48775,47873,2024-10-04 19:46:31,0,0,0,0,0,0
1,201392386,2170660915,0,0,2024-10-04 19:46:31,0,0,0,0,0,0
1,201392386,2170660915,37534,36895,2024-10-04 19:46:31,0,0,0,0,0,0
1,201392386,2170660915,57029,36895,2024-10-04 19:46:32,0,0,0,0,0,0
1,201392386,1145490691,48775,47873,2024-10-04 19:46:32,0,0,0,0,0,0
1,201392386,2170660915,0,0,2024-10-04 19:46:32,0,0,0,0,0,0
1,201392386,2170660915,37534,36895,2024-10-04 19:46:32,0,0,0,0,0,0
1,201392386,2170660915,57029,36895,2024-10-04 19:46:33,0,0,0,0,0,0
1,201392386,1145490691,48775,47873,2024-10-04 19:46:33,0,0,0,0,0,0
1,201392386,2170660915,0,0,2024-10-04 19:46:33,0,0,0,0,0,0
1,201392386,2170660915,37534,36895,2024-10-04 19:46:33,0,0,0,0,0,0
1,201392386,2170660915,57029,36895,2024-10-04 19:46:34,0,0,0,0,0,0
1,201392386,1145490691,48775,47873,2024-10-04 19:46:34,0,0,0,0,0,0
1,201392386,2170660915,0,0,2024-10-04 19:46:34,0,0,0,0,0,0
1,201392386,2170660915,37534,36895,2024-10-04 19:46:34,0,0,0,0,0,0
1,201392386,2170660915,57029,36895,2024-10-04 19:46:35,0,0,0,0,0,0
1,201392386,1145490691,48775,47873,2024-10-04 19:46:35,0,0,0,0,0,0
1,201392386,2170660915,0,0,2024-10-04 19:46:35,128,0,128,1,0,1
1,201392386,2170660915,37534,36895,2024-10-04 19:46:35,0,0,0,0,0,0
1,201392386,2170660915,57029,36895,2024-10-04 19:46:36,0,0,0,0,0,0
1,201392386,1145490691,48775,47873,2024-10-04 19:46:36,0,0,0,0,0,0
1,201392386,2170660915,0,0,2024-10-04 19:46:36,0,84,84,0,1,1
1,201392386,2170660915,37534,36895,2024-10-04 19:46:36,0,0,0,0,0,0
1,201392386,2170660915,57029,36895,2024-10-04 19:46:37,0,0,0,0,0,0
1,201392386,1145490691,48775,47873,2024-10-04 19:46:37,0,0,0,0,0,0
1,201392386,2170660915,0,0,2024-10-04 19:46:37,128,84,212,1,1,2
1,201392386,2170660915,37534,36895,2024-10-04 19:46:37,0,0,0,0,0,0
1,201392386,2170660915,57029,36895,2024-10-04 19:46:38,0,0,0,0,0,0
1,201392386,1145490691,48775,47873,2024-10-04 19:46:38,0,0,0,0,0,0
1,201392386,2170660915,0,0,2024-10-04 19:46:38,128,84,212,1,1,2
1,201392386,2170660915,37534,36895,2024-10-04 19:46:38,0,0,0,0,0,0
1,201392386,2170660915,57029,36895,2024-10-04 19:46:39,0,0,0,0,0,0
1,201392386,1145490691,48775,47873,2024-10-04 19:46:39,0,0,0,0,0,0
1,201392386,2170660915,0,0,2024-10-04 19:46:39,128,84,212,1,1,2
1,201392386,2170660915,37534,36895,2024-10-04 19:46:39,0,0,0,0,0,0
1,201392386,2170660915,57029,36895,2024-10-04 19:46:40,0,0,0,0,0,0
1,201392386,1145490691,48775,47873,2024-10-04 19:46:40,0,0,0,0,0,0
1,201392386,2170660915,0,0,2024-10-04 19:46:40,256,168,424,2,2,4
1,201392386,2170660915,37534,36895,2024-10-04 19:46:40,0,0,0,0,0,0
1,201392386,2170660915,57029,36895,2024-10-04 19:46:41,0,0,0,0,0,0
1,201392386,1145490691,48775,47873,2024-10-04 19:46:41,0,0,0,0,0,0
1,201392386,2170660915,0,0,2024-10-04 19:46:41,0,0,0,0,0,0
1,201392386,2170660915,37534,36895,2024-10-04 19:46:41,0,0,0,0,0,0
1,201392386,2170660915,57029,36895,2024-10-04 19:46:42,0,0,0,0,0,0
1,201392386,2170660915,0,0,2024-10-04 19:46:42,128,84,212,1,1,2
1,201392386,2170660915,37534,36895,2024-10-04 19:46:42,0,0,0,0,0,0
1,201392386,2170660915,57029,36895,2024-10-04 19:46:43,0,0,0,0,0,0
1,201392386,2170660915,0,0,2024-10-04 19:46:43,128,84,212,1,1,2
1,201392386,2170660915,37534,36895,2024-10-04 19:46:43,0,0,0,0,0,0
1,201392386,2170660915,57029,36895,2024-10-04 19:46:44,0,0,0,0,0,0
1,201392386,2170660915,0,0,2024-10-04 19:46:44,128,84,212,1,1,2
1,201392386,2170660915,37534,36895,2024-10-04 19:46:44,0,0,0,0,0,0
1,201392386,2170660915,57029,36895,2024-10-04 19:46:45,0,0,0,0,0,0
1,201392386,2170660915,0,0,2024-10-04 19:46:45,128,84,212,1,1,2
1,201392386,2170660915,37534,36895,2024-10-04 19:46:45,0,0,0,0,0,0
1,201392386,2170660915,57029,36895,2024-10-04 19:46:46,0,0,0,0,0,0
1,201392386,2170660915,52421,36895,2024-10-04 19:46:46,666,507,1173,6,6,12
1,201392386,2170660915,0,0,2024-10-04 19:46:46,0,0,0,0,0,0
1,201392386,2170660915,37534,36895,2024-10-04 19:46:46,0,0,0,0,0,0
1,201392386,2170660915,57029,36895,2024-10-04 19:46:47,0,0,0,0,0,0
1,201392386,2170660915,52421,36895,2024-10-04 19:46:47,0,0,0,0,0,0
1,201392386,2170660915,0,0,2024-10-04 19:46:47,128,84,212,1,1,2
1,201392386,2170660915,37534,36895,2024-10-04 19:46:47,0,0,0,0,0,0
1,201392386,2170660915,57029,36895,2024-10-04 19:46:48,0,0,0,0,0,0
1,201392386,2170660915,52421,36895,2024-10-04 19:46:48,0,0,0,0,0,0
1,201392386,2170660915,0,0,2024-10-04 19:46:48,128,84,212,1,1,2
1,201392386,2170660915,37534,36895,2024-10-04 19:46:48,0,0,0,0,0,0
1,201392386,2170660915,57029,36895,2024-10-04 19:46:49,0,0,0,0,0,0
1,201392386,2170660915,52421,36895,2024-10-04 19:46:49,0,0,0,0,0,0
1,201392386,2170660915,0,0,2024-10-04 19:46:49,128,84,212,1,1,2
1,201392386,2170660915,37534,36895,2024-10-04 19:46:49,0,0,0,0,0,0
1,201392386,2170660915,57029,36895,2024-10-04 19:46:50,0,0,0,0,0,0
1,201392386,2170660915,0,0,2024-10-04 19:46:50,0,0,0,0,0,0
1,201392386,2170660915,37534,36895,2024-10-04 19:46:50,0,0,0,0,0,0
1,201392386,2170660915,57029,36895,2024-10-04 19:46:51,0,0,0,0,0,0
1,201392386,2170660915,0,0,2024-10-04 19:46:51,0,0,0,0,0,0
1,201392386,2170660915,37534,36895,2024-10-04 19:46:51,0,0,0,0,0,0
1,201392386,2170660915,57029,36895,2024-10-04 19:46:52,0,0,0,0,0,0
1,201392386,2170660915,0,0,2024-10-04 19:46:52,0,0,0,0,0,0
1,201392386,2170660915,37534,36895,2024-10-04 19:46:52,0,0,0,0,0,0
1,201392386,2170660915,57029,36895,2024-10-04 19:46:53,0,0,0,0,0,0
1,201392386,2170660915,0,0,2024-10-04 19:46:53,128,0,128,1,0,1
1,201392386,2170660915,37534,36895,2024-10-04 19:46:53,0,0,0,0,0,0
1,201392386,2170660915,57029,36895,2024-10-04 19:46:54,0,0,0,0,0,0
1,201392386,2170660915,0,0,2024-10-04 19:46:54,128,84,212,1,1,2
1,201392386,2170660915,37534,36895,2024-10-04 19:46:54,0,0,0,0,0,0
1,201392386,2170660915,57029,36895,2024-10-04 19:46:55,0,0,0,0,0,0
1,201392386,1145490692,7378,47873,2024-10-04 19:46:55,3096,37280,40376,23,35,58
1,201392386,2170660915,0,0,2024-10-04 19:46:55,128,168,296,1,2,3
1,201392386,2170660915,37534,36895,2024-10-04 19:46:55,0,0,0,0,0,0
1,201392386,2170660915,57029,36895,2024-10-04 19:46:56,0,0,0,0,0,0
1,201392386,1145490692,7378,47873,2024-10-04 19:46:56,768,20916,21684,8,13,21
1,201392386,2170660915,0,0,2024-10-04 19:46:56,0,0,0,0,0,0
1,201392386,2170660915,37534,36895,2024-10-04 19:46:56,0,0,0,0,0,0
1,201392386,2170660915,57029,36895,2024-10-04 19:46:57,0,0,0,0,0,0
1,201392386,1145490692,7378,47873,2024-10-04 19:46:57,0,0,0,0,0,0
1,201392386,2170660915,0,0,2024-10-04 19:46:57,0,0,0,0,0,0
1,201392386,2170660915,37534,36895,2024-10-04 19:46:57,0,0,0,0,0,0
1,201392386,2170660915,57029,36895,2024-10-04 19:46:58,0,0,0,0,0,0
1,201392386,1145490692,7378,47873,2024-10-04 19:46:58,0,0,0,0,0,0
1,201392386,2170660915,0,0,2024-10-04 19:46:58,0,0,0,0,0,0
1,201392386,2170660915,37534,36895,2024-10-04 19:46:58,0,0,0,0,0,0
1,201392386,2170660915,57029,36895,2024-10-04 19:46:59,0,0,0,0,0,0
1,201392386,1145490692,7378,47873,2024-10-04 19:46:59,0,0,0,0,0,0
1,201392386,2170660915,0,0,2024-10-04 19:46:59,0,0,0,0,0,0
1,201392386,2170660915,37534,36895,2024-10-04 19:46:59,0,0,0,0,0,0
1,201392386,2170660915,57029,36895,2024-10-04 19:47:00,0,0,0,0,0,0
1,201392386,1145490692,7378,47873,2024-10-04 19:47:00,0,0,0,0,0,0
1,201392386,2170660915,0,0,2024-10-04 19:47:00,0,0,0,0,0,0
1,201392386,2170660915,37534,36895,2024-10-04 19:47:00,0,0,0,0,0,0
1,201392386,2170660915,57029,36895,2024-10-04 19:47:01,0,0,0,0,0,0
1,201392386,1145490692,7378,47873,2024-10-04 19:47:01,2940,49316,52256,29,35,64
1,201392386,2170660915,0,0,2024-10-04 19:47:01,0,0,0,0,0,0
1,201392386,2170660915,37534,36895,2024-10-04 19:47:01,0,0,0,0,0,0
1,201392386,2170660915,57029,36895,2024-10-04 19:47:02,0,0,0,0,0,0
1,201392386,1145490692,7378,47873,2024-10-04 19:47:02,0,0,0,0,0,0
1,201392386,2170660915,0,0,2024-10-04 19:47:02,0,0,0,0,0,0
1,201392386,2170660915,37534,36895,2024-10-04 19:47:02,0,0,0,0,0,0
1,201392386,2170660915,57029,36895,2024-10-04 19:47:03,0,0,0,0,0,0
1,201392386,1145490692,7378,47873,2024-10-04 19:47:03,0,0,0,0,0,0
1,201392386,2170660915,0,0,2024-10-04 19:47:03,0,0,0,0,0,0
1,201392386,2170660915,37534,36895,2024-10-04 19:47:03,0,0,0,0,0,0
1,201392386,2170660915,57029,36895,2024-10-04 19:47:04,0,0,0,0,0,0
1,201392386,1145490692,7378,47873,2024-10-04 19:47:04,0,0,0,0,0,0
1,201392386,2170660915,0,0,2024-10-04 19:47:04,0,0,0,0,0,0
1,201392386,2170660915,37534,36895,2024-10-04 19:47:04,0,0,0,0,0,0
1,201392386,2170660915,57029,36895,2024-10-04 19:47:05,0,0,0,0,0,0
1,201392386,1145490692,7378,47873,2024-10-04 19:47:05,0,0,0,0,0,0
1,201392386,2170660915,0,0,2024-10-04 19:47:05,0,0,0,0,0,0
1,201392386,2170660915,37534,36895,2024-10-04 19:47:05,0,0,0,0,0,0
1,201392386,2170660915,57029,36895,2024-10-04 19:47:06,0,0,0,0,0,0
1,201392386,1145490692,7378,47873,2024-10-04 19:47:06,0,0,0,0,0,0
1,201392386,2170660915,0,0,2024-10-04 19:47:06,0,0,0,0,0,0
1,201392386,2170660915,37534,36895,2024-10-04 19:47:06,0,0,0,0,0,0
1,201392386,2170660915,57029,36895,2024-10-04 19:47:07,0,0,0,0,0,0
1,201392386,1145490692,7378,47873,2024-10-04 19:47:07,0,0,0,0,0,0
1,201392386,2170660915,0,0,2024-10-04 19:47:07,128,84,212,1,1,2
1,201392386,2170660915,37534,36895,2024-10-04 19:47:07,0,0,0,0,0,0
1,201392386,2170660915,57029,36895,2024-10-04 19:47:08,0,0,0,0,0,0
1,201392386,1145490692,7378,47873,2024-10-04 19:47:08,0,0,0,0,0,0
1,201392386,2170660915,0,0,2024-10-04 19:47:08,128,84,212,1,1,2
1,201392386,2170660915,37534,36895,2024-10-04 19:47:08,0,0,0,0,0,0
1,201392386,2170660915,57029,36895,2024-10-04 19:47:09,0,0,0,0,0,0
1,201392386,1145490692,7378,47873,2024-10-04 19:47:09,0,0,0,0,0,0
1,201392386,2170660915,0,0,2024-10-04 19:47:09,128,84,212,1,1,2
1,201392386,2170660915,37534,36895,2024-10-04 19:47:09,0,0,0,0,0,0
1,201392386,2170660915,57029,36895,2024-10-04 19:47:10,0,0,0,0,0,0
1,201392386,1145490692,7378,47873,2024-10-04 19:47:10,0,0,0,0,0,0
1,201392386,2170660915,0,0,2024-10-04 19:47:10,128,84,212,1,1,2
1,201392386,2170660915,37534,36895,2024-10-04 19:47:10,0,0,0,0,0,0
1,201392386,2170660915,57029,36895,2024-10-04 19:47:11,0,0,0,0,0,0
1,201392386,2170660915,0,0,2024-10-04 19:47:11,128,84,212,1,1,2
1,201392386,2170660915,37534,36895,2024-10-04 19:47:11,0,0,0,0,0,0
1,201392386,2170660915,57029,36895,2024-10-04 19:47:12,0,0,0,0,0,0
1,201392386,2170660915,0,0,2024-10-04 19:47:12,128,84,212,1,1,2
1,201392386,2170660915,37534,36895,2024-10-04 19:47:12,0,0,0,0,0,0
1,201392386,2170660915,57029,36895,2024-10-04 19:47:13,0,0,0,0,0,0
1,201392386,2170660915,0,0,2024-10-04 19:47:13,128,84,212,1,1,2
1,201392386,2170660915,37534,36895,2024-10-04 19:47:13,0,0,0,0,0,0
1,201392386,2170660915,57029,36895,2024-10-04 19:47:14,0,0,0,0,0,0
1,201392386,2170660915,0,0,2024-10-04 19:47:14,128,84,212,1,1,2
1,201392386,2170660915,37534,36895,2024-10-04 19:47:14,0,0,0,0,0,0
1,201392386,2170660915,57029,36895,2024-10-04 19:47:15,0,0,0,0,0,0
1,201392386,2170660915,0,0,2024-10-04 19:47:15,128,84,212,1,1,2
1,201392386,2170660915,37534,36895,2024-10-04 19:47:15,0,0,0,0,0,0
1,201392386,2170660915,57029,36895,2024-10-04 19:47:16,0,0,0,0,0,0
1,201392386,2170660915,0,0,2024-10-04 19:47:16,128,0,128,1,0,1
1,201392386,2170660915,37534,36895,2024-10-04 19:47:16,0,0,0,0,0,0
1,201392386,2170660915,57029,36895,2024-10-04 19:47:17,0,0,0,0,0,0
1,201392386,2170660915,0,0,2024-10-04 19:47:17,0,84,84,0,1,1
1,201392386,2170660915,37534,36895,2024-10-04 19:47:17,0,0,0,0,0,0
1,201392386,2170660915,57029,36895,2024-10-04 19:47:18,0,0,0,0,0,0
1,201392386,2170660915,57005,36895,2024-10-04 19:47:18,666,507,1173,6,6,12
1,201392386,2170660915,0,0,2024-10-04 19:47:18,0,0,0,0,0,0
1,201392386,2170660915,37534,36895,2024-10-04 19:47:18,0,0,0,0,0,0
1,201392386,2170660915,57029,36895,2024-10-04 19:47:19,0,0,0,0,0,0
1,201392386,2170660915,57005,36895,2024-10-04 19:47:19,0,0,0,0,0,0
1,201392386,2170660915,0,0,2024-10-04 19:47:19,128,84,212,1,1,2
1,201392386,2170660915,37534,36895,2024-10-04 19:47:19,0,0,0,0,0,0
1,201392386,2170660915,57029,36895,2024-10-04 19:47:20,0,0,0,0,0,0
1,201392386,2170660915,57005,36895,2024-10-04 19:47:20,0,0,0,0,0,0
1,201392386,2170660915,0,0,2024-10-04 19:47:20,128,84,212,1,1,2
1,201392386,2170660915,37534,36895,2024-10-04 19:47:20,0,0,0,0,0,0
1,201392386,2170660915,57029,36895,2024-10-04 19:47:21,0,0,0,0,0,0
1,201392386,2170660915,57005,36895,2024-10-04 19:47:21,0,0,0,0,0,0
1,201392386,2170660915,0,0,2024-10-04 19:47:21,128,84,212,1,1,2
1,201392386,2170660915,37534,36895,2024-10-04 19:47:21,0,0,0,0,0,0
1,201392386,2170660915,57029,36895,2024-10-04 19:47:22,0,0,0,0,0,0
1,201392386,2170660915,57005,36895,2024-10-04 19:47:22,0,0,0,0,0,0
1,201392386,2170660915,0,0,2024-10-04 19:47:22,0,0,0,0,0,0
1,201392386,2170660915,37534,36895,2024-10-04 19:47:22,0,0,0,0,0,0
1,201392386,2170660915,57029,36895,2024-10-04 19:47:23,0,0,0,0,0,0
1,201392386,2170660915,57005,36895,2024-10-04 19:47:23,0,0,0,0,0,0
1,201392386,2170660915,0,0,2024-10-04 19:47:23,0,0,0,0,0,0
1,201392386,2170660915,37534,36895,2024-10-04 19:47:23,0,0,0,0,0,0
1,201392386,2170660915,57029,36895,2024-10-04 19:47:24,0,0,0,0,0,0
1,201392386,2170660915,57005,36895,2024-10-04 19:47:24,0,0,0,0,0,0
1,201392386,2170660915,0,0,2024-10-04 19:47:24,128,0,128,1,0,1
1,201392386,2170660915,37534,36895,2024-10-04 19:47:24,0,0,0,0,0,0
1,201392386,2170660915,57029,36895,2024-10-04 19:47:25,0,0,0,0,0,0
1,201392386,2170660915,57005,36895,2024-10-04 19:47:25,0,0,0,0,0,0
1,201392386,2170660915,0,0,2024-10-04 19:47:25,128,84,212,1,1,2
1,201392386,2170660915,37534,36895,2024-10-04 19:47:25,0,0,0,0,0,0
1,201392386,2170660915,57029,36895,2024-10-04 19:47:26,0,0,0,0,0,0
1,201392386,2170660915,57005,36895,2024-10-04 19:47:26,0,0,0,0,0,0
1,201392386,2170660915,0,0,2024-10-04 19:47:26,0,84,84,0,1,1
1,201392386,2170660915,37534,36895,2024-10-04 19:47:26,0,0,0,0,0,0
1,201392386,2170660915,57029,36895,2024-10-04 19:47:27,0,0,0,0,0,0
1,201392386,2170660915,57005,36895,2024-10-04 19:47:27,0,0,0,0,0,0
1,201392386,1145490690,25266,47873,2024-10-04 19:47:27,4464,64365,68829,36,51,87
1,201392386,2170660915,0,0,2024-10-04 19:47:27,128,84,212,1,1,2
1,201392386,2170660915,37534,36895,2024-10-04 19:47:27,0,0,0,0,0,0
1,201392386,2170660915,57029,36895,2024-10-04 19:47:28,0,0,0,0,0,0
1,201392386,2170660915,57005,36895,2024-10-04 19:47:28,0,0,0,0,0,0
1,201392386,1145490690,25266,47873,2024-10-04 19:47:28,0,0,0,0,0,0
1,201392386,2170660915,0,0,2024-10-04 19:47:28,0,0,0,0,0,0
1,201392386,2170660915,37534,36895,2024-10-04 19:47:28,0,0,0,0,0,0
1,201392386,2170660915,57029,36895,2024-10-04 19:47:29,0,0,0,0,0,0
1,201392386,2170660915,57005,36895,2024-10-04 19:47:29,0,0,0,0,0,0
1,201392386,1145490690,25266,47873,2024-10-04 19:47:29,0,0,0,0,0,0
1,201392386,2170660915,0,0,2024-10-04 19:47:29,0,0,0,0,0,0
1,201392386,2170660915,37534,36895,2024-10-04 19:47:29,0,0,0,0,0,0
1,201392386,2170660915,57029,36895,2024-10-04 19:47:30,0,0,0,0,0,0
1,201392386,2170660915,57005,36895,2024-10-04 19:47:30,0,0,0,0,0,0
1,201392386,1145490690,25266,47873,2024-10-04 19:47:30,0,0,0,0,0,0
1,201392386,2170660915,0,0,2024-10-04 19:47:30,0,0,0,0,0,0
1,201392386,2170660915,37534,36895,2024-10-04 19:47:30,0,0,0,0,0,0
1,201392386,2170660915,57029,36895,2024-10-04 19:47:31,0,0,0,0,0,0
1,201392386,2170660915,57005,36895,2024-10-04 19:47:31,0,0,0,0,0,0
1,201392386,1145490690,25266,47873,2024-10-04 19:47:31,0,0,0,0,0,0
1,201392386,2170660915,0,0,2024-10-04 19:47:31,0,0,0,0,0,0
1,201392386,2170660915,37534,36895,2024-10-04 19:47:31,0,0,0,0,0,0
1,201392386,2170660915,57029,36895,2024-10-04 19:47:32,0,0,0,0,0,0
1,201392386,2170660915,57005,36895,2024-10-04 19:47:32,0,0,0,0,0,0
1,201392386,1145490690,25266,47873,2024-10-04 19:47:32,2244,34833,37077,22,25,47
1,201392386,2170660915,0,0,2024-10-04 19:47:32,0,0,0,0,0,0
1,201392386,2170660915,37534,36895,2024-10-04 19:47:32,0,0,0,0,0,0
1,201392386,2170660915,57029,36895,2024-10-04 19:47:33,0,0,0,0,0,0
1,201392386,2170660915,57005,36895,2024-10-04 19:47:33,0,0,0,0,0,0
1,201392386,1145490690,25266,47873,2024-10-04 19:47:33,0,0,0,0,0,0
1,201392386,2170660915,0,0,2024-10-04 19:47:33,0,0,0,0,0,0
1,201392386,2170660915,37534,36895,2024-10-04 19:47:33,0,0,0,0,0,0
1,201392386,2170660915,57029,36895,2024-10-04 19:47:34,0,0,0,0,0,0
1,201392386,2170660915,57005,36895,2024-10-04 19:47:34,0,0,0,0,0,0
1,201392386,1145490690,25266,47873,2024-10-04 19:47:34,0,0,0,0,0,0
1,201392386,2170660915,0,0,2024-10-04 19:47:34,0,0,0,0,0,0
1,201392386,2170660915,37534,36895,2024-10-04 19:47:34,0,0,0,0,0,0
1,201392386,2170660915,57029,36895,2024-10-04 19:47:35,0,0,0,0,0,0
1,201392386,2170660915,57005,36895,2024-10-04 19:47:35,0,0,0,0,0,0
1,201392386,1145490690,25266,47873,2024-10-04 19:47:35,0,0,0,0,0,0
1,201392386,2170660915,0,0,2024-10-04 19:47:35,0,0,0,0,0,0
1,201392386,2170660915,37534,36895,2024-10-04 19:47:35,0,0,0,0,0,0
1,201392386,2170660915,57029,36895,2024-10-04 19:47:36,0,0,0,0,0,0
1,201392386,2170660915,57005,36895,2024-10-04 19:47:36,0,0,0,0,0,0
1,201392386,1145490690,25266,47873,2024-10-04 19:47:36,0,0,0,0,0,0
1,201392386,2170660915,0,0,2024-10-04 19:47:36,0,0,0,0,0,0
1,201392386,2170660915,37534,36895,2024-10-04 19:47:36,0,0,0,0,0,0
1,201392386,2170660915,57029,36895,2024-10-04 19:47:37,0,0,0,0,0,0
1,201392386,2170660915,57005,36895,2024-10-04 19:47:37,0,0,0,0,0,0
1,201392386,1145490690,25266,47873,2024-10-04 19:47:37,0,0,0,0,0,0
1,201392386,2170660915,0,0,2024-10-04 19:47:37,0,0,0,0,0,0
1,201392386,2170660915,37534,36895,2024-10-04 19:47:37,0,0,0,0,0,0
1,201392386,2170660915,57029,36895,2024-10-04 19:47:38,0,0,0,0,0,0
1,201392386,2170660915,57005,36895,2024-10-04 19:47:38,0,0,0,0,0,0
1,201392386,1145490690,25266,47873,2024-10-04 19:47:38,0,0,0,0,0,0
1,201392386,2170660915,0,0,2024-10-04 19:47:38,128,84,212,1,1,2
1,201392386,2170660915,37534,36895,2024-10-04 19:47:38,0,0,0,0,0,0
1,201392386,2170660915,57029,36895,2024-10-04 19:47:39,0,0,0,0,0,0
1,201392386,2170660915,57005,36895,2024-10-04 19:47:39,0,0,0,0,0,0
1,201392386,1145490690,25266,47873,2024-10-04 19:47:39,0,0,0,0,0,0
1,201392386,2170660915,0,0,2024-10-04 19:47:39,128,84,212,1,1,2
1,201392386,2170660915,37534,36895,2024-10-04 19:47:39,0,0,0,0,0,0
1,201392386,2170660915,57029,36895,2024-10-04 19:47:40,0,0,0,0,0,0
1,201392386,2170660915,57005,36895,2024-10-04 19:47:40,0,0,0,0,0,0
1,201392386,1145490690,25266,47873,2024-10-04 19:47:40,0,0,0,0,0,0
1,201392386,2170660915,0,0,2024-10-04 19:47:40,128,84,212,1,1,2
1,201392386,2170660915,37534,36895,2024-10-04 19:47:40,0,0,0,0,0,0
1,201392386,2170660915,57029,36895,2024-10-04 19:47:41,0,0,0,0,0,0
1,201392386,2170660915,57005,36895,2024-10-04 19:47:41,0,0,0,0,0,0
1,201392386,1145490690,25266,47873,2024-10-04 19:47:41,0,0,0,0,0,0
1,201392386,2170660915,0,0,2024-10-04 19:47:41,128,84,212,1,1,2
1,201392386,2170660915,37534,36895,2024-10-04 19:47:41,0,0,0,0,0,0
1,201392386,2170660915,57029,36895,2024-10-04 19:47:42,0,0,0,0,0,0
1,201392386,2170660915,57005,36895,2024-10-04 19:47:42,0,0,0,0,0,0
1,201392386,2170660915,0,0,2024-10-04 19:47:42,128,84,212,1,1,2
1,201392386,2170660915,37534,36895,2024-10-04 19:47:42,0,0,0,0,0,0
1,201392386,2170660915,57029,36895,2024-10-04 19:47:43,0,0,0,0,0,0
1,201392386,2170660915,57005,36895,2024-10-04 19:47:43,0,0,0,0,0,0
1,201392386,2170660915,0,0,2024-10-04 19:47:43,128,84,212,1,1,2
1,201392386,2170660915,37534,36895,2024-10-04 19:47:43,0,0,0,0,0,0
1,201392386,2170660915,57029,36895,2024-10-04 19:47:44,0,0,0,0,0,0
1,201392386,2170660915,57005,36895,2024-10-04 19:47:44,0,0,0,0,0,0
1,201392386,2170660915,0,0,2024-10-04 19:47:44,128,84,212,1,1,2
1,201392386,2170660915,37534,36895,2024-10-04 19:47:44,0,0,0,0,0,0
1,201392386,2170660915,57029,36895,2024-10-04 19:47:45,0,0,0,0,0,0
1,201392386,2170660915,57005,36895,2024-10-04 19:47:45,0,0,0,0,0,0
1,201392386,2170660915,0,0,2024-10-04 19:47:45,128,84,212,1,1,2
1,201392386,2170660915,37534,36895,2024-10-04 19:47:45,0,0,0,0,0,0
1,201392386,2170660915,57029,36895,2024-10-04 19:47:46,0,0,0,0,0,0
1,201392386,2170660915,57005,36895,2024-10-04 19:47:46,0,0,0,0,0,0
1,201392386,2170660915,0,0,2024-10-04 19:47:46,128,84,212,1,1,2
1,201392386,2170660915,37534,36895,2024-10-04 19:47:46,0,0,0,0,0,0
1,201392386,2170660915,57029,36895,2024-10-04 19:47:47,0,0,0,0,0,0
1,201392386,2170660915,57005,36895,2024-10-04 19:47:47,0,0,0,0,0,0
1,201392386,2170660915,0,0,2024-10-04 19:47:47,128,84,212,1,1,2
1,201392386,2170660915,37534,36895,2024-10-04 19:47:47,0,0,0,0,0,0
1,201392386,2170660915,57029,36895,2024-10-04 19:47:48,0,0,0,0,0,0
1,201392386,2170660915,0,0,2024-10-04 19:47:48,0,0,0,0,0,0
1,201392386,2170660915,37534,36895,2024-10-04 19:47:48,0,0,0,0,0,0
1,201392386,2170660915,57029,36895,2024-10-04 19:47:49,0,0,0,0,0,0
1,201392386,2170660915,61113,36895,2024-10-04 19:47:49,666,507,1173,6,6,12
1,201392386,2170660915,0,0,2024-10-04 19:47:49,0,0,0,0,0,0
1,201392386,2170660915,37534,36895,2024-10-04 19:47:49,0,0,0,0,0,0
1,201392386,2170660915,57029,36895,2024-10-04 19:47:50,0,0,0,0,0,0
1,201392386,2170660915,61113,36895,2024-10-04 19:47:50,0,0,0,0,0,0
1,201392386,2170660915,0,0,2024-10-04 19:47:50,128,84,212,1,1,2
1,201392386,2170660915,37534,36895,2024-10-04 19:47:50,0,0,0,0,0,0
1,201392386,2170660915,57029,36895,2024-10-04 19:47:51,0,0,0,0,0,0
1,201392386,2170660915,61113,36895,2024-10-04 19:47:51,0,0,0,0,0,0
1,201392386,2170660915,0,0,2024-10-04 19:47:51,128,84,212,1,1,2
1,201392386,2170660915,37534,36895,2024-10-04 19:47:51,0,0,0,0,0,0
1,201392386,2170660915,57029,36895,2024-10-04 19:47:52,0,0,0,0,0,0
1,201392386,2170660915,61113,36895,2024-10-04 19:47:52,0,0,0,0,0,0
1,201392386,2170660915,0,0,2024-10-04 19:47:52,128,84,212,1,1,2
1,201392386,2170660915,37534,36895,2024-10-04 19:47:52,0,0,0,0,0,0
1,201392386,2170660915,57029,36895,2024-10-04 19:47:53,0,0,0,0,0,0
1,201392386,2170660915,61113,36895,2024-10-04 19:47:53,0,0,0,0,0,0
1,201392386,2170660915,0,0,2024-10-04 19:47:53,0,0,0,0,0,0
1,201392386,2170660915,37534,36895,2024-10-04 19:47:53,0,0,0,0,0,0
1,201392386,2170660915,57029,36895,2024-10-04 19:47:54,0,0,0,0,0,0
1,201392386,2170660915,61113,36895,2024-10-04 19:47:54,0,0,0,0,0,0
1,201392386,2170660915,0,0,2024-10-04 19:47:54,0,0,0,0,0,0
1,201392386,2170660915,37534,36895,2024-10-04 19:47:54,0,0,0,0,0,0
1,201392386,2170660915,57029,36895,2024-10-04 19:47:55,0,0,0,0,0,0
1,201392386,2170660915,61113,36895,2024-10-04 19:47:55,0,0,0,0,0,0
1,201392386,2170660915,0,0,2024-10-04 19:47:55,128,0,128,1,0,1
1,201392386,2170660915,37534,36895,2024-10-04 19:47:55,0,0,0,0,0,0
1,201392386,2170660915,57029,36895,2024-10-04 19:47:56,0,0,0,0,0,0
1,201392386,2170660915,61113,36895,2024-10-04 19:47:56,0,0,0,0,0,0
1,201392386,2170660915,0,0,2024-10-04 19:47:56,128,84,212,1,1,2
1,201392386,2170660915,37534,36895,2024-10-04 19:47:56,0,0,0,0,0,0
1,201392386,2170660915,57029,36895,2024-10-04 19:47:57,0,0,0,0,0,0
1,201392386,2170660915,61113,36895,2024-10-04 19:47:57,0,0,0,0,0,0
1,201392386,2170660915,0,0,2024-10-04 19:47:57,128,84,212,1,1,2
1,201392386,2170660915,37534,36895,2024-10-04 19:47:57,0,0,0,0,0,0
1,201392386,2170660915,57029,36895,2024-10-04 19:47:58,0,0,0,0,0,0
1,201392386,1145490689,15591,47873,2024-10-04 19:47:58,4880,67257,72137,40,54,94
1,201392386,2170660915,61113,36895,2024-10-04 19:47:58,0,0,0,0,0,0
1,201392386,2170660915,0,0,2024-10-04 19:47:58,0,84,84,0,1,1
1,201392386,2170660915,37534,36895,2024-10-04 19:47:58,0,0,0,0,0,0
1,201392386,2170660915,57029,36895,2024-10-04 19:47:59,0,0,0,0,0,0
1,201392386,1145490689,15591,47873,2024-10-04 19:47:59,0,0,0,0,0,0
1,201392386,2170660915,61113,36895,2024-10-04 19:47:59,0,0,0,0,0,0
1,201392386,2170660915,0,0,2024-10-04 19:47:59,0,0,0,0,0,0
1,201392386,2170660915,37534,36895,2024-10-04 19:47:59,0,0,0,0,0,0
1,201392386,2170660915,57029,36895,2024-10-04 19:48:00,0,0,0,0,0,0
1,201392386,1145490689,15591,47873,2024-10-04 19:48:00,0,0,0,0,0,0
1,201392386,2170660915,61113,36895,2024-10-04 19:48:00,0,0,0,0,0,0
1,201392386,2170660915,0,0,2024-10-04 19:48:00,0,0,0,0,0,0
1,201392386,2170660915,37534,36895,2024-10-04 19:48:00,0,0,0,0,0,0
1,201392386,2170660915,57029,36895,2024-10-04 19:48:01,0,0,0,0,0,0
1,201392386,1145490689,15591,47873,2024-10-04 19:48:01,0,0,0,0,0,0
1,201392386,2170660915,61113,36895,2024-10-04 19:48:01,0,0,0,0,0,0
1,201392386,2170660915,0,0,2024-10-04 19:48:01,0,0,0,0,0,0
1,201392386,2170660915,37534,36895,2024-10-04 19:48:01,0,0,0,0,0,0
1,201392386,2170660915,57029,36895,2024-10-04 19:48:02,0,0,0,0,0,0
1,201392386,1145490689,15591,47873,2024-10-04 19:48:02,0,0,0,0,0,0
1,201392386,2170660915,61113,36895,2024-10-04 19:48:02,0,0,0,0,0,0
1,201392386,2170660915,0,0,2024-10-04 19:48:02,0,0,0,0,0,0
1,201392386,2170660915,37534,36895,2024-10-04 19:48:02,0,0,0,0,0,0
1,201392386,2170660915,57029,36895,2024-10-04 19:48:03,0,0,0,0,0,0
1,201392386,1145490689,15591,47873,2024-10-04 19:48:03,2052,36113,38165,20,26,46
1,201392386,2170660915,61113,36895,2024-10-04 19:48:03,0,0,0,0,0,0
1,201392386,2170660915,0,0,2024-10-04 19:48:03,0,0,0,0,0,0
1,201392386,2170660915,37534,36895,2024-10-04 19:48:03,0,0,0,0,0,0
1,201392386,2170660915,57029,36895,2024-10-04 19:48:04,0,0,0,0,0,0
1,201392386,1145490689,15591,47873,2024-10-04 19:48:04,0,0,0,0,0,0
1,201392386,2170660915,61113,36895,2024-10-04 19:48:04,0,0,0,0,0,0
1,201392386,2170660915,0,0,2024-10-04 19:48:04,0,0,0,0,0,0
1,201392386,2170660915,37534,36895,2024-10-04 19:48:04,0,0,0,0,0,0
1,201392386,2170660915,57029,36895,2024-10-04 19:48:05,0,0,0,0,0,0
1,201392386,1145490689,15591,47873,2024-10-04 19:48:05,0,0,0,0,0,0
1,201392386,2170660915,61113,36895,2024-10-04 19:48:05,0,0,0,0,0,0
1,201392386,2170660915,0,0,2024-10-04 19:48:05,0,0,0,0,0,0
1,201392386,2170660915,37534,36895,2024-10-04 19:48:05,0,0,0,0,0,0
1,201392386,2170660915,57029,36895,2024-10-04 19:48:06,0,0,0,0,0,0
1,201392386,1145490689,15591,47873,2024-10-04 19:48:06,0,0,0,0,0,0
1,201392386,2170660915,61113,36895,2024-10-04 19:48:06,0,0,0,0,0,0
1,201392386,2170660915,0,0,2024-10-04 19:48:06,0,0,0,0,0,0
1,201392386,2170660915,37534,36895,2024-10-04 19:48:06,0,0,0,0,0,0
1,201392386,2170660915,57029,36895,2024-10-04 19:48:07,0,0,0,0,0,0
1,201392386,1145490689,15591,47873,2024-10-04 19:48:07,0,0,0,0,0,0
1,201392386,2170660915,61113,36895,2024-10-04 19:48:07,0,0,0,0,0,0
1,201392386,2170660915,0,0,2024-10-04 19:48:07,0,0,0,0,0,0
1,201392386,2170660915,37534,36895,2024-10-04 19:48:07,0,0,0,0,0,0
1,201392386,2170660915,57029,36895,2024-10-04 19:48:08,0,0,0,0,0,0
1,201392386,1145490689,15591,47873,2024-10-04 19:48:08,0,0,0,0,0,0
1,201392386,2170660915,61113,36895,2024-10-04 19:48:08,0,0,0,0,0,0
1,201392386,2170660915,0,0,2024-10-04 19:48:08,0,0,0,0,0,0
1,201392386,2170660915,37534,36895,2024-10-04 19:48:08,0,0,0,0,0,0
1,201392386,2170660915,57029,36895,2024-10-04 19:48:09,0,0,0,0,0,0
1,201392386,1145490689,15591,47873,2024-10-04 19:48:09,0,0,0,0,0,0
1,201392386,2170660915,61113,36895,2024-10-04 19:48:09,0,0,0,0,0,0
1,201392386,2170660915,0,0,2024-10-04 19:48:09,128,0,128,1,0,1
1,201392386,2170660915,37534,36895,2024-10-04 19:48:09,0,0,0,0,0,0
1,201392386,2170660915,57029,36895,2024-10-04 19:48:10,0,0,0,0,0,0
1,201392386,1145490689,15591,47873,2024-10-04 19:48:10,0,0,0,0,0,0
1,201392386,2170660915,61113,36895,2024-10-04 19:48:10,0,0,0,0,0,0
1,201392386,2170660915,0,0,2024-10-04 19:48:10,128,84,212,1,1,2
1,201392386,2170660915,37534,36895,2024-10-04 19:48:10,0,0,0,0,0,0
4,201392389,2170660915,0,0,2024-10-04 19:18:51,128,84,212,1,1,2
4,201392389,2170660915,24809,36895,2024-10-04 19:18:51,571,423,994,5,5,10
4,201392389,2170660915,0,0,2024-10-04 19:18:52,128,84,212,1,1,2
4,201392389,2170660915,24809,36895,2024-10-04 19:18:52,0,0,0,0,0,0
4,201392389,2170660915,0,0,2024-10-04 19:18:53,128,84,212,1,1,2
4,201392389,2170660915,24809,36895,2024-10-04 19:18:53,0,0,0,0,0,0
4,201392389,2170660915,0,0,2024-10-04 19:18:54,128,84,212,1,1,2
4,201392389,2170660915,24809,36895,2024-10-04 19:18:54,0,0,0,0,0,0
4,201392389,2170660915,0,0,2024-10-04 19:18:55,128,84,212,1,1,2
4,201392389,2170660915,24809,36895,2024-10-04 19:18:55,0,0,0,0,0,0
4,201392389,2170660915,0,0,2024-10-04 19:18:56,128,84,212,1,1,2
4,201392389,2170660915,24809,36895,2024-10-04 19:18:56,0,0,0,0,0,0
4,201392389,2170660915,0,0,2024-10-04 19:18:57,128,84,212,1,1,2
4,201392389,2170660915,24809,36895,2024-10-04 19:18:57,0,0,0,0,0,0
4,201392389,2170660915,0,0,2024-10-04 19:18:58,128,84,212,1,1,2
4,201392389,2170660915,24809,36895,2024-10-04 19:18:58,0,0,0,0,0,0
4,201392389,2170660915,0,0,2024-10-04 19:18:59,128,84,212,1,1,2
4,201392389,2170660915,24809,36895,2024-10-04 19:18:59,0,0,0,0,0,0
4,201392389,2170660915,0,0,2024-10-04 19:19:00,128,84,212,1,1,2
4,201392389,2170660915,28821,36895,2024-10-04 19:19:00,571,423,994,5,5,10
4,201392389,2170660915,0,0,2024-10-04 19:19:01,0,0,0,0,0,0
4,201392389,2170660915,28821,36895,2024-10-04 19:19:01,0,0,0,0,0,0
4,201392389,2170660915,32917,36895,2024-10-04 19:19:02,571,423,994,5,5,10
4,201392389,2170660915,0,0,2024-10-04 19:19:02,128,84,212,1,1,2
4,201392389,2170660915,28821,36895,2024-10-04 19:19:02,0,0,0,0,0,0
4,201392389,2170660915,32917,36895,2024-10-04 19:19:03,0,0,0,0,0,0
4,201392389,2170660915,0,0,2024-10-04 19:19:03,128,84,212,1,1,2
4,201392389,2170660915,28821,36895,2024-10-04 19:19:03,0,0,0,0,0,0
4,201392389,2170660915,32917,36895,2024-10-04 19:19:04,0,0,0,0,0,0
4,201392389,2170660915,0,0,2024-10-04 19:19:04,128,84,212,1,1,2
4,201392389,2170660915,28821,36895,2024-10-04 19:19:04,0,0,0,0,0,0
4,201392389,2170660915,32917,36895,2024-10-04 19:19:05,0,0,0,0,0,0
4,201392389,2170660915,0,0,2024-10-04 19:19:05,128,0,128,1,0,1
4,201392389,2170660915,28821,36895,2024-10-04 19:19:05,0,0,0,0,0,0
4,201392389,2170660915,32917,36895,2024-10-04 19:19:06,0,0,0,0,0,0
4,201392389,2170660915,0,0,2024-10-04 19:19:06,128,84,212,1,1,2
4,201392389,2170660915,28821,36895,2024-10-04 19:19:06,0,0,0,0,0,0
4,201392389,2170660915,32917,36895,2024-10-04 19:19:07,0,0,0,0,0,0
4,201392389,2170660915,0,0,2024-10-04 19:19:07,128,84,212,1,1,2
4,201392389,2170660915,28821,36895,2024-10-04 19:19:07,0,0,0,0,0,0
4,201392389,2170660915,32917,36895,2024-10-04 19:19:08,0,0,0,0,0,0
4,201392389,2170660915,0,0,2024-10-04 19:19:08,128,84,212,1,1,2
4,201392389,2170660915,28821,36895,2024-10-04 19:19:08,0,0,0,0,0,0
4,201392389,2170660915,32917,36895,2024-10-04 19:19:09,0,0,0,0,0,0
4,201392389,2170660915,0,0,2024-10-04 19:19:09,128,84,212,1,1,2
4,201392389,2170660915,28821,36895,2024-10-04 19:19:09,0,0,0,0,0,0
4,201392389,2170660915,32917,36895,2024-10-04 19:19:10,0,0,0,0,0,0
4,201392389,2170660915,0,0,2024-10-04 19:19:10,0,84,84,0,1,1
4,201392389,2170660915,28821,36895,2024-10-04 19:19:10,0,0,0,0,0,0
4,201392389,2170660915,32917,36895,2024-10-04 19:19:11,0,0,0,0,0,0
4,201392389,2170660915,0,0,2024-10-04 19:19:11,256,84,340,2,1,3
4,201392389,2170660915,28821,36895,2024-10-04 19:19:11,0,0,0,0,0,0
4,201392389,2170660915,32917,36895,2024-10-04 19:19:12,0,0,0,0,0,0
4,201392389,2170660915,33961,36895,2024-10-04 19:19:12,571,423,994,5,5,10
4,201392389,2170660915,0,0,2024-10-04 19:19:12,0,84,84,0,1,1
4,201392389,2170660915,28821,36895,2024-10-04 19:19:12,0,0,0,0,0,0
4,201392389,2170660915,32917,36895,2024-10-04 19:19:13,0,0,0,0,0,0
4,201392389,2170660915,33961,36895,2024-10-04 19:19:13,0,0,0,0,0,0
4,201392389,2170660915,0,0,2024-10-04 19:19:13,0,0,0,0,0,0
4,201392389,2170660915,28821,36895,2024-10-04 19:19:13,0,0,0,0,0,0
4,201392389,2170660915,38057,36895,2024-10-04 19:19:14,571,423,994,5,5,10
4,201392389,2170660915,33961,36895,2024-10-04 19:19:14,0,0,0,0,0,0
4,201392389,2170660915,0,0,2024-10-04 19:19:14,256,84,340,2,1,3
4,201392389,2170660915,28821,36895,2024-10-04 19:19:14,0,0,0,0,0,0
4,201392389,2170660915,38057,36895,2024-10-04 19:19:15,0,0,0,0,0,0
4,201392389,2170660915,33961,36895,2024-10-04 19:19:15,0,0,0,0,0,0
4,201392389,2170660915,0,0,2024-10-04 19:19:15,128,84,212,1,1,2
4,201392389,2170660915,28821,36895,2024-10-04 19:19:15,0,0,0,0,0,0
4,201392389,2170660915,38057,36895,2024-10-04 19:19:16,0,0,0,0,0,0
4,201392389,2170660915,33961,36895,2024-10-04 19:19:16,0,0,0,0,0,0
4,201392389,2170660915,0,0,2024-10-04 19:19:16,128,84,212,1,1,2
4,201392389,2170660915,28821,36895,2024-10-04 19:19:16,0,0,0,0,0,0
4,201392389,2170660915,38057,36895,2024-10-04 19:19:17,0,0,0,0,0,0
4,201392389,2170660915,33961,36895,2024-10-04 19:19:17,0,0,0,0,0,0
4,201392389,2170660915,0,0,2024-10-04 19:19:17,128,84,212,1,1,2
4,201392389,2170660915,28821,36895,2024-10-04 19:19:17,0,0,0,0,0,0
4,201392389,2170660915,38057,36895,2024-10-04 19:19:18,0,0,0,0,0,0
4,201392389,2170660915,33961,36895,2024-10-04 19:19:18,0,0,0,0,0,0
4,201392389,2170660915,0,0,2024-10-04 19:19:18,128,84,212,1,1,2
4,201392389,2170660915,28821,36895,2024-10-04 19:19:18,0,0,0,0,0,0
4,201392389,2170660915,38057,36895,2024-10-04 19:19:19,0,0,0,0,0,0
4,201392389,2170660915,33961,36895,2024-10-04 19:19:19,0,0,0,0,0,0
4,201392389,2170660915,0,0,2024-10-04 19:19:19,128,168,296,1,2,3
4,201392389,2170660915,28821,36895,2024-10-04 19:19:19,0,0,0,0,0,0
4,201392389,2170660915,38057,36895,2024-10-04 19:19:20,0,0,0,0,0,0
4,201392389,2170660915,33961,36895,2024-10-04 19:19:20,0,0,0,0,0,0
4,201392389,2170660915,0,0,2024-10-04 19:19:20,0,0,0,0,0,0
4,201392389,2170660915,28821,36895,2024-10-04 19:19:20,0,0,0,0,0,0
4,201392389,2170660915,38057,36895,2024-10-04 19:19:21,0,0,0,0,0,0
4,201392389,2170660915,33961,36895,2024-10-04 19:19:21,0,0,0,0,0,0
4,201392389,2170660915,0,0,2024-10-04 19:19:21,256,84,340,2,1,3
4,201392389,2170660915,28821,36895,2024-10-04 19:19:21,0,0,0,0,0,0
4,201392389,2170660915,38057,36895,2024-10-04 19:19:22,0,0,0,0,0,0
4,201392389,2170660915,33961,36895,2024-10-04 19:19:22,0,0,0,0,0,0
4,201392389,2170660915,0,0,2024-10-04 19:19:22,0,84,84,0,1,1
4,201392389,2170660915,28821,36895,2024-10-04 19:19:22,0,0,0,0,0,0
4,201392389,2170660915,41192,36895,2024-10-04 19:19:23,571,423,994,5,5,10
4,201392389,2170660915,38057,36895,2024-10-04 19:19:23,0,0,0,0,0,0
4,201392389,2170660915,33961,36895,2024-10-04 19:19:23,0,0,0,0,0,0
4,201392389,2170660915,0,0,2024-10-04 19:19:23,128,84,212,1,1,2
4,201392389,2170660915,28821,36895,2024-10-04 19:19:23,0,0,0,0,0,0
4,201392389,2170660915,41192,36895,2024-10-04 19:19:24,0,0,0,0,0,0
4,201392389,2170660915,38057,36895,2024-10-04 19:19:24,0,0,0,0,0,0
4,201392389,2170660915,33961,36895,2024-10-04 19:19:24,0,0,0,0,0,0
4,201392389,2170660915,0,0,2024-10-04 19:19:24,0,0,0,0,0,0
4,201392389,2170660915,28821,36895,2024-10-04 19:19:24,0,0,0,0,0,0
4,201392389,2170660915,41192,36895,2024-10-04 19:19:25,0,0,0,0,0,0
4,201392389,2170660915,38057,36895,2024-10-04 19:19:25,0,0,0,0,0,0
4,201392389,2170660915,33961,36895,2024-10-04 19:19:25,0,0,0,0,0,0
4,201392389,2170660915,0,0,2024-10-04 19:19:25,0,0,0,0,0,0
4,201392389,2170660915,28821,36895,2024-10-04 19:19:25,0,0,0,0,0,0
4,201392389,2170660915,41192,36895,2024-10-04 19:19:26,0,0,0,0,0,0
4,201392389,2170660915,38057,36895,2024-10-04 19:19:26,0,0,0,0,0,0
4,201392389,2170660915,33961,36895,2024-10-04 19:19:26,0,0,0,0,0,0
4,201392389,2170660915,0,0,2024-10-04 19:19:26,0,0,0,0,0,0
4,201392389,2170660915,28821,36895,2024-10-04 19:19:26,0,0,0,0,0,0
4,201392389,2170660915,41192,36895,2024-10-04 19:19:27,0,0,0,0,0,0
4,201392389,2170660915,38057,36895,2024-10-04 19:19:27,0,0,0,0,0,0
4,201392389,2170660915,33961,36895,2024-10-04 19:19:27,0,0,0,0,0,0
4,201392389,2170660915,0,0,2024-10-04 19:19:27,0,0,0,0,0,0
4,201392389,2170660915,28821,36895,2024-10-04 19:19:27,0,0,0,0,0,0
4,201392389,2170660915,41192,36895,2024-10-04 19:19:28,0,0,0,0,0,0
4,201392389,2170660915,38057,36895,2024-10-04 19:19:28,0,0,0,0,0,0
4,201392389,2170660915,33961,36895,2024-10-04 19:19:28,0,0,0,0,0,0
4,201392389,2170660915,0,0,2024-10-04 19:19:28,0,0,0,0,0,0
4,201392389,2170660915,28821,36895,2024-10-04 19:19:28,0,0,0,0,0,0
4,201392389,2170660915,41192,36895,2024-10-04 19:19:29,0,0,0,0,0,0
4,201392389,2170660915,38057,36895,2024-10-04 19:19:29,0,0,0,0,0,0
4,201392389,2170660915,33961,36895,2024-10-04 19:19:29,0,0,0,0,0,0
4,201392389,2170660915,0,0,2024-10-04 19:19:29,0,0,0,0,0,0
4,201392389,2170660915,28821,36895,2024-10-04 19:19:29,0,0,0,0,0,0
4,201392389,2170660915,41192,36895,2024-10-04 19:19:30,0,0,0,0,0,0
4,201392389,2170660915,38057,36895,2024-10-04 19:19:30,0,0,0,0,0,0
4,201392389,2170660915,33961,36895,2024-10-04 19:19:30,0,0,0,0,0,0
4,201392389,2170660915,0,0,2024-10-04 19:19:30,0,0,0,0,0,0
4,201392389,2170660915,28821,36895,2024-10-04 19:19:30,0,0,0,0,0,0
4,201392389,2170660915,41192,36895,2024-10-04 19:19:31,0,0,0,0,0,0
4,201392389,2170660915,38057,36895,2024-10-04 19:19:31,0,0,0,0,0,0
4,201392389,2170660915,33961,36895,2024-10-04 19:19:31,0,0,0,0,0,0
4,201392389,2170660915,0,0,2024-10-04 19:19:31,0,0,0,0,0,0
4,201392389,2170660915,28821,36895,2024-10-04 19:19:31,0,0,0,0,0,0
4,201392389,2170660915,38057,36895,2024-10-04 19:19:32,0,0,0,0,0,0
4,201392389,2170660915,33961,36895,2024-10-04 19:19:32,0,0,0,0,0,0
4,201392389,2170660915,0,0,2024-10-04 19:19:32,0,0,0,0,0,0
4,201392389,2170660915,28821,36895,2024-10-04 19:19:32,0,0,0,0,0,0
4,201392389,2170660915,33961,36895,2024-10-04 19:19:33,0,0,0,0,0,0
4,201392389,2170660915,0,0,2024-10-04 19:19:33,0,0,0,0,0,0
4,201392389,2170660915,28821,36895,2024-10-04 19:19:33,0,0,0,0,0,0
4,201392389,2170660915,33961,36895,2024-10-04 19:19:34,0,0,0,0,0,0
4,201392389,2170660915,0,0,2024-10-04 19:19:34,0,0,0,0,0,0
4,201392389,2170660915,28821,36895,2024-10-04 19:19:34,0,0,0,0,0,0
4,201392389,2170660915,0,0,2024-10-04 19:19:35,0,0,0,0,0,0
4,201392389,2170660915,28821,36895,2024-10-04 19:19:35,0,0,0,0,0,0
4,201392389,2170660915,0,0,2024-10-04 19:19:36,0,0,0,0,0,0
4,201392389,2170660915,28821,36895,2024-10-04 19:19:36,0,0,0,0,0,0
4,201392389,2170660915,0,0,2024-10-04 19:19:37,0,0,0,0,0,0
4,201392389,2170660915,28821,36895,2024-10-04 19:19:37,0,0,0,0,0,0
4,201392389,2170660915,0,0,2024-10-04 19:19:38,0,0,0,0,0,0
4,201392389,2170660915,28821,36895,2024-10-04 19:19:38,0,0,0,0,0,0
4,201392389,2170660915,0,0,2024-10-04 19:19:39,0,0,0,0,0,0
4,201392389,2170660915,28821,36895,2024-10-04 19:19:39,0,0,0,0,0,0
4,201392389,2170660915,0,0,2024-10-04 19:19:40,0,0,0,0,0,0
4,201392389,2170660915,28821,36895,2024-10-04 19:19:40,0,0,0,0,0,0
4,201392389,2170660915,0,0,2024-10-04 19:19:41,0,0,0,0,0,0
4,201392389,2170660915,28821,36895,2024-10-04 19:19:41,0,0,0,0,0,0
4,201392389,2170660915,0,0,2024-10-04 19:19:42,0,0,0,0,0,0
4,201392389,2170660915,28821,36895,2024-10-04 19:19:42,0,0,0,0,0,0
4,201392389,2170660915,0,0,2024-10-04 19:19:43,0,0,0,0,0,0
4,201392389,2170660915,28821,36895,2024-10-04 19:19:43,0,0,0,0,0,0
4,201392389,2170660915,0,0,2024-10-04 19:19:44,0,0,0,0,0,0
4,201392389,2170660915,28821,36895,2024-10-04 19:19:44,0,0,0,0,0,0
4,201392389,2170660915,0,0,2024-10-04 19:19:45,0,0,0,0,0,0
4,201392389,2170660915,28821,36895,2024-10-04 19:19:45,0,0,0,0,0,0
4,201392389,2170660915,0,0,2024-10-04 19:19:46,0,0,0,0,0,0
4,201392389,2170660915,28821,36895,2024-10-04 19:19:46,0,0,0,0,0,0
4,201392389,2170660915,0,0,2024-10-04 19:19:47,0,0,0,0,0,0
4,201392389,2170660915,28821,36895,2024-10-04 19:19:47,0,0,0,0,0,0
4,201392389,2170660915,0,0,2024-10-04 19:19:48,0,0,0,0,0,0
4,201392389,2170660915,28821,36895,2024-10-04 19:19:48,0,0,0,0,0,0
4,201392389,2170660915,0,0,2024-10-04 19:19:49,0,0,0,0,0,0
4,201392389,2170660915,28821,36895,2024-10-04 19:19:49,0,0,0,0,0,0
4,201392389,2170660915,0,0,2024-10-04 19:19:50,0,0,0,0,0,0
4,201392389,2170660915,28821,36895,2024-10-04 19:19:50,0,0,0,0,0,0
4,201392389,2170660915,0,0,2024-10-04 19:19:51,0,0,0,0,0,0
4,201392389,2170660915,28821,36895,2024-10-04 19:19:51,0,0,0,0,0,0
4,201392389,2170660915,0,0,2024-10-04 19:19:52,0,0,0,0,0,0
4,201392389,2170660915,28821,36895,2024-10-04 19:19:52,0,0,0,0,0,0
4,201392389,2170660915,0,0,2024-10-04 19:19:53,0,0,0,0,0,0
4,201392389,2170660915,28821,36895,2024-10-04 19:19:53,0,0,0,0,0,0
4,201392389,2170660915,0,0,2024-10-04 19:19:54,0,0,0,0,0,0
4,201392389,2170660915,28821,36895,2024-10-04 19:19:54,0,0,0,0,0,0
4,201392389,2170660915,0,0,2024-10-04 19:19:55,0,0,0,0,0,0
4,201392389,2170660915,28821,36895,2024-10-04 19:19:55,0,0,0,0,0,0
4,201392389,2170660915,0,0,2024-10-04 19:19:56,0,0,0,0,0,0
4,201392389,2170660915,28821,36895,2024-10-04 19:19:56,0,0,0,0,0,0
4,201392389,2170660915,0,0,2024-10-04 19:19:57,0,0,0,0,0,0
4,201392389,2170660915,28821,36895,2024-10-04 19:19:57,0,0,0,0,0,0
4,201392389,2170660915,0,0,2024-10-04 19:19:58,0,0,0,0,0,0
4,201392389,2170660915,28821,36895,2024-10-04 19:19:58,0,0,0,0,0,0
4,201392389,2170660915,0,0,2024-10-04 19:19:59,0,0,0,0,0,0
4,201392389,2170660915,28821,36895,2024-10-04 19:19:59,0,0,0,0,0,0
4,201392389,2170660915,0,0,2024-10-04 19:20:00,0,0,0,0,0,0
4,201392389,2170660915,28821,36895,2024-10-04 19:20:00,0,0,0,0,0,0
4,201392389,2170660915,0,0,2024-10-04 19:20:01,0,0,0,0,0,0
4,201392389,2170660915,28821,36895,2024-10-04 19:20:01,0,0,0,0,0,0
4,201392389,2170660915,0,0,2024-10-04 19:20:02,0,0,0,0,0,0
4,201392389,2170660915,28821,36895,2024-10-04 19:20:02,0,0,0,0,0,0
4,201392389,2170660915,0,0,2024-10-04 19:20:03,0,0,0,0,0,0
4,201392389,2170660915,28821,36895,2024-10-04 19:20:03,0,0,0,0,0,0
4,201392389,2170660915,0,0,2024-10-04 19:20:04,0,0,0,0,0,0
4,201392389,2170660915,28821,36895,2024-10-04 19:20:04,0,0,0,0,0,0
4,201392389,2170660915,0,0,2024-10-04 19:20:05,0,0,0,0,0,0
4,201392389,2170660915,28821,36895,2024-10-04 19:20:05,0,0,0,0,0,0
4,201392389,2170660915,0,0,2024-10-04 19:20:06,0,0,0,0,0,0
4,201392389,2170660915,28821,36895,2024-10-04 19:20:06,0,0,0,0,0,0
4,201392389,2170660915,0,0,2024-10-04 19:20:07,0,0,0,0,0,0
4,201392389,2170660915,28821,36895,2024-10-04 19:20:07,0,0,0,0,0,0
4,201392389,2170660915,0,0,2024-10-04 19:20:08,0,0,0,0,0,0
4,201392389,2170660915,28821,36895,2024-10-04 19:20:08,0,0,0,0,0,0
4,201392389,2170660915,0,0,2024-10-04 19:20:09,0,0,0,0,0,0
4,201392389,2170660915,28821,36895,2024-10-04 19:20:09,0,0,0,0,0,0
4,201392389,2170660915,0,0,2024-10-04 19:20:10,0,0,0,0,0,0
4,201392389,2170660915,28821,36895,2024-10-04 19:20:10,0,0,0,0,0,0
4,201392389,2170660915,0,0,2024-10-04 19:20:11,0,0,0,0,0,0
4,201392389,2170660915,28821,36895,2024-10-04 19:20:11,0,0,0,0,0,0
4,201392389,2170660915,0,0,2024-10-04 19:20:12,0,0,0,0,0,0
4,201392389,2170660915,28821,36895,2024-10-04 19:20:12,0,0,0,0,0,0
4,201392389,2170660915,0,0,2024-10-04 19:20:13,0,0,0,0,0,0
4,201392389,2170660915,28821,36895,2024-10-04 19:20:13,0,0,0,0,0,0
4,201392389,2170660915,0,0,2024-10-04 19:20:14,0,0,0,0,0,0
4,201392389,2170660915,28821,36895,2024-10-04 19:20:14,0,0,0,0,0,0
4,201392389,2170660915,0,0,2024-10-04 19:20:15,0,0,0,0,0,0
4,201392389,2170660915,28821,36895,2024-10-04 19:20:15,0,0,0,0,0,0
4,201392389,2170660915,0,0,2024-10-04 19:20:16,0,0,0,0,0,0
4,201392389,2170660915,28821,36895,2024-10-04 19:20:16,0,0,0,0,0,0
4,201392389,2170660915,0,0,2024-10-04 19:20:17,0,0,0,0,0,0
4,201392389,2170660915,28821,36895,2024-10-04 19:20:17,0,0,0,0,0,0
4,201392389,2170660915,0,0,2024-10-04 19:20:18,0,0,0,0,0,0
4,201392389,2170660915,28821,36895,2024-10-04 19:20:18,0,0,0,0,0,0
4,201392389,2170660915,0,0,2024-10-04 19:20:19,0,0,0,0,0,0
4,201392389,2170660915,28821,36895,2024-10-04 19:20:19,0,0,0,0,0,0
4,201392389,2170660915,0,0,2024-10-04 19:20:20,0,0,0,0,0,0
4,201392389,2170660915,28821,36895,2024-10-04 19:20:20,0,0,0,0,0,0
4,201392389,2170660915,0,0,2024-10-04 19:20:21,0,0,0,0,0,0
4,201392389,2170660915,28821,36895,2024-10-04 19:20:21,0,0,0,0,0,0
4,201392389,2170660915,0,0,2024-10-04 19:20:22,0,0,0,0,0,0
4,201392389,2170660915,28821,36895,2024-10-04 19:20:22,0,0,0,0,0,0
4,201392389,2170660915,0,0,2024-10-04 19:20:23,0,0,0,0,0,0
4,201392389,2170660915,28821,36895,2024-10-04 19:20:23,0,0,0,0,0,0
4,201392389,2170660915,0,0,2024-10-04 19:20:24,0,0,0,0,0,0
4,201392389,2170660915,28821,36895,2024-10-04 19:20:24,0,0,0,0,0,0
4,201392389,2170660915,0,0,2024-10-04 19:20:25,0,0,0,0,0,0
4,201392389,2170660915,28821,36895,2024-10-04 19:20:25,0,0,0,0,0,0
4,201392389,2170660915,0,0,2024-10-04 19:20:26,0,0,0,0,0,0
4,201392389,2170660915,28821,36895,2024-10-04 19:20:26,0,0,0,0,0,0
4,201392389,2170660915,0,0,2024-10-04 19:20:27,0,0,0,0,0,0
4,201392389,2170660915,28821,36895,2024-10-04 19:20:27,0,0,0,0,0,0
4,201392389,2170660915,0,0,2024-10-04 19:20:28,0,0,0,0,0,0
4,201392389,2170660915,28821,36895,2024-10-04 19:20:28,0,0,0,0,0,0
4,201392389,2170660915,0,0,2024-10-04 19:20:29,0,0,0,0,0,0
4,201392389,2170660915,28821,36895,2024-10-04 19:20:29,0,0,0,0,0,0
4,201392389,2170660915,0,0,2024-10-04 19:20:30,0,0,0,0,0,0
4,201392389,2170660915,28821,36895,2024-10-04 19:20:30,0,0,0,0,0,0
4,201392389,2170660915,0,0,2024-10-04 19:20:31,0,0,0,0,0,0
4,201392389,2170660915,28821,36895,2024-10-04 19:20:31,0,0,0,0,0,0
4,201392389,2170660915,0,0,2024-10-04 19:20:32,0,0,0,0,0,0
4,201392389,2170660915,28821,36895,2024-10-04 19:20:32,0,0,0,0,0,0
4,201392389,2170660915,0,0,2024-10-04 19:20:33,0,0,0,0,0,0
4,201392389,2170660915,28821,36895,2024-10-04 19:20:33,0,0,0,0,0,0
4,201392389,2170660915,28821,36895,2024-10-04 19:20:34,0,0,0,0,0,0
4,201392389,2170660915,28821,36895,2024-10-04 19:20:35,0,0,0,0,0,0
4,201392389,2170660915,28821,36895,2024-10-04 19:20:36,0,0,0,0,0,0
4,201392389,2170660915,28821,36895,2024-10-04 19:20:37,0,0,0,0,0,0
4,201392389,2170660915,28821,36895,2024-10-04 19:20:38,0,0,0,0,0,0
4,201392389,2170660915,28821,36895,2024-10-04 19:20:39,0,0,0,0,0,0
4,201392389,2170660915,28821,36895,2024-10-04 19:20:40,0,0,0,0,0,0
4,201392389,2170660915,28821,36895,2024-10-04 19:20:41,0,0,0,0,0,0
4,201392389,2170660915,28821,36895,2024-10-04 19:20:42,0,0,0,0,0,0
4,201392389,2170660915,28821,36895,2024-10-04 19:20:43,0,0,0,0,0,0
4,201392389,2170660915,28821,36895,2024-10-04 19:20:44,0,0,0,0,0,0
4,201392389,2170660915,28821,36895,2024-10-04 19:20:45,0,0,0,0,0,0
4,201392389,2170660915,28821,36895,2024-10-04 19:20:46,0,0,0,0,0,0
4,201392389,2170660915,28821,36895,2024-10-04 19:20:47,0,0,0,0,0,0
4,201392389,2170660915,28821,36895,2024-10-04 19:20:48,0,0,0,0,0,0
4,201392389,2170660915,28821,36895,2024-10-04 19:20:49,0,0,0,0,0,0
4,201392389,2170660915,28821,36895,2024-10-04 19:20:50,0,0,0,0,0,0
4,201392389,2170660915,28821,36895,2024-10-04 19:20:51,0,0,0,0,0,0
4,201392389,2170660915,28821,36895,2024-10-04 19:20:52,0,0,0,0,0,0
4,201392389,2170660915,28821,36895,2024-10-04 19:20:53,0,0,0,0,0,0
4,201392389,2170660915,28821,36895,2024-10-04 19:20:54,0,0,0,0,0,0
4,201392389,2170660915,28821,36895,2024-10-04 19:20:55,0,0,0,0,0,0
4,201392389,2170660915,28821,36895,2024-10-04 19:20:56,0,0,0,0,0,0
4,201392389,2170660915,28821,36895,2024-10-04 19:20:57,0,0,0,0,0,0
4,201392389,2170660915,28821,36895,2024-10-04 19:20:58,0,0,0,0,0,0
4,201392389,2170660915,28821,36895,2024-10-04 19:20:59,0,0,0,0,0,0
4,201392389,2170660915,28821,36895,2024-10-04 19:21:00,0,0,0,0,0,0
4,201392389,2170660915,28821,36895,2024-10-04 19:21:01,0,0,0,0,0,0
4,201392389,2170660915,28821,36895,2024-10-04 19:21:02,0,0,0,0,0,0
4,201392389,2170660915,28821,36895,2024-10-04 19:21:03,0,0,0,0,0,0
4,201392389,2170660915,28821,36895,2024-10-04 19:21:04,0,0,0,0,0,0
4,201392389,2170660915,28821,36895,2024-10-04 19:21:05,0,0,0,0,0,0
4,201392389,2170660915,28821,36895,2024-10-04 19:21:06,0,0,0,0,0,0
4,201392389,2170660915,28821,36895,2024-10-04 19:21:07,0,0,0,0,0,0
4,201392389,2170660915,28821,36895,2024-10-04 19:21:08,0,0,0,0,0,0
4,201392389,2170660915,28821,36895,2024-10-04 19:21:09,0,0,0,0,0,0
4,201392389,2170660915,28821,36895,2024-10-04 19:21:10,0,0,0,0,0,0
4,201392389,2170660915,28821,36895,2024-10-04 19:21:11,0,0,0,0,0,0
4,201392389,2170660915,28821,36895,2024-10-04 19:21:12,0,0,0,0,0,0
4,201392389,2170660915,28821,36895,2024-10-04 19:21:13,0,0,0,0,0,0
4,201392389,2170660915,28821,36895,2024-10-04 19:21:14,0,0,0,0,0,0
4,201392389,2170660915,28821,36895,2024-10-04 19:21:15,0,0,0,0,0,0
4,201392389,2170660915,28821,36895,2024-10-04 19:21:16,0,0,0,0,0,0
4,201392389,2170660915,28821,36895,2024-10-04 19:21:17,0,0,0,0,0,0
4,201392389,2170660915,28821,36895,2024-10-04 19:21:18,0,0,0,0,0,0
4,201392389,2170660915,28821,36895,2024-10-04 19:21:19,0,0,0,0,0,0
4,201392389,2170660915,28821,36895,2024-10-04 19:21:20,0,0,0,0,0,0
4,201392389,2170660915,28821,36895,2024-10-04 19:21:21,0,0,0,0,0,0
4,201392389,2170660915,28821,36895,2024-10-04 19:21:22,0,0,0,0,0,0
4,201392389,2170660915,28821,36895,2024-10-04 19:21:23,0,0,0,0,0,0
4,201392389,2170660915,28821,36895,2024-10-04 19:21:24,0,0,0,0,0,0
4,201392389,2170660915,28821,36895,2024-10-04 19:21:25,0,0,0,0,0,0
4,201392389,2170660915,28821,36895,2024-10-04 19:21:26,0,0,0,0,0,0
4,201392389,2170660915,28821,36895,2024-10-04 19:21:27,0,0,0,0,0,0
4,201392389,2170660915,28821,36895,2024-10-04 19:21:28,0,0,0,0,0,0
4,201392389,2170660915,28821,36895,2024-10-04 19:21:29,0,0,0,0,0,0
4,201392389,2170660915,28821,36895,2024-10-04 19:21:30,0,0,0,0,0,0
4,201392389,2170660915,28821,36895,2024-10-04 19:21:31,0,0,0,0,0,0
4,201392389,2170660915,28821,36895,2024-10-04 19:21:32,0,0,0,0,0,0
4,201392389,2170660915,28821,36895,2024-10-04 19:21:33,0,0,0,0,0,0
4,201392389,2170660915,28821,36895,2024-10-04 19:21:34,0,0,0,0,0,0
4,201392389,2170660915,28821,36895,2024-10-04 19:21:35,0,0,0,0,0,0
4,201392389,2170660915,28821,36895,2024-10-04 19:21:36,0,0,0,0,0,0
4,201392389,2170660915,28821,36895,2024-10-04 19:21:37,0,0,0,0,0,0
4,201392389,2170660915,28821,36895,2024-10-04 19:21:38,0,0,0,0,0,0
4,201392389,2170660915,28821,36895,2024-10-04 19:21:39,0,0,0,0,0,0
4,201392389,2170660915,28821,36895,2024-10-04 19:21:40,0,0,0,0,0,0
4,201392389,2170660915,28821,36895,2024-10-04 19:21:41,0,0,0,0,0,0
4,201392389,2170660915,28821,36895,2024-10-04 19:21:42,0,0,0,0,0,0
4,201392389,2170660915,28821,36895,2024-10-04 19:21:43,0,0,0,0,0,0
4,201392389,2170660915,28821,36895,2024-10-04 19:21:44,0,0,0,0,0,0
4,201392389,2170660915,28821,36895,2024-10-04 19:21:45,0,0,0,0,0,0
4,201392389,2170660915,28821,36895,2024-10-04 19:21:46,0,0,0,0,0,0
4,201392389,2170660915,28821,36895,2024-10-04 19:21:47,0,0,0,0,0,0
4,201392389,2170660915,28821,36895,2024-10-04 19:21:48,0,0,0,0,0,0
4,201392389,2170660915,28821,36895,2024-10-04 19:21:49,0,0,0,0,0,0
4,201392389,2170660915,28821,36895,2024-10-04 19:21:50,0,0,0,0,0,0
4,201392389,2170660915,28821,36895,2024-10-04 19:21:51,0,0,0,0,0,0
4,201392389,2170660915,28821,36895,2024-10-04 19:21:52,0,0,0,0,0,0
4,201392389,2170660915,28821,36895,2024-10-04 19:21:53,0,0,0,0,0,0
4,201392389,2170660915,28821,36895,2024-10-04 19:21:54,0,0,0,0,0,0
4,201392389,2170660915,28821,36895,2024-10-04 19:21:55,0,0,0,0,0,0
4,201392389,2170660915,28821,36895,2024-10-04 19:21:56,0,0,0,0,0,0
4,201392389,2170660915,28821,36895,2024-10-04 19:21:57,0,0,0,0,0,0
4,201392389,2170660915,28821,36895,2024-10-04 19:21:58,0,0,0,0,0,0
4,201392389,2170660915,28821,36895,2024-10-04 19:21:59,0,0,0,0,0,0
4,201392389,2170660915,28821,36895,2024-10-04 19:22:00,0,0,0,0,0,0
4,201392389,2170660915,28821,36895,2024-10-04 19:22:01,0,0,0,0,0,0
4,201392389,2170660915,28821,36895,2024-10-04 19:22:02,0,0,0,0,0,0
4,201392389,2170660915,28821,36895,2024-10-04 19:22:03,0,0,0,0,0,0
4,201392389,2170660915,28821,36895,2024-10-04 19:22:04,0,0,0,0,0,0
4,201392389,2170660915,28821,36895,2024-10-04 19:22:05,0,0,0,0,0,0
4,201392389,2170660915,28821,36895,2024-10-04 19:22:06,0,0,0,0,0,0
4,201392389,2170660915,28821,36895,2024-10-04 19:22:07,0,0,0,0,0,0
4,201392389,2170660915,28821,36895,2024-10-04 19:22:08,0,0,0,0,0,0
4,201392389,2170660915,28821,36895,2024-10-04 19:22:09,0,0,0,0,0,0
4,201392389,2170660915,28821,36895,2024-10-04 19:22:10,0,0,0,0,0,0
4,201392389,2170660915,28821,36895,2024-10-04 19:22:11,0,0,0,0,0,0
4,201392389,2170660915,28821,36895,2024-10-04 19:22:12,0,0,0,0,0,0
4,201392389,2170660915,28821,36895,2024-10-04 19:22:13,0,0,0,0,0,0
4,201392389,2170660915,28821,36895,2024-10-04 19:22:14,0,0,0,0,0,0
4,201392389,2170660915,28821,36895,2024-10-04 19:22:15,0,0,0,0,0,0
4,201392389,2170660915,28821,36895,2024-10-04 19:22:16,0,0,0,0,0,0
4,201392389,2170660915,28821,36895,2024-10-04 19:22:17,0,0,0,0,0,0
4,201392389,2170660915,28821,36895,2024-10-04 19:22:18,0,0,0,0,0,0
4,201392389,2170660915,28821,36895,2024-10-04 19:22:19,0,0,0,0,0,0
4,201392389,2170660915,28821,36895,2024-10-04 19:22:20,0,0,0,0,0,0
4,201392389,2170660915,28821,36895,2024-10-04 19:22:21,0,0,0,0,0,0
4,201392389,2170660915,28821,36895,2024-10-04 19:22:22,0,0,0,0,0,0
4,201392389,2170660915,28821,36895,2024-10-04 19:22:23,0,0,0,0,0,0
4,201392389,2170660915,28821,36895,2024-10-04 19:22:24,0,0,0,0,0,0
4,201392389,2170660915,28821,36895,2024-10-04 19:22:25,0,0,0,0,0,0
4,201392389,2170660915,28821,36895,2024-10-04 19:22:26,0,0,0,0,0,0
4,201392389,2170660915,28821,36895,2024-10-04 19:22:27,0,0,0,0,0,0
4,201392389,2170660915,28821,36895,2024-10-04 19:22:28,0,0,0,0,0,0
4,201392389,2170660915,28821,36895,2024-10-04 19:22:29,0,0,0,0,0,0
4,201392389,2170660915,28821,36895,2024-10-04 19:22:30,0,0,0,0,0,0
4,201392389,2170660915,28821,36895,2024-10-04 19:22:31,0,0,0,0,0,0
4,201392389,2170660915,28821,36895,2024-10-04 19:22:32,0,0,0,0,0,0
4,201392389,2170660915,28821,36895,2024-10-04 19:22:33,0,0,0,0,0,0
4,201392389,2170660915,28821,36895,2024-10-04 19:22:34,0,0,0,0,0,0
4,201392389,2170660915,28821,36895,2024-10-04 19:22:35,0,0,0,0,0,0
4,201392389,2170660915,28821,36895,2024-10-04 19:22:36,0,0,0,0,0,0
4,201392389,2170660915,28821,36895,2024-10-04 19:22:37,0,0,0,0,0,0
4,201392389,2170660915,28821,36895,2024-10-04 19:22:38,0,0,0,0,0,0
4,201392389,2170660915,28821,36895,2024-10-04 19:22:39,0,0,0,0,0,0
4,201392389,2170660915,28821,36895,2024-10-04 19:22:40,0,0,0,0,0,0
4,201392389,2170660915,28821,36895,2024-10-04 19:22:41,0,0,0,0,0,0
4,201392389,2170660915,28821,36895,2024-10-04 19:22:42,0,0,0,0,0,0
4,201392389,2170660915,28821,36895,2024-10-04 19:22:43,0,0,0,0,0,0
4,201392389,2170660915,28821,36895,2024-10-04 19:22:44,0,0,0,0,0,0
4,201392389,2170660915,28821,36895,2024-10-04 19:22:45,0,0,0,0,0,0
4,201392389,2170660915,28821,36895,2024-10-04 19:22:46,0,0,0,0,0,0
4,201392389,2170660915,28821,36895,2024-10-04 19:22:47,0,0,0,0,0,0
4,201392389,2170660915,28821,36895,2024-10-04 19:22:48,0,0,0,0,0,0
4,201392389,2170660915,28821,36895,2024-10-04 19:22:49,0,0,0,0,0,0
4,201392389,2170660915,28821,36895,2024-10-04 19:22:50,0,0,0,0,0,0
4,201392389,2170660915,28821,36895,2024-10-04 19:22:51,0,0,0,0,0,0
4,201392389,2170660915,28821,36895,2024-10-04 19:22:52,0,0,0,0,0,0
4,201392389,2170660915,28821,36895,2024-10-04 19:22:53,0,0,0,0,0,0
4,201392389,2170660915,28821,36895,2024-10-04 19:22:54,0,0,0,0,0,0
4,201392389,2170660915,28821,36895,2024-10-04 19:22:55,0,0,0,0,0,0
4,201392389,2170660915,28821,36895,2024-10-04 19:22:56,0,0,0,0,0,0
4,201392389,2170660915,28821,36895,2024-10-04 19:22:57,0,0,0,0,0,0
4,201392389,2170660915,28821,36895,2024-10-04 19:22:58,0,0,0,0,0,0
4,201392389,2170660915,28821,36895,2024-10-04 19:22:59,0,0,0,0,0,0
4,201392389,2170660915,28821,36895,2024-10-04 19:23:00,0,0,0,0,0,0
4,201392389,2170660915,28821,36895,2024-10-04 19:23:01,0,0,0,0,0,0
4,201392389,2170660915,28821,36895,2024-10-04 19:23:02,0,0,0,0,0,0
4,201392389,2170660915,28821,36895,2024-10-04 19:23:03,0,0,0,0,0,0
4,201392389,2170660915,28821,36895,2024-10-04 19:23:04,0,0,0,0,0,0
4,201392389,2170660915,28821,36895,2024-10-04 19:23:05,0,0,0,0,0,0
4,201392389,2170660915,28821,36895,2024-10-04 19:23:06,0,0,0,0,0,0
4,201392389,2170660915,28821,36895,2024-10-04 19:23:07,0,0,0,0,0,0
4,201392389,2170660915,28821,36895,2024-10-04 19:23:08,0,0,0,0,0,0
4,201392389,2170660915,28821,36895,2024-10-04 19:23:09,0,0,0,0,0,0
4,201392389,2170660915,28821,36895,2024-10-04 19:23:10,0,0,0,0,0,0
4,201392389,2170660915,28821,36895,2024-10-04 19:23:11,0,0,0,0,0,0
4,201392389,2170660915,28821,36895,2024-10-04 19:23:12,0,0,0,0,0,0
4,201392389,2170660915,28821,36895,2024-10-04 19:23:13,0,0,0,0,0,0
4,201392389,2170660915,28821,36895,2024-10-04 19:23:14,0,0,0,0,0,0
4,201392389,2170660915,28821,36895,2024-10-04 19:23:15,0,0,0,0,0,0
4,201392389,2170660915,28821,36895,2024-10-04 19:23:16,0,0,0,0,0,0
4,201392389,2170660915,28821,36895,2024-10-04 19:23:17,0,0,0,0,0,0
4,201392389,2170660915,28821,36895,2024-10-04 19:23:18,0,0,0,0,0,0
4,201392389,2170660915,28821,36895,2024-10-04 19:23:19,0,0,0,0,0,0
4,201392389,2170660915,28821,36895,2024-10-04 19:23:20,0,0,0,0,0,0
4,201392389,2170660915,28821,36895,2024-10-04 19:23:21,0,0,0,0,0,0
4,201392389,2170660915,28821,36895,2024-10-04 19:23:22,0,0,0,0,0,0
4,201392389,2170660915,28821,36895,2024-10-04 19:23:23,0,0,0,0,0,0
4,201392389,2170660915,28821,36895,2024-10-04 19:23:24,0,0,0,0,0,0
4,201392389,2170660915,28821,36895,2024-10-04 19:23:25,0,0,0,0,0,0
4,201392389,2170660915,28821,36895,2024-10-04 19:23:26,0,0,0,0,0,0
4,201392389,2170660915,28821,36895,2024-10-04 19:23:27,0,0,0,0,0,0
4,201392389,2170660915,28821,36895,2024-10-04 19:23:28,0,0,0,0,0,0
4,201392389,2170660915,28821,36895,2024-10-04 19:23:29,0,0,0,0,0,0
4,201392389,2170660915,28821,36895,2024-10-04 19:23:30,0,0,0,0,0,0
4,201392389,2170660915,28821,36895,2024-10-04 19:23:31,0,0,0,0,0,0
4,201392389,2170660915,28821,36895,2024-10-04 19:23:32,0,0,0,0,0,0
4,201392389,2170660915,28821,36895,2024-10-04 19:23:33,0,0,0,0,0,0
4,201392389,2170660915,28821,36895,2024-10-04 19:23:34,0,0,0,0,0,0
4,201392389,2170660915,28821,36895,2024-10-04 19:23:35,0,0,0,0,0,0
4,201392389,2170660915,28821,36895,2024-10-04 19:23:36,0,0,0,0,0,0
4,201392389,2170660915,28821,36895,2024-10-04 19:23:37,0,0,0,0,0,0
4,201392389,2170660915,28821,36895,2024-10-04 19:23:38,0,0,0,0,0,0
4,201392389,2170660915,28821,36895,2024-10-04 19:23:39,0,0,0,0,0,0
4,201392389,2170660915,28821,36895,2024-10-04 19:23:40,0,0,0,0,0,0
4,201392389,2170660915,28821,36895,2024-10-04 19:23:41,0,0,0,0,0,0
4,201392389,2170660915,28821,36895,2024-10-04 19:23:42,0,0,0,0,0,0
4,201392389,2170660915,28821,36895,2024-10-04 19:23:43,0,0,0,0,0,0
4,201392389,2170660915,28821,36895,2024-10-04 19:23:44,0,0,0,0,0,0
4,201392389,2170660915,28821,36895,2024-10-04 19:23:45,0,0,0,0,0,0
4,201392389,2170660915,28821,36895,2024-10-04 19:23:46,0,0,0,0,0,0
4,201392389,2170660915,28821,36895,2024-10-04 19:23:47,0,0,0,0,0,0
4,201392389,2170660915,28821,36895,2024-10-04 19:23:48,0,0,0,0,0,0
4,201392389,2170660915,28821,36895,2024-10-04 19:23:49,0,0,0,0,0,0
4,201392389,2170660915,28821,36895,2024-10-04 19:23:50,0,0,0,0,0,0
4,201392389,2170660915,28821,36895,2024-10-04 19:23:51,0,0,0,0,0,0
4,201392389,2170660915,28821,36895,2024-10-04 19:23:52,0,0,0,0,0,0
4,201392389,2170660915,28821,36895,2024-10-04 19:23:53,0,0,0,0,0,0
4,201392389,2170660915,28821,36895,2024-10-04 19:23:54,0,0,0,0,0,0
4,201392389,2170660915,28821,36895,2024-10-04 19:23:55,0,0,0,0,0,0
4,201392389,2170660915,28821,36895,2024-10-04 19:23:56,0,0,0,0,0,0
4,201392389,2170660915,28821,36895,2024-10-04 19:23:57,0,0,0,0,0,0
4,201392389,2170660915,28821,36895,2024-10-04 19:23:58,0,0,0,0,0,0
4,201392389,2170660915,28821,36895,2024-10-04 19:23:59,0,0,0,0,0,0
4,201392389,2170660915,28821,36895,2024-10-04 19:24:00,0,0,0,0,0,0
4,201392389,2170660915,28821,36895,2024-10-04 19:24:01,0,0,0,0,0,0
4,201392389,2170660915,28821,36895,2024-10-04 19:24:02,0,0,0,0,0,0
4,201392389,2170660915,28821,36895,2024-10-04 19:24:03,0,0,0,0,0,0
4,201392389,2170660915,28821,36895,2024-10-04 19:24:04,0,0,0,0,0,0
4,201392389,2170660915,28821,36895,2024-10-04 19:24:05,0,0,0,0,0,0
4,201392389,2170660915,28821,36895,2024-10-04 19:24:06,0,0,0,0,0,0
4,201392389,2170660915,28821,36895,2024-10-04 19:24:07,0,0,0,0,0,0
4,201392389,2170660915,28821,36895,2024-10-04 19:24:08,0,0,0,0,0,0
4,201392389,2170660915,28821,36895,2024-10-04 19:24:09,0,0,0,0,0,0
4,201392389,2170660915,28821,36895,2024-10-04 19:24:10,0,0,0,0,0,0
4,201392389,2170660915,28821,36895,2024-10-04 19:24:11,0,0,0,0,0,0
4,201392389,2170660915,28821,36895,2024-10-04 19:24:12,0,0,0,0,0,0
4,201392389,2170660915,28821,36895,2024-10-04 19:24:13,0,0,0,0,0,0
4,201392389,2170660915,28821,36895,2024-10-04 19:24:14,0,0,0,0,0,0
4,201392389,2170660915,28821,36895,2024-10-04 19:24:15,0,0,0,0,0,0
4,201392389,2170660915,28821,36895,2024-10-04 19:24:16,0,0,0,0,0,0
4,201392389,2170660915,28821,36895,2024-10-04 19:24:17,0,0,0,0,0,0
4,201392389,2170660915,28821,36895,2024-10-04 19:24:18,0,0,0,0,0,0
4,201392389,2170660915,28821,36895,2024-10-04 19:24:19,0,0,0,0,0,0
4,201392389,2170660915,28821,36895,2024-10-04 19:24:20,0,0,0,0,0,0
4,201392389,2170660915,28821,36895,2024-10-04 19:24:21,0,0,0,0,0,0
4,201392389,2170660915,28821,36895,2024-10-04 19:24:22,0,0,0,0,0,0
4,201392389,2170660915,28821,36895,2024-10-04 19:24:23,0,0,0,0,0,0
4,201392389,2170660915,28821,36895,2024-10-04 19:24:24,0,0,0,0,0,0
4,201392389,2170660915,28821,36895,2024-10-04 19:24:25,0,0,0,0,0,0
4,201392389,2170660915,28821,36895,2024-10-04 19:24:26,0,0,0,0,0,0
4,201392389,2170660915,28821,36895,2024-10-04 19:24:27,0,0,0,0,0,0
4,201392389,2170660915,28821,36895,2024-10-04 19:24:28,0,0,0,0,0,0
4,201392389,2170660915,28821,36895,2024-10-04 19:24:29,0,0,0,0,0,0
4,201392389,2170660915,28821,36895,2024-10-04 19:24:30,0,0,0,0,0,0
4,201392389,2170660915,28821,36895,2024-10-04 19:24:31,0,0,0,0,0,0
4,201392389,2170660915,28821,36895,2024-10-04 19:24:32,0,0,0,0,0,0
4,201392389,2170660915,28821,36895,2024-10-04 19:24:33,0,0,0,0,0,0
4,201392389,2170660915,28821,36895,2024-10-04 19:24:34,0,0,0,0,0,0
4,201392389,2170660915,28821,36895,2024-10-04 19:24:35,0,0,0,0,0,0
4,201392389,2170660915,28821,36895,2024-10-04 19:24:36,0,0,0,0,0,0
4,201392389,2170660915,28821,36895,2024-10-04 19:24:37,0,0,0,0,0,0
4,201392389,2170660915,28821,36895,2024-10-04 19:24:38,0,0,0,0,0,0
4,201392389,2170660915,28821,36895,2024-10-04 19:24:39,0,0,0,0,0,0
4,201392389,2170660915,28821,36895,2024-10-04 19:24:40,0,0,0,0,0,0
4,201392389,2170660915,28821,36895,2024-10-04 19:24:41,0,0,0,0,0,0
4,201392389,2170660915,28821,36895,2024-10-04 19:24:42,0,0,0,0,0,0
4,201392389,2170660915,28821,36895,2024-10-04 19:24:43,0,0,0,0,0,0
4,201392389,2170660915,28821,36895,2024-10-04 19:24:44,0,0,0,0,0,0
4,201392389,2170660915,28821,36895,2024-10-04 19:24:45,0,0,0,0,0,0
4,201392389,2170660915,28821,36895,2024-10-04 19:24:46,0,0,0,0,0,0
4,201392389,2170660915,28821,36895,2024-10-04 19:24:47,0,0,0,0,0,0
4,201392389,2170660915,28821,36895,2024-10-04 19:24:48,0,0,0,0,0,0
4,201392389,2170660915,28821,36895,2024-10-04 19:24:49,0,0,0,0,0,0
4,201392389,2170660915,28821,36895,2024-10-04 19:24:50,0,0,0,0,0,0
4,201392389,2170660915,28821,36895,2024-10-04 19:24:51,0,0,0,0,0,0
4,201392389,2170660915,28821,36895,2024-10-04 19:24:52,0,0,0,0,0,0
4,201392389,2170660915,28821,36895,2024-10-04 19:24:53,0,0,0,0,0,0
4,201392389,2170660915,28821,36895,2024-10-04 19:24:54,0,0,0,0,0,0
4,201392389,2170660915,28821,36895,2024-10-04 19:24:55,0,0,0,0,0,0
4,201392389,2170660915,28821,36895,2024-10-04 19:24:56,0,0,0,0,0,0
4,201392389,2170660915,28821,36895,2024-10-04 19:24:57,0,0,0,0,0,0
4,201392389,2170660915,28821,36895,2024-10-04 19:24:58,0,0,0,0,0,0
4,201392389,2170660915,28821,36895,2024-10-04 19:24:59,0,0,0,0,0,0
4,201392389,2170660915,28821,36895,2024-10-04 19:25:00,0,0,0,0,0,0
4,201392389,2170660915,28821,36895,2024-10-04 19:25:01,0,0,0,0,0,0
4,201392389,2170660915,28821,36895,2024-10-04 19:25:02,0,0,0,0,0,0
4,201392389,2170660915,28821,36895,2024-10-04 19:25:03,0,0,0,0,0,0
4,201392389,2170660915,28821,36895,2024-10-04 19:25:04,0,0,0,0,0,0
4,201392389,2170660915,28821,36895,2024-10-04 19:25:05,0,0,0,0,0,0
4,201392389,2170660915,28821,36895,2024-10-04 19:25:06,0,0,0,0,0,0
4,201392389,2170660915,28821,36895,2024-10-04 19:25:07,0,0,0,0,0,0
4,201392389,2170660915,28821,36895,2024-10-04 19:25:08,0,0,0,0,0,0
4,201392389,2170660915,28821,36895,2024-10-04 19:25:09,0,0,0,0,0,0
4,201392389,2170660915,28821,36895,2024-10-04 19:25:10,0,0,0,0,0,0
4,201392389,2170660915,28821,36895,2024-10-04 19:25:11,0,0,0,0,0,0
4,201392389,2170660915,28821,36895,2024-10-04 19:25:12,0,0,0,0,0,0
4,201392389,2170660915,28821,36895,2024-10-04 19:25:13,0,0,0,0,0,0
4,201392389,2170660915,28821,36895,2024-10-04 19:25:14,0,0,0,0,0,0
4,201392389,2170660915,28821,36895,2024-10-04 19:25:15,0,0,0,0,0,0
4,201392389,2170660915,28821,36895,2024-10-04 19:25:16,0,0,0,0,0,0
4,201392389,2170660915,28821,36895,2024-10-04 19:25:17,0,0,0,0,0,0
4,201392389,2170660915,28821,36895,2024-10-04 19:25:18,0,0,0,0,0,0
4,201392389,2170660915,28821,36895,2024-10-04 19:25:19,0,0,0,0,0,0
4,201392389,2170660915,28821,36895,2024-10-04 19:25:20,0,0,0,0,0,0
4,201392389,2170660915,28821,36895,2024-10-04 19:25:21,0,0,0,0,0,0
4,201392389,2170660915,28821,36895,2024-10-04 19:25:22,0,0,0,0,0,0
4,201392389,2170660915,28821,36895,2024-10-04 19:25:23,0,0,0,0,0,0
4,201392389,2170660915,28821,36895,2024-10-04 19:25:24,0,0,0,0,0,0
4,201392389,2170660915,28821,36895,2024-10-04 19:25:25,0,0,0,0,0,0
4,201392389,2170660915,28821,36895,2024-10-04 19:25:26,0,0,0,0,0,0
4,201392389,2170660915,28821,36895,2024-10-04 19:25:27,0,0,0,0,0,0
4,201392389,2170660915,28821,36895,2024-10-04 19:25:28,0,0,0,0,0,0
4,201392389,2170660915,28821,36895,2024-10-04 19:25:29,0,0,0,0,0,0
4,201392389,2170660915,28821,36895,2024-10-04 19:25:30,0,0,0,0,0,0
4,201392389,2170660915,28821,36895,2024-10-04 19:25:31,0,0,0,0,0,0
4,201392389,2170660915,28821,36895,2024-10-04 19:25:32,0,0,0,0,0,0
4,201392389,2170660915,28821,36895,2024-10-04 19:25:33,0,0,0,0,0,0
4,201392389,2170660915,28821,36895,2024-10-04 19:25:34,0,0,0,0,0,0
4,201392389,2170660915,28821,36895,2024-10-04 19:25:35,0,0,0,0,0,0
4,201392389,2170660915,28821,36895,2024-10-04 19:25:36,0,0,0,0,0,0
4,201392389,2170660915,28821,36895,2024-10-04 19:25:37,0,0,0,0,0,0
4,201392389,2170660915,28821,36895,2024-10-04 19:25:38,0,0,0,0,0,0
4,201392389,2170660915,28821,36895,2024-10-04 19:25:39,0,0,0,0,0,0
4,201392389,2170660915,28821,36895,2024-10-04 19:25:40,0,0,0,0,0,0
4,201392389,2170660915,28821,36895,2024-10-04 19:25:41,0,0,0,0,0,0
4,201392389,2170660915,28821,36895,2024-10-04 19:25:42,0,0,0,0,0,0
4,201392389,2170660915,28821,36895,2024-10-04 19:25:43,0,0,0,0,0,0
4,201392389,2170660915,28821,36895,2024-10-04 19:25:44,0,0,0,0,0,0
4,201392389,2170660915,28821,36895,2024-10-04 19:25:45,0,0,0,0,0,0
4,201392389,2170660915,28821,36895,2024-10-04 19:25:46,0,0,0,0,0,0
4,201392389,2170660915,28821,36895,2024-10-04 19:25:47,0,0,0,0,0,0
4,201392389,2170660915,28821,36895,2024-10-04 19:25:48,0,0,0,0,0,0
4,201392389,2170660915,28821,36895,2024-10-04 19:25:49,0,0,0,0,0,0
4,201392389,2170660915,28821,36895,2024-10-04 19:25:50,0,0,0,0,0,0
4,201392389,2170660915,28821,36895,2024-10-04 19:25:51,0,0,0,0,0,0
4,201392389,2170660915,28821,36895,2024-10-04 19:25:52,0,0,0,0,0,0
4,201392389,2170660915,28821,36895,2024-10-04 19:25:53,0,0,0,0,0,0
4,201392389,2170660915,28821,36895,2024-10-04 19:25:54,0,0,0,0,0,0
4,201392389,2170660915,28821,36895,2024-10-04 19:25:55,0,0,0,0,0,0
4,201392389,2170660915,28821,36895,2024-10-04 19:25:56,0,0,0,0,0,0
4,201392389,2170660915,28821,36895,2024-10-04 19:25:57,0,0,0,0,0,0
4,201392389,2170660915,28821,36895,2024-10-04 19:25:58,0,0,0,0,0,0
4,201392389,2170660915,28821,36895,2024-10-04 19:25:59,0,0,0,0,0,0
4,201392389,2170660915,28821,36895,2024-10-04 19:26:00,0,0,0,0,0,0
4,201392389,2170660915,28821,36895,2024-10-04 19:26:01,0,0,0,0,0,0
4,201392389,2170660915,28821,36895,2024-10-04 19:26:02,0,0,0,0,0,0
4,201392389,2170660915,28821,36895,2024-10-04 19:26:03,0,0,0,0,0,0
4,201392389,2170660915,28821,36895,2024-10-04 19:26:04,0,0,0,0,0,0
4,201392389,2170660915,28821,36895,2024-10-04 19:26:05,0,0,0,0,0,0
4,201392389,2170660915,28821,36895,2024-10-04 19:26:06,0,0,0,0,0,0
4,201392389,2170660915,28821,36895,2024-10-04 19:26:07,0,0,0,0,0,0
4,201392389,2170660915,28821,36895,2024-10-04 19:26:08,0,0,0,0,0,0
4,201392389,2170660915,28821,36895,2024-10-04 19:26:09,0,0,0,0,0,0
4,201392389,2170660915,28821,36895,2024-10-04 19:26:10,0,0,0,0,0,0
4,201392389,2170660915,28821,36895,2024-10-04 19:26:11,0,0,0,0,0,0
4,201392389,2170660915,28821,36895,2024-10-04 19:26:12,0,0,0,0,0,0
4,201392389,2170660915,28821,36895,2024-10-04 19:26:13,0,0,0,0,0,0
4,201392389,2170660915,28821,36895,2024-10-04 19:26:14,0,0,0,0,0,0
4,201392389,2170660915,28821,36895,2024-10-04 19:26:15,0,0,0,0,0,0
4,201392389,2170660915,28821,36895,2024-10-04 19:26:16,0,0,0,0,0,0
4,201392389,2170660915,28821,36895,2024-10-04 19:26:17,0,0,0,0,0,0
4,201392389,2170660915,28821,36895,2024-10-04 19:26:18,0,0,0,0,0,0
4,201392389,2170660915,28821,36895,2024-10-04 19:26:19,0,0,0,0,0,0
4,201392389,2170660915,28821,36895,2024-10-04 19:26:20,0,0,0,0,0,0
4,201392389,2170660915,28821,36895,2024-10-04 19:26:21,0,0,0,0,0,0
4,201392389,2170660915,28821,36895,2024-10-04 19:26:22,0,0,0,0,0,0
4,201392389,2170660915,28821,36895,2024-10-04 19:26:23,0,0,0,0,0,0
4,201392389,2170660915,28821,36895,2024-10-04 19:26:24,0,0,0,0,0,0
4,201392389,2170660915,28821,36895,2024-10-04 19:26:25,0,0,0,0,0,0
4,201392389,2170660915,28821,36895,2024-10-04 19:26:26,0,0,0,0,0,0
4,201392389,2170660915,28821,36895,2024-10-04 19:26:27,0,0,0,0,0,0
4,201392389,2170660915,28821,36895,2024-10-04 19:26:28,0,0,0,0,0,0
4,201392389,2170660915,28821,36895,2024-10-04 19:26:29,0,0,0,0,0,0
4,201392389,2170660915,28821,36895,2024-10-04 19:26:30,0,0,0,0,0,0
4,201392389,2170660915,28821,36895,2024-10-04 19:26:31,0,0,0,0,0,0
4,201392389,2170660915,28821,36895,2024-10-04 19:26:32,0,0,0,0,0,0
4,201392389,2170660915,28821,36895,2024-10-04 19:26:33,0,0,0,0,0,0
4,201392389,2170660915,28821,36895,2024-10-04 19:26:34,0,0,0,0,0,0
4,201392389,2170660915,28821,36895,2024-10-04 19:26:35,0,0,0,0,0,0
4,201392389,2170660915,28821,36895,2024-10-04 19:26:36,0,0,0,0,0,0
4,201392389,2170660915,28821,36895,2024-10-04 19:26:37,0,0,0,0,0,0
4,201392389,2170660915,28821,36895,2024-10-04 19:26:38,0,0,0,0,0,0
4,201392389,2170660915,28821,36895,2024-10-04 19:26:39,0,0,0,0,0,0
4,201392389,2170660915,28821,36895,2024-10-04 19:26:40,0,0,0,0,0,0
4,201392389,2170660915,28821,36895,2024-10-04 19:26:41,0,0,0,0,0,0
4,201392389,2170660915,28821,36895,2024-10-04 19:26:42,0,0,0,0,0,0
4,201392389,2170660915,28821,36895,2024-10-04 19:26:43,0,0,0,0,0,0
4,201392389,2170660915,28821,36895,2024-10-04 19:26:44,0,0,0,0,0,0
4,201392389,2170660915,28821,36895,2024-10-04 19:26:45,0,0,0,0,0,0
4,201392389,2170660915,28821,36895,2024-10-04 19:26:46,0,0,0,0,0,0
4,201392389,2170660915,28821,36895,2024-10-04 19:26:47,0,0,0,0,0,0
4,201392389,2170660915,28821,36895,2024-10-04 19:26:48,0,0,0,0,0,0
4,201392389,2170660915,28821,36895,2024-10-04 19:26:49,0,0,0,0,0,0
4,201392389,2170660915,28821,36895,2024-10-04 19:26:50,0,0,0,0,0,0
4,201392389,2170660915,28821,36895,2024-10-04 19:26:51,0,0,0,0,0,0
4,201392389,2170660915,28821,36895,2024-10-04 19:26:52,0,0,0,0,0,0
4,201392389,2170660915,28821,36895,2024-10-04 19:26:53,0,0,0,0,0,0
4,201392389,2170660915,28821,36895,2024-10-04 19:26:54,0,0,0,0,0,0
4,201392389,2170660915,28821,36895,2024-10-04 19:26:55,0,0,0,0,0,0
4,201392389,2170660915,28821,36895,2024-10-04 19:26:56,0,0,0,0,0,0
4,201392389,2170660915,28821,36895,2024-10-04 19:26:57,0,0,0,0,0,0
4,201392389,2170660915,28821,36895,2024-10-04 19:26:58,0,0,0,0,0,0
4,201392389,2170660915,28821,36895,2024-10-04 19:26:59,0,0,0,0,0,0
4,201392389,2170660915,28821,36895,2024-10-04 19:27:00,0,0,0,0,0,0
4,201392389,2170660915,28821,36895,2024-10-04 19:27:01,0,0,0,0,0,0
4,201392389,2170660915,28821,36895,2024-10-04 19:27:02,0,0,0,0,0,0
4,201392389,2170660915,28821,36895,2024-10-04 19:27:03,0,0,0,0,0,0
4,201392389,2170660915,28821,36895,2024-10-04 19:27:04,0,0,0,0,0,0
4,201392389,2170660915,28821,36895,2024-10-04 19:27:05,0,0,0,0,0,0
4,201392389,2170660915,28821,36895,2024-10-04 19:27:06,0,0,0,0,0,0
4,201392389,2170660915,28821,36895,2024-10-04 19:27:07,0,0,0,0,0,0
4,201392389,2170660915,28821,36895,2024-10-04 19:27:08,0,0,0,0,0,0
4,201392389,2170660915,28821,36895,2024-10-04 19:27:09,0,0,0,0,0,0
4,201392389,2170660915,28821,36895,2024-10-04 19:27:10,0,0,0,0,0,0
4,201392389,2170660915,28821,36895,2024-10-04 19:27:11,0,0,0,0,0,0
4,201392389,2170660915,28821,36895,2024-10-04 19:27:12,0,0,0,0,0,0
4,201392389,2170660915,28821,36895,2024-10-04 19:27:13,0,0,0,0,0,0
4,201392389,2170660915,28821,36895,2024-10-04 19:27:14,0,0,0,0,0,0
4,201392389,2170660915,28821,36895,2024-10-04 19:27:15,0,0,0,0,0,0
4,201392389,2170660915,28821,36895,2024-10-04 19:27:16,0,0,0,0,0,0
4,201392389,2170660915,28821,36895,2024-10-04 19:27:17,0,0,0,0,0,0
4,201392389,2170660915,28821,36895,2024-10-04 19:27:18,0,0,0,0,0,0
4,201392389,2170660915,28821,36895,2024-10-04 19:27:19,0,0,0,0,0,0
4,201392389,2170660915,28821,36895,2024-10-04 19:27:20,0,0,0,0,0,0
4,201392389,2170660915,28821,36895,2024-10-04 19:27:21,0,0,0,0,0,0
4,201392389,2170660915,28821,36895,2024-10-04 19:27:22,0,0,0,0,0,0
4,201392389,2170660915,28821,36895,2024-10-04 19:27:23,0,0,0,0,0,0
4,201392389,2170660915,28821,36895,2024-10-04 19:27:24,0,0,0,0,0,0
4,201392389,2170660915,28821,36895,2024-10-04 19:27:25,0,0,0,0,0,0
4,201392389,2170660915,28821,36895,2024-10-04 19:27:26,0,0,0,0,0,0
4,201392389,2170660915,28821,36895,2024-10-04 19:27:27,0,0,0,0,0,0
4,201392389,2170660915,28821,36895,2024-10-04 19:27:28,0,0,0,0,0,0
4,201392389,2170660915,28821,36895,2024-10-04 19:27:29,0,0,0,0,0,0
4,201392389,2170660915,28821,36895,2024-10-04 19:27:30,0,0,0,0,0,0
4,201392389,2170660915,28821,36895,2024-10-04 19:27:31,0,0,0,0,0,0
4,201392389,2170660915,28821,36895,2024-10-04 19:27:32,0,0,0,0,0,0
4,201392389,2170660915,28821,36895,2024-10-04 19:27:33,0,0,0,0,0,0
4,201392389,2170660915,28821,36895,2024-10-04 19:27:34,0,0,0,0,0,0
4,201392389,2170660915,28821,36895,2024-10-04 19:27:35,0,0,0,0,0,0
4,201392389,2170660915,28821,36895,2024-10-04 19:27:36,0,0,0,0,0,0
4,201392389,2170660915,28821,36895,2024-10-04 19:27:37,0,0,0,0,0,0
4,201392389,2170660915,28821,36895,2024-10-04 19:27:38,0,0,0,0,0,0
4,201392389,2170660915,28821,36895,2024-10-04 19:27:39,0,0,0,0,0,0
4,201392389,2170660915,28821,36895,2024-10-04 19:27:40,0,0,0,0,0,0
4,201392389,2170660915,28821,36895,2024-10-04 19:27:41,0,0,0,0,0,0
4,201392389,2170660915,28821,36895,2024-10-04 19:27:42,0,0,0,0,0,0
4,201392389,2170660915,28821,36895,2024-10-04 19:27:43,0,0,0,0,0,0
4,201392389,2170660915,28821,36895,2024-10-04 19:27:44,0,0,0,0,0,0
4,201392389,2170660915,28821,36895,2024-10-04 19:27:45,0,0,0,0,0,0
4,201392389,2170660915,28821,36895,2024-10-04 19:27:46,0,0,0,0,0,0
4,201392389,2170660915,28821,36895,2024-10-04 19:27:47,0,0,0,0,0,0
4,201392389,2170660915,28821,36895,2024-10-04 19:27:48,0,0,0,0,0,0
4,201392389,2170660915,28821,36895,2024-10-04 19:27:49,0,0,0,0,0,0
4,201392389,2170660915,28821,36895,2024-10-04 19:27:50,0,0,0,0,0,0
4,201392389,2170660915,28821,36895,2024-10-04 19:27:51,0,0,0,0,0,0
4,201392389,2170660915,28821,36895,2024-10-04 19:27:52,0,0,0,0,0,0
4,201392389,2170660915,28821,36895,2024-10-04 19:27:53,0,0,0,0,0,0
4,201392389,2170660915,28821,36895,2024-10-04 19:27:54,0,0,0,0,0,0
4,201392389,2170660915,28821,36895,2024-10-04 19:27:55,0,0,0,0,0,0
4,201392389,2170660915,28821,36895,2024-10-04 19:27:56,0,0,0,0,0,0
4,201392389,2170660915,28821,36895,2024-10-04 19:27:57,0,0,0,0,0,0
4,201392389,2170660915,28821,36895,2024-10-04 19:27:58,0,0,0,0,0,0
4,201392389,2170660915,28821,36895,2024-10-04 19:27:59,0,0,0,0,0,0
4,201392389,2170660915,28821,36895,2024-10-04 19:28:00,0,0,0,0,0,0
4,201392389,2170660915,28821,36895,2024-10-04 19:28:01,0,0,0,0,0,0
4,201392389,2170660915,28821,36895,2024-10-04 19:28:02,0,0,0,0,0,0
4,201392389,2170660915,28821,36895,2024-10-04 19:28:03,0,0,0,0,0,0
4,201392389,2170660915,28821,36895,2024-10-04 19:28:04,0,0,0,0,0,0
4,201392389,2170660915,28821,36895,2024-10-04 19:28:05,0,0,0,0,0,0
4,201392389,2170660915,28821,36895,2024-10-04 19:28:06,0,0,0,0,0,0
4,201392389,2170660915,28821,36895,2024-10-04 19:28:07,0,0,0,0,0,0
4,201392389,2170660915,28821,36895,2024-10-04 19:28:08,0,0,0,0,0,0
4,201392389,2170660915,28821,36895,2024-10-04 19:28:09,0,0,0,0,0,0
4,201392389,2170660915,28821,36895,2024-10-04 19:28:10,0,0,0,0,0,0
4,201392389,2170660915,28821,36895,2024-10-04 19:28:11,0,0,0,0,0,0
4,201392389,2170660915,28821,36895,2024-10-04 19:28:12,0,0,0,0,0,0
4,201392389,2170660915,28821,36895,2024-10-04 19:28:13,0,0,0,0,0,0
4,201392389,2170660915,28821,36895,2024-10-04 19:28:14,0,0,0,0,0,0
4,201392389,2170660915,28821,36895,2024-10-04 19:28:15,0,0,0,0,0,0
4,201392389,2170660915,28821,36895,2024-10-04 19:28:16,0,0,0,0,0,0
4,201392389,2170660915,28821,36895,2024-10-04 19:28:17,0,0,0,0,0,0
4,201392389,2170660915,28821,36895,2024-10-04 19:28:18,0,0,0,0,0,0
4,201392389,2170660915,28821,36895,2024-10-04 19:28:19,0,0,0,0,0,0
4,201392389,2170660915,28821,36895,2024-10-04 19:28:20,0,0,0,0,0,0
4,201392389,2170660915,28821,36895,2024-10-04 19:28:21,0,0,0,0,0,0
4,201392389,2170660915,28821,36895,2024-10-04 19:28:22,0,0,0,0,0,0
4,201392389,2170660915,28821,36895,2024-10-04 19:28:23,0,0,0,0,0,0
4,201392389,2170660915,28821,36895,2024-10-04 19:28:24,0,0,0,0,0,0
4,201392389,2170660915,28821,36895,2024-10-04 19:28:25,0,0,0,0,0,0
4,201392389,2170660915,28821,36895,2024-10-04 19:28:26,0,0,0,0,0,0
4,201392389,2170660915,28821,36895,2024-10-04 19:28:27,0,0,0,0,0,0
4,201392389,2170660915,28821,36895,2024-10-04 19:28:28,0,0,0,0,0,0
4,201392389,2170660915,28821,36895,2024-10-04 19:28:29,0,0,0,0,0,0
4,201392389,2170660915,28821,36895,2024-10-04 19:28:30,0,0,0,0,0,0
4,201392389,2170660915,28821,36895,2024-10-04 19:28:31,0,0,0,0,0,0
4,201392389,2170660915,28821,36895,2024-10-04 19:28:32,0,0,0,0,0,0
4,201392389,2170660915,28821,36895,2024-10-04 19:28:33,0,0,0,0,0,0
4,201392389,2170660915,28821,36895,2024-10-04 19:28:34,0,0,0,0,0,0
4,201392389,2170660915,28821,36895,2024-10-04 19:28:35,0,0,0,0,0,0
4,201392389,2170660915,28821,36895,2024-10-04 19:28:36,0,0,0,0,0,0
4,201392389,2170660915,28821,36895,2024-10-04 19:28:37,0,0,0,0,0,0
4,201392389,2170660915,28821,36895,2024-10-04 19:28:38,0,0,0,0,0,0
4,201392389,2170660915,28821,36895,2024-10-04 19:28:39,0,0,0,0,0,0
4,201392389,2170660915,28821,36895,2024-10-04 19:28:40,0,0,0,0,0,0
4,201392389,2170660915,28821,36895,2024-10-04 19:28:41,0,0,0,0,0,0
4,201392389,2170660915,28821,36895,2024-10-04 19:28:42,0,0,0,0,0,0
4,201392389,2170660915,28821,36895,2024-10-04 19:28:43,0,0,0,0,0,0
4,201392389,2170660915,28821,36895,2024-10-04 19:28:44,0,0,0,0,0,0
4,201392389,2170660915,28821,36895,2024-10-04 19:28:45,0,0,0,0,0,0
4,201392389,2170660915,28821,36895,2024-10-04 19:28:46,0,0,0,0,0,0
4,201392389,2170660915,28821,36895,2024-10-04 19:28:47,0,0,0,0,0,0
4,201392389,2170660915,28821,36895,2024-10-04 19:28:48,0,0,0,0,0,0
4,201392389,2170660915,28821,36895,2024-10-04 19:28:49,0,0,0,0,0,0
4,201392389,2170660915,28821,36895,2024-10-04 19:28:50,0,0,0,0,0,0
4,201392389,2170660915,28821,36895,2024-10-04 19:28:51,0,0,0,0,0,0
4,201392389,2170660915,28821,36895,2024-10-04 19:28:52,0,0,0,0,0,0
4,201392389,2170660915,28821,36895,2024-10-04 19:28:53,0,0,0,0,0,0
4,201392389,2170660915,28821,36895,2024-10-04 19:28:54,0,0,0,0,0,0
4,201392389,2170660915,28821,36895,2024-10-04 19:28:55,0,0,0,0,0,0
4,201392389,2170660915,28821,36895,2024-10-04 19:28:56,0,0,0,0,0,0
4,201392389,2170660915,28821,36895,2024-10-04 19:28:57,0,0,0,0,0,0
4,201392389,2170660915,28821,36895,2024-10-04 19:28:58,0,0,0,0,0,0
4,201392389,2170660915,28821,36895,2024-10-04 19:28:59,0,0,0,0,0,0
4,201392389,2170660915,28821,36895,2024-10-04 19:29:00,0,0,0,0,0,0
4,201392389,2170660915,28821,36895,2024-10-04 19:29:01,0,0,0,0,0,0
4,201392389,2170660915,28821,36895,2024-10-04 19:29:02,0,0,0,0,0,0
4,201392389,2170660915,28821,36895,2024-10-04 19:29:03,0,0,0,0,0,0
4,201392389,2170660915,28821,36895,2024-10-04 19:29:04,0,0,0,0,0,0
4,201392389,2170660915,28821,36895,2024-10-04 19:29:05,0,0,0,0,0,0
4,201392389,2170660915,28821,36895,2024-10-04 19:29:06,0,0,0,0,0,0
4,201392389,2170660915,28821,36895,2024-10-04 19:29:07,0,0,0,0,0,0
4,201392389,2170660915,28821,36895,2024-10-04 19:29:08,0,0,0,0,0,0
4,201392389,2170660915,28821,36895,2024-10-04 19:29:09,0,0,0,0,0,0
4,201392389,2170660915,28821,36895,2024-10-04 19:29:10,0,0,0,0,0,0
4,201392389,2170660915,28821,36895,2024-10-04 19:29:11,0,0,0,0,0,0
4,201392389,2170660915,28821,36895,2024-10-04 19:29:12,0,0,0,0,0,0
4,201392389,2170660915,28821,36895,2024-10-04 19:29:13,0,0,0,0,0,0
4,201392389,2170660915,28821,36895,2024-10-04 19:29:14,0,0,0,0,0,0
4,201392389,2170660915,28821,36895,2024-10-04 19:29:15,0,0,0,0,0,0
4,201392389,2170660915,28821,36895,2024-10-04 19:29:16,0,0,0,0,0,0
4,201392389,2170660915,28821,36895,2024-10-04 19:29:17,0,0,0,0,0,0
4,201392389,2170660915,28821,36895,2024-10-04 19:29:18,0,0,0,0,0,0
4,201392389,2170660915,28821,36895,2024-10-04 19:29:19,0,0,0,0,0,0
4,201392389,2170660915,28821,36895,2024-10-04 19:29:20,0,0,0,0,0,0
4,201392389,2170660915,28821,36895,2024-10-04 19:29:21,0,0,0,0,0,0
4,201392389,2170660915,28821,36895,2024-10-04 19:29:22,0,0,0,0,0,0
4,201392389,2170660915,28821,36895,2024-10-04 19:29:23,0,0,0,0,0,0
4,201392389,2170660915,28821,36895,2024-10-04 19:29:24,0,0,0,0,0,0
4,201392389,2170660915,28821,36895,2024-10-04 19:29:25,0,0,0,0,0,0
4,201392389,2170660915,28821,36895,2024-10-04 19:29:26,0,0,0,0,0,0
4,201392389,2170660915,28821,36895,2024-10-04 19:29:27,0,0,0,0,0,0
4,201392389,2170660915,28821,36895,2024-10-04 19:29:28,0,0,0,0,0,0
4,201392389,2170660915,28821,36895,2024-10-04 19:29:29,0,0,0,0,0,0
4,201392389,2170660915,28821,36895,2024-10-04 19:29:30,0,0,0,0,0,0
4,201392389,2170660915,28821,36895,2024-10-04 19:29:31,0,0,0,0,0,0
4,201392389,2170660915,28821,36895,2024-10-04 19:29:32,0,0,0,0,0,0
4,201392389,2170660915,28821,36895,2024-10-04 19:29:33,0,0,0,0,0,0
4,201392389,2170660915,28821,36895,2024-10-04 19:29:34,0,0,0,0,0,0
4,201392389,2170660915,28821,36895,2024-10-04 19:29:35,0,0,0,0,0,0
4,201392389,2170660915,28821,36895,2024-10-04 19:29:36,0,0,0,0,0,0
4,201392389,2170660915,28821,36895,2024-10-04 19:29:37,0,0,0,0,0,0
4,201392389,2170660915,28821,36895,2024-10-04 19:29:38,0,0,0,0,0,0
4,201392389,2170660915,28821,36895,2024-10-04 19:29:39,0,0,0,0,0,0
4,201392389,2170660915,28821,36895,2024-10-04 19:29:40,0,0,0,0,0,0
4,201392389,2170660915,28821,36895,2024-10-04 19:29:41,0,0,0,0,0,0
4,201392389,2170660915,28821,36895,2024-10-04 19:29:42,0,0,0,0,0,0
4,201392389,2170660915,28821,36895,2024-10-04 19:29:43,0,0,0,0,0,0
4,201392389,2170660915,28821,36895,2024-10-04 19:29:44,0,0,0,0,0,0
4,201392389,2170660915,28821,36895,2024-10-04 19:29:45,0,0,0,0,0,0
4,201392389,2170660915,28821,36895,2024-10-04 19:29:46,0,0,0,0,0,0
4,201392389,2170660915,28821,36895,2024-10-04 19:29:47,0,0,0,0,0,0
4,201392389,2170660915,28821,36895,2024-10-04 19:29:48,0,0,0,0,0,0
4,201392389,2170660915,28821,36895,2024-10-04 19:29:49,0,0,0,0,0,0
4,201392389,2170660915,28821,36895,2024-10-04 19:29:50,0,0,0,0,0,0
4,201392389,2170660915,28821,36895,2024-10-04 19:29:51,0,0,0,0,0,0
4,201392389,2170660915,28821,36895,2024-10-04 19:29:52,0,0,0,0,0,0
4,201392389,2170660915,28821,36895,2024-10-04 19:29:53,0,0,0,0,0,0
4,201392389,2170660915,28821,36895,2024-10-04 19:29:54,0,0,0,0,0,0
4,201392389,2170660915,28821,36895,2024-10-04 19:29:55,0,0,0,0,0,0
4,201392389,2170660915,28821,36895,2024-10-04 19:29:56,0,0,0,0,0,0
4,201392389,2170660915,28821,36895,2024-10-04 19:29:57,0,0,0,0,0,0
4,201392389,2170660915,28821,36895,2024-10-04 19:29:58,0,0,0,0,0,0
4,201392389,2170660915,28821,36895,2024-10-04 19:29:59,0,0,0,0,0,0
4,201392389,2170660915,28821,36895,2024-10-04 19:30:00,0,0,0,0,0,0
4,201392389,2170660915,28821,36895,2024-10-04 19:30:01,0,0,0,0,0,0
4,201392389,2170660915,28821,36895,2024-10-04 19:30:02,0,0,0,0,0,0
4,201392389,2170660915,28821,36895,2024-10-04 19:30:03,0,0,0,0,0,0
4,201392389,2170660915,28821,36895,2024-10-04 19:30:04,0,0,0,0,0,0
4,201392389,2170660915,28821,36895,2024-10-04 19:30:05,0,0,0,0,0,0
4,201392389,2170660915,28821,36895,2024-10-04 19:30:06,0,0,0,0,0,0
4,201392389,2170660915,28821,36895,2024-10-04 19:30:07,0,0,0,0,0,0
4,201392389,2170660915,28821,36895,2024-10-04 19:30:08,0,0,0,0,0,0
4,201392389,2170660915,28821,36895,2024-10-04 19:30:09,0,0,0,0,0,0
4,201392389,2170660915,28821,36895,2024-10-04 19:30:10,0,0,0,0,0,0
4,201392389,2170660915,28821,36895,2024-10-04 19:30:11,0,0,0,0,0,0
4,201392389,2170660915,28821,36895,2024-10-04 19:30:12,0,0,0,0,0,0
4,201392389,2170660915,28821,36895,2024-10-04 19:30:13,0,0,0,0,0,0
4,201392389,2170660915,28821,36895,2024-10-04 19:30:14,0,0,0,0,0,0
4,201392389,2170660915,28821,36895,2024-10-04 19:30:15,0,0,0,0,0,0
4,201392389,2170660915,28821,36895,2024-10-04 19:30:16,0,0,0,0,0,0
4,201392389,2170660915,28821,36895,2024-10-04 19:30:17,0,0,0,0,0,0
4,201392389,2170660915,28821,36895,2024-10-04 19:30:18,0,0,0,0,0,0
4,201392389,2170660915,28821,36895,2024-10-04 19:30:19,0,0,0,0,0,0
4,201392389,2170660915,28821,36895,2024-10-04 19:30:20,0,0,0,0,0,0
4,201392389,2170660915,28821,36895,2024-10-04 19:30:21,0,0,0,0,0,0
4,201392389,2170660915,28821,36895,2024-10-04 19:30:22,0,0,0,0,0,0
4,201392389,2170660915,28821,36895,2024-10-04 19:30:23,0,0,0,0,0,0
4,201392389,2170660915,28821,36895,2024-10-04 19:30:24,0,0,0,0,0,0
4,201392389,2170660915,28821,36895,2024-10-04 19:30:25,0,0,0,0,0,0
4,201392389,2170660915,28821,36895,2024-10-04 19:30:26,0,0,0,0,0,0
4,201392389,2170660915,28821,36895,2024-10-04 19:30:27,0,0,0,0,0,0
4,201392389,2170660915,28821,36895,2024-10-04 19:30:28,0,0,0,0,0,0
4,201392389,2170660915,28821,36895,2024-10-04 19:30:29,0,0,0,0,0,0
4,201392389,2170660915,28821,36895,2024-10-04 19:30:30,0,0,0,0,0,0
4,201392389,2170660915,28821,36895,2024-10-04 19:30:31,0,0,0,0,0,0
4,201392389,2170660915,28821,36895,2024-10-04 19:30:32,0,0,0,0,0,0
4,201392389,2170660915,28821,36895,2024-10-04 19:30:33,0,0,0,0,0,0
4,201392389,2170660915,28821,36895,2024-10-04 19:30:34,0,0,0,0,0,0
4,201392389,2170660915,28821,36895,2024-10-04 19:30:35,0,0,0,0,0,0
4,201392389,2170660915,28821,36895,2024-10-04 19:30:36,0,0,0,0,0,0
4,201392389,2170660915,28821,36895,2024-10-04 19:30:37,0,0,0,0,0,0
4,201392389,2170660915,28821,36895,2024-10-04 19:30:38,0,0,0,0,0,0
4,201392389,2170660915,28821,36895,2024-10-04 19:30:39,0,0,0,0,0,0
4,201392389,2170660915,28821,36895,2024-10-04 19:30:40,0,0,0,0,0,0
4,201392389,2170660915,28821,36895,2024-10-04 19:30:41,0,0,0,0,0,0
4,201392389,2170660915,28821,36895,2024-10-04 19:30:42,0,0,0,0,0,0
4,201392389,2170660915,28821,36895,2024-10-04 19:30:43,0,0,0,0,0,0
4,201392389,2170660915,28821,36895,2024-10-04 19:30:44,0,0,0,0,0,0
4,201392389,2170660915,28821,36895,2024-10-04 19:30:45,0,0,0,0,0,0
4,201392389,2170660915,28821,36895,2024-10-04 19:30:46,0,0,0,0,0,0
4,201392389,2170660915,28821,36895,2024-10-04 19:30:47,0,0,0,0,0,0
4,201392389,2170660915,28821,36895,2024-10-04 19:30:48,0,0,0,0,0,0
4,201392389,2170660915,28821,36895,2024-10-04 19:30:49,0,0,0,0,0,0
4,201392389,2170660915,28821,36895,2024-10-04 19:30:50,0,0,0,0,0,0
4,201392389,2170660915,28821,36895,2024-10-04 19:30:51,0,0,0,0,0,0
4,201392389,2170660915,28821,36895,2024-10-04 19:30:52,0,0,0,0,0,0
4,201392389,2170660915,28821,36895,2024-10-04 19:30:53,0,0,0,0,0,0
4,201392389,2170660915,28821,36895,2024-10-04 19:30:54,0,0,0,0,0,0
4,201392389,2170660915,28821,36895,2024-10-04 19:30:55,0,0,0,0,0,0
4,201392389,2170660915,28821,36895,2024-10-04 19:30:56,0,0,0,0,0,0
4,201392389,2170660915,28821,36895,2024-10-04 19:30:57,0,0,0,0,0,0
4,201392389,2170660915,28821,36895,2024-10-04 19:30:58,0,0,0,0,0,0
4,201392389,2170660915,28821,36895,2024-10-04 19:30:59,0,0,0,0,0,0
4,201392389,2170660915,28821,36895,2024-10-04 19:31:00,0,0,0,0,0,0
4,201392389,2170660915,28821,36895,2024-10-04 19:31:01,0,0,0,0,0,0
4,201392389,2170660915,28821,36895,2024-10-04 19:31:02,0,0,0,0,0,0
4,201392389,2170660915,28821,36895,2024-10-04 19:31:03,0,0,0,0,0,0
4,201392389,2170660915,28821,36895,2024-10-04 19:31:04,0,0,0,0,0,0
4,201392389,2170660915,28821,36895,2024-10-04 19:31:05,0,0,0,0,0,0
4,201392389,2170660915,28821,36895,2024-10-04 19:31:06,0,0,0,0,0,0
4,201392389,2170660915,28821,36895,2024-10-04 19:31:07,0,0,0,0,0,0
4,201392389,2170660915,28821,36895,2024-10-04 19:31:08,0,0,0,0,0,0
4,201392389,2170660915,28821,36895,2024-10-04 19:31:09,0,0,0,0,0,0
4,201392389,2170660915,28821,36895,2024-10-04 19:31:10,0,0,0,0,0,0
4,201392389,2170660915,28821,36895,2024-10-04 19:31:11,0,0,0,0,0,0
4,201392389,2170660915,28821,36895,2024-10-04 19:31:12,0,0,0,0,0,0
4,201392389,2170660915,28821,36895,2024-10-04 19:31:13,0,0,0,0,0,0
4,201392389,2170660915,28821,36895,2024-10-04 19:31:14,0,0,0,0,0,0
4,201392389,2170660915,28821,36895,2024-10-04 19:31:15,0,0,0,0,0,0
4,201392389,2170660915,28821,36895,2024-10-04 19:31:16,0,0,0,0,0,0
4,201392389,2170660915,28821,36895,2024-10-04 19:31:17,0,0,0,0,0,0
4,201392389,2170660915,28821,36895,2024-10-04 19:31:18,0,0,0,0,0,0
4,201392389,2170660915,28821,36895,2024-10-04 19:31:19,0,0,0,0,0,0
4,201392389,2170660915,28821,36895,2024-10-04 19:31:20,0,0,0,0,0,0
4,201392389,2170660915,28821,36895,2024-10-04 19:31:21,0,0,0,0,0,0
4,201392389,2170660915,28821,36895,2024-10-04 19:31:22,0,0,0,0,0,0
4,201392389,2170660915,28821,36895,2024-10-04 19:31:23,0,0,0,0,0,0
4,201392389,2170660915,28821,36895,2024-10-04 19:31:24,0,0,0,0,0,0
4,201392389,2170660915,28821,36895,2024-10-04 19:31:25,0,0,0,0,0,0
4,201392389,2170660915,28821,36895,2024-10-04 19:31:26,0,0,0,0,0,0
4,201392389,2170660915,28821,36895,2024-10-04 19:31:27,0,0,0,0,0,0
4,201392389,2170660915,28821,36895,2024-10-04 19:31:28,0,0,0,0,0,0
4,201392389,2170660915,28821,36895,2024-10-04 19:31:29,0,0,0,0,0,0
4,201392389,2170660915,28821,36895,2024-10-04 19:31:30,0,0,0,0,0,0
4,201392389,2170660915,28821,36895,2024-10-04 19:31:31,0,0,0,0,0,0
4,201392389,2170660915,28821,36895,2024-10-04 19:31:32,0,0,0,0,0,0
4,201392389,2170660915,28821,36895,2024-10-04 19:31:33,0,0,0,0,0,0
4,201392389,2170660915,28821,36895,2024-10-04 19:31:34,0,0,0,0,0,0
4,201392389,2170660915,28821,36895,2024-10-04 19:31:35,0,0,0,0,0,0
4,201392389,2170660915,28821,36895,2024-10-04 19:31:36,0,0,0,0,0,0
4,201392389,2170660915,28821,36895,2024-10-04 19:31:37,0,0,0,0,0,0
4,201392389,2170660915,28821,36895,2024-10-04 19:31:38,0,0,0,0,0,0
4,201392389,2170660915,28821,36895,2024-10-04 19:31:39,0,0,0,0,0,0
4,201392389,2170660915,28821,36895,2024-10-04 19:31:40,0,0,0,0,0,0
4,201392389,2170660915,28821,36895,2024-10-04 19:31:41,0,0,0,0,0,0
4,201392389,2170660915,28821,36895,2024-10-04 19:31:42,0,0,0,0,0,0
4,201392389,2170660915,28821,36895,2024-10-04 19:31:43,0,0,0,0,0,0
4,201392389,2170660915,28821,36895,2024-10-04 19:31:44,0,0,0,0,0,0
4,201392389,2170660915,28821,36895,2024-10-04 19:31:45,0,0,0,0,0,0
4,201392389,2170660915,28821,36895,2024-10-04 19:31:46,0,0,0,0,0,0
4,201392389,2170660915,28821,36895,2024-10-04 19:31:47,0,0,0,0,0,0
4,201392389,2170660915,28821,36895,2024-10-04 19:31:48,0,0,0,0,0,0
4,201392389,2170660915,28821,36895,2024-10-04 19:31:49,0,0,0,0,0,0
4,201392389,2170660915,28821,36895,2024-10-04 19:31:50,0,0,0,0,0,0
4,201392389,2170660915,28821,36895,2024-10-04 19:31:51,0,0,0,0,0,0
4,201392389,2170660915,28821,36895,2024-10-04 19:31:52,0,0,0,0,0,0
4,201392389,2170660915,28821,36895,2024-10-04 19:31:53,0,0,0,0,0,0
4,201392389,2170660915,28821,36895,2024-10-04 19:31:54,0,0,0,0,0,0
4,201392389,2170660915,28821,36895,2024-10-04 19:31:55,0,0,0,0,0,0
4,201392389,2170660915,28821,36895,2024-10-04 19:31:56,0,0,0,0,0,0
4,201392389,2170660915,28821,36895,2024-10-04 19:31:57,0,0,0,0,0,0
4,201392389,2170660915,28821,36895,2024-10-04 19:31:58,0,0,0,0,0,0
4,201392389,2170660915,28821,36895,2024-10-04 19:31:59,0,0,0,0,0,0
4,201392389,2170660915,28821,36895,2024-10-04 19:32:00,0,0,0,0,0,0
4,201392389,2170660915,28821,36895,2024-10-04 19:32:01,0,0,0,0,0,0
4,201392389,2170660915,28821,36895,2024-10-04 19:32:02,0,0,0,0,0,0
4,201392389,2170660915,28821,36895,2024-10-04 19:32:03,0,0,0,0,0,0
4,201392389,2170660915,28821,36895,2024-10-04 19:32:04,0,0,0,0,0,0
4,201392389,2170660915,28821,36895,2024-10-04 19:32:05,0,0,0,0,0,0
4,201392389,2170660915,28821,36895,2024-10-04 19:32:06,0,0,0,0,0,0
4,201392389,2170660915,28821,36895,2024-10-04 19:32:07,0,0,0,0,0,0
4,201392389,2170660915,28821,36895,2024-10-04 19:32:08,0,0,0,0,0,0
4,201392389,2170660915,28821,36895,2024-10-04 19:32:09,0,0,0,0,0,0
4,201392389,2170660915,28821,36895,2024-10-04 19:32:10,0,0,0,0,0,0
4,201392389,2170660915,28821,36895,2024-10-04 19:32:11,0,0,0,0,0,0
4,201392389,2170660915,28821,36895,2024-10-04 19:32:12,0,0,0,0,0,0
4,201392389,2170660915,28821,36895,2024-10-04 19:32:13,0,0,0,0,0,0
4,201392389,2170660915,28821,36895,2024-10-04 19:32:14,0,0,0,0,0,0
4,201392389,2170660915,28821,36895,2024-10-04 19:32:15,0,0,0,0,0,0
4,201392389,2170660915,28821,36895,2024-10-04 19:32:16,0,0,0,0,0,0
4,201392389,2170660915,28821,36895,2024-10-04 19:32:17,0,0,0,0,0,0
4,201392389,2170660915,28821,36895,2024-10-04 19:32:18,0,0,0,0,0,0
4,201392389,2170660915,28821,36895,2024-10-04 19:32:19,0,0,0,0,0,0
4,201392389,2170660915,28821,36895,2024-10-04 19:32:20,0,0,0,0,0,0
4,201392389,2170660915,28821,36895,2024-10-04 19:32:21,0,0,0,0,0,0
4,201392389,2170660915,28821,36895,2024-10-04 19:32:22,0,0,0,0,0,0
4,201392389,2170660915,28821,36895,2024-10-04 19:32:23,0,0,0,0,0,0
4,201392389,2170660915,28821,36895,2024-10-04 19:32:24,0,0,0,0,0,0
4,201392389,2170660915,28821,36895,2024-10-04 19:32:25,0,0,0,0,0,0
4,201392389,2170660915,28821,36895,2024-10-04 19:32:26,0,0,0,0,0,0
4,201392389,2170660915,28821,36895,2024-10-04 19:32:27,0,0,0,0,0,0
4,201392389,2170660915,28821,36895,2024-10-04 19:32:28,0,0,0,0,0,0
4,201392389,2170660915,28821,36895,2024-10-04 19:32:29,0,0,0,0,0,0
4,201392389,2170660915,28821,36895,2024-10-04 19:32:30,0,0,0,0,0,0
4,201392389,2170660915,28821,36895,2024-10-04 19:32:31,0,0,0,0,0,0
4,201392389,2170660915,28821,36895,2024-10-04 19:32:32,0,0,0,0,0,0
4,201392389,2170660915,28821,36895,2024-10-04 19:32:33,0,0,0,0,0,0
4,201392389,2170660915,28821,36895,2024-10-04 19:32:34,0,0,0,0,0,0
4,201392389,2170660915,28821,36895,2024-10-04 19:32:35,0,0,0,0,0,0
4,201392389,2170660915,28821,36895,2024-10-04 19:32:36,0,0,0,0,0,0
4,201392389,2170660915,28821,36895,2024-10-04 19:32:37,0,0,0,0,0,0
4,201392389,2170660915,28821,36895,2024-10-04 19:32:38,0,0,0,0,0,0
4,201392389,2170660915,28821,36895,2024-10-04 19:32:39,0,0,0,0,0,0
4,201392389,2170660915,28821,36895,2024-10-04 19:32:40,0,0,0,0,0,0
4,201392389,2170660915,28821,36895,2024-10-04 19:32:41,0,0,0,0,0,0
4,201392389,2170660915,28821,36895,2024-10-04 19:32:42,0,0,0,0,0,0
4,201392389,2170660915,28821,36895,2024-10-04 19:32:43,0,0,0,0,0,0
4,201392389,2170660915,28821,36895,2024-10-04 19:32:44,0,0,0,0,0,0
4,201392389,2170660915,28821,36895,2024-10-04 19:32:45,0,0,0,0,0,0
4,201392389,2170660915,28821,36895,2024-10-04 19:32:46,0,0,0,0,0,0
4,201392389,2170660915,28821,36895,2024-10-04 19:32:47,0,0,0,0,0,0
4,201392389,2170660915,28821,36895,2024-10-04 19:32:48,0,0,0,0,0,0
4,201392389,2170660915,28821,36895,2024-10-04 19:32:49,0,0,0,0,0,0
4,201392389,2170660915,28821,36895,2024-10-04 19:32:50,0,0,0,0,0,0
4,201392389,2170660915,28821,36895,2024-10-04 19:32:51,0,0,0,0,0,0
4,201392389,2170660915,28821,36895,2024-10-04 19:32:52,0,0,0,0,0,0
4,201392389,2170660915,28821,36895,2024-10-04 19:32:53,0,0,0,0,0,0
4,201392389,2170660915,28821,36895,2024-10-04 19:32:54,0,0,0,0,0,0
4,201392389,2170660915,28821,36895,2024-10-04 19:32:55,0,0,0,0,0,0
4,201392389,2170660915,28821,36895,2024-10-04 19:32:56,0,0,0,0,0,0
4,201392389,2170660915,28821,36895,2024-10-04 19:32:57,0,0,0,0,0,0
4,201392389,2170660915,28821,36895,2024-10-04 19:32:58,0,0,0,0,0,0
4,201392389,2170660915,28821,36895,2024-10-04 19:32:59,0,0,0,0,0,0
4,201392389,2170660915,28821,36895,2024-10-04 19:33:00,0,0,0,0,0,0
4,201392389,2170660915,28821,36895,2024-10-04 19:33:01,0,0,0,0,0,0
4,201392389,2170660915,28821,36895,2024-10-04 19:33:02,0,0,0,0,0,0
4,201392389,2170660915,28821,36895,2024-10-04 19:33:03,0,0,0,0,0,0
4,201392389,2170660915,28821,36895,2024-10-04 19:33:04,0,0,0,0,0,0
4,201392389,2170660915,28821,36895,2024-10-04 19:33:05,0,0,0,0,0,0
4,201392389,2170660915,28821,36895,2024-10-04 19:33:06,0,0,0,0,0,0
4,201392389,2170660915,28821,36895,2024-10-04 19:33:07,0,0,0,0,0,0
4,201392389,2170660915,28821,36895,2024-10-04 19:33:08,0,0,0,0,0,0
4,201392389,2170660915,28821,36895,2024-10-04 19:33:09,0,0,0,0,0,0
4,201392389,2170660915,28821,36895,2024-10-04 19:33:10,0,0,0,0,0,0
4,201392389,2170660915,28821,36895,2024-10-04 19:33:11,0,0,0,0,0,0
4,201392389,2170660915,28821,36895,2024-10-04 19:33:12,0,0,0,0,0,0
4,201392389,2170660915,28821,36895,2024-10-04 19:33:13,0,0,0,0,0,0
4,201392389,2170660915,28821,36895,2024-10-04 19:33:14,0,0,0,0,0,0
4,201392389,2170660915,28821,36895,2024-10-04 19:33:15,0,0,0,0,0,0
4,201392389,2170660915,28821,36895,2024-10-04 19:33:16,0,0,0,0,0,0
4,201392389,2170660915,28821,36895,2024-10-04 19:33:17,0,0,0,0,0,0
4,201392389,2170660915,28821,36895,2024-10-04 19:33:18,0,0,0,0,0,0
4,201392389,2170660915,28821,36895,2024-10-04 19:33:19,0,0,0,0,0,0
4,201392389,2170660915,28821,36895,2024-10-04 19:33:20,0,0,0,0,0,0
4,201392389,2170660915,28821,36895,2024-10-04 19:33:21,0,0,0,0,0,0
4,201392389,2170660915,28821,36895,2024-10-04 19:33:22,0,0,0,0,0,0
4,201392389,2170660915,28821,36895,2024-10-04 19:33:23,0,0,0,0,0,0
4,201392389,2170660915,28821,36895,2024-10-04 19:33:24,0,0,0,0,0,0
4,201392389,2170660915,28821,36895,2024-10-04 19:33:25,0,0,0,0,0,0
4,201392389,2170660915,28821,36895,2024-10-04 19:33:26,0,0,0,0,0,0
4,201392389,2170660915,28821,36895,2024-10-04 19:33:27,0,0,0,0,0,0
4,201392389,2170660915,28821,36895,2024-10-04 19:33:28,0,0,0,0,0,0
4,201392389,2170660915,28821,36895,2024-10-04 19:33:29,0,0,0,0,0,0
4,201392389,2170660915,28821,36895,2024-10-04 19:33:30,0,0,0,0,0,0
4,201392389,2170660915,28821,36895,2024-10-04 19:33:31,0,0,0,0,0,0
4,201392389,2170660915,28821,36895,2024-10-04 19:33:32,0,0,0,0,0,0
4,201392389,2170660915,28821,36895,2024-10-04 19:33:33,0,0,0,0,0,0
4,201392389,2170660915,28821,36895,2024-10-04 19:33:34,0,0,0,0,0,0
4,201392389,2170660915,28821,36895,2024-10-04 19:33:35,0,0,0,0,0,0
4,201392389,2170660915,28821,36895,2024-10-04 19:33:36,0,0,0,0,0,0
4,201392389,2170660915,28821,36895,2024-10-04 19:33:37,0,0,0,0,0,0
4,201392389,2170660915,28821,36895,2024-10-04 19:33:38,0,0,0,0,0,0
4,201392389,2170660915,28821,36895,2024-10-04 19:33:39,0,0,0,0,0,0
4,201392389,2170660915,28821,36895,2024-10-04 19:33:40,0,0,0,0,0,0
4,201392389,2170660915,28821,36895,2024-10-04 19:33:41,0,0,0,0,0,0
4,201392389,2170660915,28821,36895,2024-10-04 19:33:42,0,0,0,0,0,0
4,201392389,2170660915,28821,36895,2024-10-04 19:33:43,0,0,0,0,0,0
4,201392389,2170660915,28821,36895,2024-10-04 19:33:44,0,0,0,0,0,0
4,201392389,2170660915,28821,36895,2024-10-04 19:33:45,0,0,0,0,0,0
4,201392389,2170660915,28821,36895,2024-10-04 19:33:46,0,0,0,0,0,0
4,201392389,2170660915,28821,36895,2024-10-04 19:33:47,0,0,0,0,0,0
4,201392389,2170660915,28821,36895,2024-10-04 19:33:48,0,0,0,0,0,0
4,201392389,2170660915,28821,36895,2024-10-04 19:33:49,0,0,0,0,0,0
4,201392389,2170660915,28821,36895,2024-10-04 19:33:50,0,0,0,0,0,0
4,201392389,2170660915,28821,36895,2024-10-04 19:33:51,0,0,0,0,0,0
4,201392389,2170660915,28821,36895,2024-10-04 19:33:52,0,0,0,0,0,0
4,201392389,2170660915,28821,36895,2024-10-04 19:33:53,0,0,0,0,0,0
4,201392389,2170660915,28821,36895,2024-10-04 19:33:54,0,0,0,0,0,0
4,201392389,2170660915,28821,36895,2024-10-04 19:33:55,0,0,0,0,0,0
4,201392389,2170660915,28821,36895,2024-10-04 19:33:56,0,0,0,0,0,0
4,201392389,2170660915,28821,36895,2024-10-04 19:33:57,0,0,0,0,0,0
4,201392389,2170660915,28821,36895,2024-10-04 19:33:58,0,0,0,0,0,0
4,201392389,2170660915,28821,36895,2024-10-04 19:33:59,0,0,0,0,0,0
4,201392389,2170660915,28821,36895,2024-10-04 19:34:00,0,0,0,0,0,0
4,201392389,2170660915,28821,36895,2024-10-04 19:34:01,0,0,0,0,0,0
4,201392389,2170660915,28821,36895,2024-10-04 19:34:02,0,0,0,0,0,0
4,201392389,2170660915,28821,36895,2024-10-04 19:34:03,0,0,0,0,0,0
4,201392389,2170660915,28821,36895,2024-10-04 19:34:04,0,0,0,0,0,0
4,201392389,2170660915,28821,36895,2024-10-04 19:34:05,0,0,0,0,0,0
4,201392389,2170660915,28821,36895,2024-10-04 19:34:06,0,0,0,0,0,0
4,201392389,2170660915,28821,36895,2024-10-04 19:34:07,0,0,0,0,0,0
4,201392389,2170660915,28821,36895,2024-10-04 19:34:08,0,0,0,0,0,0
4,201392389,2170660915,28821,36895,2024-10-04 19:34:09,0,0,0,0,0,0
4,201392389,2170660915,28821,36895,2024-10-04 19:34:10,0,0,0,0,0,0
4,201392389,2170660915,28821,36895,2024-10-04 19:34:11,0,0,0,0,0,0
4,201392389,2170660915,28821,36895,2024-10-04 19:34:12,0,0,0,0,0,0
4,201392389,2170660915,28821,36895,2024-10-04 19:34:13,0,0,0,0,0,0
4,201392389,2170660915,28821,36895,2024-10-04 19:34:14,0,0,0,0,0,0
4,201392389,2170660915,28821,36895,2024-10-04 19:34:15,0,0,0,0,0,0
4,201392389,2170660915,28821,36895,2024-10-04 19:34:16,0,0,0,0,0,0
4,201392389,2170660915,28821,36895,2024-10-04 19:34:17,0,0,0,0,0,0
4,201392389,2170660915,28821,36895,2024-10-04 19:34:18,0,0,0,0,0,0
4,201392389,2170660915,28821,36895,2024-10-04 19:34:19,0,0,0,0,0,0
4,201392389,2170660915,28821,36895,2024-10-04 19:34:20,0,0,0,0,0,0
4,201392389,2170660915,28821,36895,2024-10-04 19:34:21,0,0,0,0,0,0
4,201392389,2170660915,28821,36895,2024-10-04 19:34:22,0,0,0,0,0,0
4,201392389,2170660915,28821,36895,2024-10-04 19:34:23,0,0,0,0,0,0
4,201392389,2170660915,28821,36895,2024-10-04 19:34:24,0,0,0,0,0,0
4,201392389,2170660915,28821,36895,2024-10-04 19:34:25,0,0,0,0,0,0
4,201392389,2170660915,28821,36895,2024-10-04 19:34:26,0,0,0,0,0,0
4,201392389,2170660915,28821,36895,2024-10-04 19:34:27,0,0,0,0,0,0
4,201392389,2170660915,28821,36895,2024-10-04 19:34:28,0,0,0,0,0,0
4,201392389,2170660915,28821,36895,2024-10-04 19:34:29,0,0,0,0,0,0
4,201392389,2170660915,28821,36895,2024-10-04 19:34:30,0,0,0,0,0,0
4,201392389,2170660915,28821,36895,2024-10-04 19:34:31,0,0,0,0,0,0
4,201392389,2170660915,28821,36895,2024-10-04 19:34:32,0,0,0,0,0,0
4,201392389,2170660915,28821,36895,2024-10-04 19:34:33,0,0,0,0,0,0
4,201392389,2170660915,28821,36895,2024-10-04 19:34:34,0,0,0,0,0,0
4,201392389,2170660915,28821,36895,2024-10-04 19:34:35,0,0,0,0,0,0
4,201392389,2170660915,28821,36895,2024-10-04 19:34:36,0,0,0,0,0,0
4,201392389,2170660915,28821,36895,2024-10-04 19:34:37,0,0,0,0,0,0
4,201392389,2170660915,28821,36895,2024-10-04 19:34:38,0,0,0,0,0,0
4,201392389,2170660915,28821,36895,2024-10-04 19:34:39,0,0,0,0,0,0
4,201392389,2170660915,28821,36895,2024-10-04 19:34:40,0,0,0,0,0,0
4,201392389,2170660915,28821,36895,2024-10-04 19:34:41,0,0,0,0,0,0
4,201392389,2170660915,28821,36895,2024-10-04 19:34:42,0,0,0,0,0,0
4,201392389,2170660915,28821,36895,2024-10-04 19:34:43,0,0,0,0,0,0
4,201392389,2170660915,28821,36895,2024-10-04 19:34:44,0,0,0,0,0,0
4,201392389,2170660915,28821,36895,2024-10-04 19:34:45,0,0,0,0,0,0
4,201392389,2170660915,28821,36895,2024-10-04 19:34:46,0,0,0,0,0,0
4,201392389,2170660915,28821,36895,2024-10-04 19:34:47,0,0,0,0,0,0
4,201392389,2170660915,28821,36895,2024-10-04 19:34:48,0,0,0,0,0,0
4,201392389,2170660915,28821,36895,2024-10-04 19:34:49,0,0,0,0,0,0
4,201392389,2170660915,28821,36895,2024-10-04 19:34:50,0,0,0,0,0,0
4,201392389,2170660915,28821,36895,2024-10-04 19:34:51,0,0,0,0,0,0
4,201392389,2170660915,28821,36895,2024-10-04 19:34:52,0,0,0,0,0,0
4,201392389,2170660915,28821,36895,2024-10-04 19:34:53,0,0,0,0,0,0
4,201392389,2170660915,28821,36895,2024-10-04 19:34:54,0,0,0,0,0,0
4,201392389,2170660915,28821,36895,2024-10-04 19:34:55,0,0,0,0,0,0
4,201392389,2170660915,28821,36895,2024-10-04 19:34:56,0,0,0,0,0,0
4,201392389,2170660915,28821,36895,2024-10-04 19:34:57,0,0,0,0,0,0
4,201392389,2170660915,28821,36895,2024-10-04 19:34:58,0,0,0,0,0,0
4,201392389,2170660915,28821,36895,2024-10-04 19:34:59,0,0,0,0,0,0
4,201392389,2170660915,28821,36895,2024-10-04 19:35:00,0,0,0,0,0,0
4,201392389,2170660915,28821,36895,2024-10-04 19:35:01,0,0,0,0,0,0
4,201392389,2170660915,28821,36895,2024-10-04 19:35:02,0,0,0,0,0,0
4,201392389,2170660915,28821,36895,2024-10-04 19:35:03,0,0,0,0,0,0
4,201392389,2170660915,28821,36895,2024-10-04 19:35:04,0,0,0,0,0,0
4,201392389,2170660915,28821,36895,2024-10-04 19:35:05,0,0,0,0,0,0
4,201392389,2170660915,28821,36895,2024-10-04 19:35:06,0,0,0,0,0,0
4,201392389,2170660915,28821,36895,2024-10-04 19:35:07,0,0,0,0,0,0
4,201392389,2170660915,28821,36895,2024-10-04 19:35:08,0,0,0,0,0,0
4,201392389,2170660915,28821,36895,2024-10-04 19:35:09,0,0,0,0,0,0
4,201392389,2170660915,28821,36895,2024-10-04 19:35:10,0,0,0,0,0,0
4,201392389,2170660915,28821,36895,2024-10-04 19:35:11,0,0,0,0,0,0
4,201392389,2170660915,28821,36895,2024-10-04 19:35:12,0,0,0,0,0,0
4,201392389,2170660915,28821,36895,2024-10-04 19:35:13,0,0,0,0,0,0
4,201392389,2170660915,28821,36895,2024-10-04 19:35:14,0,0,0,0,0,0
4,201392389,2170660915,28821,36895,2024-10-04 19:35:15,0,0,0,0,0,0
4,201392389,2170660915,28821,36895,2024-10-04 19:35:16,0,0,0,0,0,0
4,201392389,2170660915,28821,36895,2024-10-04 19:35:17,0,0,0,0,0,0
4,201392389,2170660915,28821,36895,2024-10-04 19:35:18,0,0,0,0,0,0
4,201392389,2170660915,28821,36895,2024-10-04 19:35:19,0,0,0,0,0,0
4,201392389,2170660915,28821,36895,2024-10-04 19:35:20,0,0,0,0,0,0
4,201392389,2170660915,28821,36895,2024-10-04 19:35:21,0,0,0,0,0,0
4,201392389,2170660915,28821,36895,2024-10-04 19:35:22,0,0,0,0,0,0
4,201392389,2170660915,28821,36895,2024-10-04 19:35:23,0,0,0,0,0,0
4,201392389,2170660915,28821,36895,2024-10-04 19:35:24,0,0,0,0,0,0
4,201392389,2170660915,28821,36895,2024-10-04 19:35:25,0,0,0,0,0,0
4,201392389,2170660915,28821,36895,2024-10-04 19:35:26,0,0,0,0,0,0
4,201392389,2170660915,28821,36895,2024-10-04 19:35:27,0,0,0,0,0,0
4,201392389,2170660915,28821,36895,2024-10-04 19:35:28,0,0,0,0,0,0
4,201392389,2170660915,28821,36895,2024-10-04 19:35:29,0,0,0,0,0,0
4,201392389,2170660915,28821,36895,2024-10-04 19:35:30,0,0,0,0,0,0
4,201392389,2170660915,28821,36895,2024-10-04 19:35:31,0,0,0,0,0,0
4,201392389,2170660915,28821,36895,2024-10-04 19:35:32,0,0,0,0,0,0
4,201392389,2170660915,28821,36895,2024-10-04 19:35:33,0,0,0,0,0,0
4,201392389,2170660915,28821,36895,2024-10-04 19:35:34,0,0,0,0,0,0
4,201392389,2170660915,28821,36895,2024-10-04 19:35:35,0,0,0,0,0,0
4,201392389,2170660915,28821,36895,2024-10-04 19:35:36,0,0,0,0,0,0
4,201392389,2170660915,28821,36895,2024-10-04 19:35:37,0,0,0,0,0,0
4,201392389,2170660915,28821,36895,2024-10-04 19:35:38,0,0,0,0,0,0
4,201392389,2170660915,28821,36895,2024-10-04 19:35:39,0,0,0,0,0,0
4,201392389,2170660915,28821,36895,2024-10-04 19:35:40,0,0,0,0,0,0
4,201392389,2170660915,28821,36895,2024-10-04 19:35:41,0,0,0,0,0,0
4,201392389,2170660915,28821,36895,2024-10-04 19:35:42,0,0,0,0,0,0
4,201392389,2170660915,28821,36895,2024-10-04 19:35:43,0,0,0,0,0,0
4,201392389,2170660915,28821,36895,2024-10-04 19:35:44,0,0,0,0,0,0
4,201392389,2170660915,28821,36895,2024-10-04 19:35:45,0,0,0,0,0,0
4,201392389,2170660915,28821,36895,2024-10-04 19:35:46,0,0,0,0,0,0
4,201392389,2170660915,28821,36895,2024-10-04 19:35:47,0,0,0,0,0,0
4,201392389,2170660915,28821,36895,2024-10-04 19:35:48,0,0,0,0,0,0
4,201392389,2170660915,28821,36895,2024-10-04 19:35:49,0,0,0,0,0,0
4,201392389,2170660915,28821,36895,2024-10-04 19:35:50,0,0,0,0,0,0
4,201392389,2170660915,28821,36895,2024-10-04 19:35:51,0,0,0,0,0,0
4,201392389,2170660915,28821,36895,2024-10-04 19:35:52,0,0,0,0,0,0
4,201392389,2170660915,28821,36895,2024-10-04 19:35:53,0,0,0,0,0,0
4,201392389,2170660915,28821,36895,2024-10-04 19:35:54,0,0,0,0,0,0
4,201392389,2170660915,28821,36895,2024-10-04 19:35:55,0,0,0,0,0,0
4,201392389,2170660915,28821,36895,2024-10-04 19:35:56,0,0,0,0,0,0
4,201392389,2170660915,28821,36895,2024-10-04 19:35:57,0,0,0,0,0,0
4,201392389,2170660915,28821,36895,2024-10-04 19:35:58,0,0,0,0,0,0
4,201392389,2170660915,28821,36895,2024-10-04 19:35:59,0,0,0,0,0,0
4,201392389,2170660915,28821,36895,2024-10-04 19:36:00,0,0,0,0,0,0
4,201392389,2170660915,28821,36895,2024-10-04 19:36:01,0,0,0,0,0,0
4,201392389,2170660915,28821,36895,2024-10-04 19:36:02,0,0,0,0,0,0
4,201392389,2170660915,28821,36895,2024-10-04 19:36:03,0,0,0,0,0,0
4,201392389,2170660915,28821,36895,2024-10-04 19:36:04,0,0,0,0,0,0
4,201392389,2170660915,28821,36895,2024-10-04 19:36:05,0,0,0,0,0,0
4,201392389,2170660915,28821,36895,2024-10-04 19:36:06,0,0,0,0,0,0
4,201392389,2170660915,28821,36895,2024-10-04 19:36:07,0,0,0,0,0,0
4,201392389,2170660915,28821,36895,2024-10-04 19:36:08,0,0,0,0,0,0
4,201392389,2170660915,28821,36895,2024-10-04 19:36:09,0,0,0,0,0,0
4,201392389,2170660915,28821,36895,2024-10-04 19:36:10,0,0,0,0,0,0
4,201392389,2170660915,28821,36895,2024-10-04 19:36:11,0,0,0,0,0,0
4,201392389,2170660915,28821,36895,2024-10-04 19:36:12,0,0,0,0,0,0
4,201392389,2170660915,28821,36895,2024-10-04 19:36:13,0,0,0,0,0,0
4,201392389,2170660915,28821,36895,2024-10-04 19:36:14,0,0,0,0,0,0
4,201392389,2170660915,28821,36895,2024-10-04 19:36:15,0,0,0,0,0,0
4,201392389,2170660915,28821,36895,2024-10-04 19:36:16,0,0,0,0,0,0
4,201392389,2170660915,28821,36895,2024-10-04 19:36:17,0,0,0,0,0,0
4,201392389,2170660915,28821,36895,2024-10-04 19:36:18,0,0,0,0,0,0
4,201392389,2170660915,28821,36895,2024-10-04 19:36:19,0,0,0,0,0,0
4,201392389,2170660915,28821,36895,2024-10-04 19:36:20,0,0,0,0,0,0
4,201392389,2170660915,28821,36895,2024-10-04 19:36:21,0,0,0,0,0,0
4,201392389,2170660915,28821,36895,2024-10-04 19:36:22,0,0,0,0,0,0
4,201392389,2170660915,28821,36895,2024-10-04 19:36:23,0,0,0,0,0,0
4,201392389,2170660915,28821,36895,2024-10-04 19:36:24,0,0,0,0,0,0
4,201392389,2170660915,28821,36895,2024-10-04 19:36:25,0,0,0,0,0,0
4,201392389,2170660915,28821,36895,2024-10-04 19:36:26,0,0,0,0,0,0
4,201392389,2170660915,28821,36895,2024-10-04 19:36:27,0,0,0,0,0,0
4,201392389,2170660915,28821,36895,2024-10-04 19:36:28,0,0,0,0,0,0
4,201392389,2170660915,28821,36895,2024-10-04 19:36:29,0,0,0,0,0,0
4,201392389,2170660915,28821,36895,2024-10-04 19:36:30,0,0,0,0,0,0
4,201392389,2170660915,28821,36895,2024-10-04 19:36:31,0,0,0,0,0,0
4,201392389,2170660915,28821,36895,2024-10-04 19:36:32,0,0,0,0,0,0
4,201392389,2170660915,28821,36895,2024-10-04 19:36:33,0,0,0,0,0,0
4,201392389,2170660915,28821,36895,2024-10-04 19:36:34,0,0,0,0,0,0
4,201392389,2170660915,28821,36895,2024-10-04 19:36:35,0,0,0,0,0,0
4,201392389,2170660915,28821,36895,2024-10-04 19:36:36,0,0,0,0,0,0
4,201392389,2170660915,28821,36895,2024-10-04 19:36:37,0,0,0,0,0,0
4,201392389,2170660915,28821,36895,2024-10-04 19:36:38,0,0,0,0,0,0
4,201392389,2170660915,28821,36895,2024-10-04 19:36:39,0,0,0,0,0,0
4,201392389,2170660915,28821,36895,2024-10-04 19:36:40,0,0,0,0,0,0
4,201392389,2170660915,28821,36895,2024-10-04 19:36:41,0,0,0,0,0,0
4,201392389,2170660915,28821,36895,2024-10-04 19:36:42,0,0,0,0,0,0
4,201392389,2170660915,28821,36895,2024-10-04 19:36:43,0,0,0,0,0,0
4,201392389,2170660915,28821,36895,2024-10-04 19:36:44,0,0,0,0,0,0
4,201392389,2170660915,28821,36895,2024-10-04 19:36:45,0,0,0,0,0,0
4,201392389,2170660915,28821,36895,2024-10-04 19:36:46,0,0,0,0,0,0
4,201392389,2170660915,28821,36895,2024-10-04 19:36:47,0,0,0,0,0,0
4,201392389,2170660915,28821,36895,2024-10-04 19:36:48,0,0,0,0,0,0
4,201392389,2170660915,28821,36895,2024-10-04 19:36:49,0,0,0,0,0,0
4,201392389,2170660915,28821,36895,2024-10-04 19:36:50,0,0,0,0,0,0
4,201392389,2170660915,28821,36895,2024-10-04 19:36:51,0,0,0,0,0,0
4,201392389,2170660915,28821,36895,2024-10-04 19:36:52,0,0,0,0,0,0
4,201392389,2170660915,28821,36895,2024-10-04 19:36:53,0,0,0,0,0,0
4,201392389,2170660915,28821,36895,2024-10-04 19:36:54,0,0,0,0,0,0
4,201392389,2170660915,28821,36895,2024-10-04 19:36:55,0,0,0,0,0,0
4,201392389,2170660915,28821,36895,2024-10-04 19:36:56,0,0,0,0,0,0
4,201392389,2170660915,28821,36895,2024-10-04 19:36:57,0,0,0,0,0,0
4,201392389,2170660915,28821,36895,2024-10-04 19:36:58,0,0,0,0,0,0
4,201392389,2170660915,28821,36895,2024-10-04 19:36:59,0,0,0,0,0,0
4,201392389,2170660915,28821,36895,2024-10-04 19:37:00,0,0,0,0,0,0
4,201392389,2170660915,28821,36895,2024-10-04 19:37:01,0,0,0,0,0,0
4,201392389,2170660915,28821,36895,2024-10-04 19:37:02,0,0,0,0,0,0
4,201392389,2170660915,28821,36895,2024-10-04 19:37:03,0,0,0,0,0,0
4,201392389,2170660915,28821,36895,2024-10-04 19:37:04,0,0,0,0,0,0
4,201392389,2170660915,28821,36895,2024-10-04 19:37:05,0,0,0,0,0,0
4,201392389,2170660915,28821,36895,2024-10-04 19:37:06,0,0,0,0,0,0
4,201392389,2170660915,28821,36895,2024-10-04 19:37:07,0,0,0,0,0,0
4,201392389,2170660915,28821,36895,2024-10-04 19:37:08,0,0,0,0,0,0
4,201392389,2170660915,28821,36895,2024-10-04 19:37:09,0,0,0,0,0,0
4,201392389,2170660915,28821,36895,2024-10-04 19:37:10,0,0,0,0,0,0
4,201392389,2170660915,28821,36895,2024-10-04 19:37:11,0,0,0,0,0,0
4,201392389,2170660915,28821,36895,2024-10-04 19:37:12,0,0,0,0,0,0
4,201392389,2170660915,28821,36895,2024-10-04 19:37:13,0,0,0,0,0,0
4,201392389,2170660915,28821,36895,2024-10-04 19:37:14,0,0,0,0,0,0
4,201392389,2170660915,28821,36895,2024-10-04 19:37:15,0,0,0,0,0,0
4,201392389,2170660915,28821,36895,2024-10-04 19:37:16,0,0,0,0,0,0
4,201392389,2170660915,28821,36895,2024-10-04 19:37:17,0,0,0,0,0,0
4,201392389,2170660915,28821,36895,2024-10-04 19:37:18,0,0,0,0,0,0
4,201392389,2170660915,28821,36895,2024-10-04 19:37:19,0,0,0,0,0,0
4,201392389,2170660915,28821,36895,2024-10-04 19:37:20,0,0,0,0,0,0
4,201392389,2170660915,28821,36895,2024-10-04 19:37:21,0,0,0,0,0,0
4,201392389,2170660915,28821,36895,2024-10-04 19:37:22,0,0,0,0,0,0
4,201392389,2170660915,28821,36895,2024-10-04 19:37:23,0,0,0,0,0,0
4,201392389,2170660915,28821,36895,2024-10-04 19:37:24,0,0,0,0,0,0
4,201392389,2170660915,28821,36895,2024-10-04 19:37:25,0,0,0,0,0,0
4,201392389,2170660915,28821,36895,2024-10-04 19:37:26,0,0,0,0,0,0
4,201392389,2170660915,28821,36895,2024-10-04 19:37:27,0,0,0,0,0,0
4,201392389,2170660915,28821,36895,2024-10-04 19:37:28,0,0,0,0,0,0
4,201392389,2170660915,28821,36895,2024-10-04 19:37:29,0,0,0,0,0,0
4,201392389,2170660915,28821,36895,2024-10-04 19:37:30,0,0,0,0,0,0
4,201392389,2170660915,28821,36895,2024-10-04 19:37:31,0,0,0,0,0,0
4,201392389,2170660915,28821,36895,2024-10-04 19:37:32,0,0,0,0,0,0
4,201392389,2170660915,28821,36895,2024-10-04 19:37:33,0,0,0,0,0,0
4,201392389,2170660915,28821,36895,2024-10-04 19:37:34,0,0,0,0,0,0
4,201392389,2170660915,28821,36895,2024-10-04 19:37:35,0,0,0,0,0,0
4,201392389,2170660915,28821,36895,2024-10-04 19:37:36,0,0,0,0,0,0
4,201392389,2170660915,28821,36895,2024-10-04 19:37:37,0,0,0,0,0,0
4,201392389,2170660915,28821,36895,2024-10-04 19:37:38,0,0,0,0,0,0
4,201392389,2170660915,28821,36895,2024-10-04 19:37:39,0,0,0,0,0,0
4,201392389,2170660915,28821,36895,2024-10-04 19:37:40,0,0,0,0,0,0
4,201392389,2170660915,28821,36895,2024-10-04 19:37:41,0,0,0,0,0,0
4,201392389,2170660915,28821,36895,2024-10-04 19:37:42,0,0,0,0,0,0
4,201392389,2170660915,28821,36895,2024-10-04 19:37:43,0,0,0,0,0,0
4,201392389,2170660915,28821,36895,2024-10-04 19:37:44,0,0,0,0,0,0
4,201392389,2170660915,28821,36895,2024-10-04 19:37:45,0,0,0,0,0,0
4,201392389,2170660915,28821,36895,2024-10-04 19:37:46,0,0,0,0,0,0
4,201392389,2170660915,28821,36895,2024-10-04 19:37:47,0,0,0,0,0,0
4,201392389,2170660915,28821,36895,2024-10-04 19:37:48,0,0,0,0,0,0
4,201392389,2170660915,28821,36895,2024-10-04 19:37:49,0,0,0,0,0,0
4,201392389,2170660915,28821,36895,2024-10-04 19:37:50,0,0,0,0,0,0
4,201392389,2170660915,28821,36895,2024-10-04 19:37:51,0,0,0,0,0,0
4,201392389,2170660915,28821,36895,2024-10-04 19:37:52,0,0,0,0,0,0
4,201392389,2170660915,28821,36895,2024-10-04 19:37:53,0,0,0,0,0,0
4,201392389,2170660915,28821,36895,2024-10-04 19:37:54,0,0,0,0,0,0
4,201392389,2170660915,28821,36895,2024-10-04 19:37:55,0,0,0,0,0,0
4,201392389,2170660915,28821,36895,2024-10-04 19:37:56,0,0,0,0,0,0
4,201392389,2170660915,28821,36895,2024-10-04 19:37:57,0,0,0,0,0,0
4,201392389,2170660915,28821,36895,2024-10-04 19:37:58,0,0,0,0,0,0
4,201392389,2170660915,28821,36895,2024-10-04 19:37:59,0,0,0,0,0,0
4,201392389,2170660915,28821,36895,2024-10-04 19:38:00,0,0,0,0,0,0
4,201392389,2170660915,28821,36895,2024-10-04 19:38:01,0,0,0,0,0,0
4,201392389,2170660915,28821,36895,2024-10-04 19:38:02,0,0,0,0,0,0
4,201392389,2170660915,28821,36895,2024-10-04 19:38:03,0,0,0,0,0,0
4,201392389,2170660915,28821,36895,2024-10-04 19:38:04,0,0,0,0,0,0
4,201392389,2170660915,28821,36895,2024-10-04 19:38:05,0,0,0,0,0,0
4,201392389,2170660915,28821,36895,2024-10-04 19:38:06,0,0,0,0,0,0
4,201392389,2170660915,28821,36895,2024-10-04 19:38:07,0,0,0,0,0,0
4,201392389,2170660915,28821,36895,2024-10-04 19:38:08,0,0,0,0,0,0
4,201392389,2170660915,28821,36895,2024-10-04 19:38:09,0,0,0,0,0,0
4,201392389,2170660915,28821,36895,2024-10-04 19:38:10,0,0,0,0,0,0
4,201392389,2170660915,28821,36895,2024-10-04 19:38:11,0,0,0,0,0,0
4,201392389,2170660915,28821,36895,2024-10-04 19:38:12,0,0,0,0,0,0
4,201392389,2170660915,28821,36895,2024-10-04 19:38:13,0,0,0,0,0,0
4,201392389,2170660915,28821,36895,2024-10-04 19:38:14,0,0,0,0,0,0
4,201392389,2170660915,28821,36895,2024-10-04 19:38:15,0,0,0,0,0,0
4,201392389,2170660915,28821,36895,2024-10-04 19:38:16,0,0,0,0,0,0
4,201392389,2170660915,28821,36895,2024-10-04 19:38:17,0,0,0,0,0,0
4,201392389,2170660915,28821,36895,2024-10-04 19:38:18,0,0,0,0,0,0
4,201392389,2170660915,28821,36895,2024-10-04 19:38:19,0,0,0,0,0,0
4,201392389,2170660915,28821,36895,2024-10-04 19:38:20,0,0,0,0,0,0
4,201392389,2170660915,28821,36895,2024-10-04 19:38:21,0,0,0,0,0,0
4,201392389,2170660915,28821,36895,2024-10-04 19:38:22,0,0,0,0,0,0
4,201392389,2170660915,28821,36895,2024-10-04 19:38:23,0,0,0,0,0,0
4,201392389,2170660915,28821,36895,2024-10-04 19:38:24,0,0,0,0,0,0
4,201392389,2170660915,28821,36895,2024-10-04 19:38:25,0,0,0,0,0,0
4,201392389,2170660915,28821,36895,2024-10-04 19:38:26,0,0,0,0,0,0
4,201392389,2170660915,28821,36895,2024-10-04 19:38:27,0,0,0,0,0,0
4,201392389,2170660915,28821,36895,2024-10-04 19:38:28,0,0,0,0,0,0
4,201392389,2170660915,28821,36895,2024-10-04 19:38:29,0,0,0,0,0,0
4,201392389,2170660915,28821,36895,2024-10-04 19:38:30,0,0,0,0,0,0
4,201392389,2170660915,28821,36895,2024-10-04 19:38:31,0,0,0,0,0,0
4,201392389,2170660915,28821,36895,2024-10-04 19:38:32,0,0,0,0,0,0
4,201392389,2170660915,28821,36895,2024-10-04 19:38:33,0,0,0,0,0,0
4,201392389,2170660915,28821,36895,2024-10-04 19:38:34,0,0,0,0,0,0
4,201392389,2170660915,28821,36895,2024-10-04 19:38:35,0,0,0,0,0,0
4,201392389,2170660915,28821,36895,2024-10-04 19:38:36,0,0,0,0,0,0
4,201392389,2170660915,28821,36895,2024-10-04 19:38:37,0,0,0,0,0,0
4,201392389,2170660915,28821,36895,2024-10-04 19:38:38,0,0,0,0,0,0
4,201392389,2170660915,28821,36895,2024-10-04 19:38:39,0,0,0,0,0,0
4,201392389,2170660915,28821,36895,2024-10-04 19:38:40,0,0,0,0,0,0
4,201392389,2170660915,28821,36895,2024-10-04 19:38:41,0,0,0,0,0,0
4,201392389,2170660915,28821,36895,2024-10-04 19:38:42,0,0,0,0,0,0
4,201392389,2170660915,28821,36895,2024-10-04 19:38:43,0,0,0,0,0,0
4,201392389,2170660915,28821,36895,2024-10-04 19:38:44,0,0,0,0,0,0
4,201392389,2170660915,28821,36895,2024-10-04 19:38:45,0,0,0,0,0,0
4,201392389,2170660915,28821,36895,2024-10-04 19:38:46,0,0,0,0,0,0
4,201392389,2170660915,28821,36895,2024-10-04 19:38:47,0,0,0,0,0,0
4,201392389,2170660915,28821,36895,2024-10-04 19:38:48,0,0,0,0,0,0
4,201392389,2170660915,28821,36895,2024-10-04 19:38:49,0,0,0,0,0,0
4,201392389,2170660915,28821,36895,2024-10-04 19:38:50,0,0,0,0,0,0
4,201392389,2170660915,28821,36895,2024-10-04 19:38:51,0,0,0,0,0,0
4,201392389,2170660915,28821,36895,2024-10-04 19:38:52,0,0,0,0,0,0
4,201392389,2170660915,28821,36895,2024-10-04 19:38:53,0,0,0,0,0,0
4,201392389,2170660915,28821,36895,2024-10-04 19:38:54,0,0,0,0,0,0
4,201392389,2170660915,28821,36895,2024-10-04 19:38:55,0,0,0,0,0,0
4,201392389,2170660915,28821,36895,2024-10-04 19:38:56,0,0,0,0,0,0
4,201392389,2170660915,28821,36895,2024-10-04 19:38:57,0,0,0,0,0,0
4,201392389,2170660915,28821,36895,2024-10-04 19:38:58,0,0,0,0,0,0
4,201392389,2170660915,28821,36895,2024-10-04 19:38:59,0,0,0,0,0,0
4,201392389,2170660915,28821,36895,2024-10-04 19:39:00,0,0,0,0,0,0
4,201392389,2170660915,28821,36895,2024-10-04 19:39:01,0,0,0,0,0,0
4,201392389,2170660915,28821,36895,2024-10-04 19:39:02,0,0,0,0,0,0
4,201392389,2170660915,28821,36895,2024-10-04 19:39:03,0,0,0,0,0,0
4,201392389,2170660915,28821,36895,2024-10-04 19:39:04,0,0,0,0,0,0
4,201392389,2170660915,28821,36895,2024-10-04 19:39:05,0,0,0,0,0,0
4,201392389,2170660915,28821,36895,2024-10-04 19:39:06,0,0,0,0,0,0
4,201392389,2170660915,28821,36895,2024-10-04 19:39:07,0,0,0,0,0,0
4,201392389,2170660915,28821,36895,2024-10-04 19:39:08,0,0,0,0,0,0
4,201392389,2170660915,28821,36895,2024-10-04 19:39:09,0,0,0,0,0,0
4,201392389,2170660915,28821,36895,2024-10-04 19:39:10,0,0,0,0,0,0
4,201392389,2170660915,28821,36895,2024-10-04 19:39:11,0,0,0,0,0,0
4,201392389,2170660915,28821,36895,2024-10-04 19:39:12,0,0,0,0,0,0
4,201392389,2170660915,28821,36895,2024-10-04 19:39:13,0,0,0,0,0,0
4,201392389,2170660915,28821,36895,2024-10-04 19:39:14,0,0,0,0,0,0
4,201392389,2170660915,28821,36895,2024-10-04 19:39:15,0,0,0,0,0,0
4,201392389,2170660915,28821,36895,2024-10-04 19:39:16,0,0,0,0,0,0
4,201392389,2170660915,28821,36895,2024-10-04 19:39:17,0,0,0,0,0,0
4,201392389,2170660915,28821,36895,2024-10-04 19:39:18,0,0,0,0,0,0
4,201392389,2170660915,28821,36895,2024-10-04 19:39:19,0,0,0,0,0,0
4,201392389,2170660915,28821,36895,2024-10-04 19:39:20,0,0,0,0,0,0
4,201392389,2170660915,28821,36895,2024-10-04 19:39:21,0,0,0,0,0,0
4,201392389,2170660915,28821,36895,2024-10-04 19:39:22,0,0,0,0,0,0
4,201392389,2170660915,28821,36895,2024-10-04 19:39:23,0,0,0,0,0,0
4,201392389,2170660915,28821,36895,2024-10-04 19:39:24,0,0,0,0,0,0
4,201392389,2170660915,28821,36895,2024-10-04 19:39:25,0,0,0,0,0,0
4,201392389,2170660915,28821,36895,2024-10-04 19:39:26,0,0,0,0,0,0
4,201392389,2170660915,28821,36895,2024-10-04 19:39:27,0,0,0,0,0,0
4,201392389,2170660915,28821,36895,2024-10-04 19:39:28,0,0,0,0,0,0
4,201392389,2170660915,28821,36895,2024-10-04 19:39:29,0,0,0,0,0,0
4,201392389,2170660915,28821,36895,2024-10-04 19:39:30,0,0,0,0,0,0
4,201392389,2170660915,28821,36895,2024-10-04 19:39:31,0,0,0,0,0,0
4,201392389,2170660915,28821,36895,2024-10-04 19:39:32,0,0,0,0,0,0
4,201392389,2170660915,28821,36895,2024-10-04 19:39:33,0,0,0,0,0,0
4,201392389,2170660915,28821,36895,2024-10-04 19:39:34,0,0,0,0,0,0
4,201392389,2170660915,28821,36895,2024-10-04 19:39:35,0,0,0,0,0,0
4,201392389,2170660915,28821,36895,2024-10-04 19:39:36,0,0,0,0,0,0
4,201392389,2170660915,28821,36895,2024-10-04 19:39:37,0,0,0,0,0,0
4,201392389,2170660915,28821,36895,2024-10-04 19:39:38,0,0,0,0,0,0
4,201392389,2170660915,28821,36895,2024-10-04 19:39:39,0,0,0,0,0,0
4,201392389,2170660915,28821,36895,2024-10-04 19:39:40,0,0,0,0,0,0
4,201392389,2170660915,28821,36895,2024-10-04 19:39:41,0,0,0,0,0,0
4,201392389,2170660915,28821,36895,2024-10-04 19:39:42,0,0,0,0,0,0
4,201392389,2170660915,28821,36895,2024-10-04 19:39:43,0,0,0,0,0,0
4,201392389,2170660915,28821,36895,2024-10-04 19:39:44,0,0,0,0,0,0
4,201392389,2170660915,28821,36895,2024-10-04 19:39:45,0,0,0,0,0,0
4,201392389,2170660915,28821,36895,2024-10-04 19:39:46,0,0,0,0,0,0
4,201392389,2170660915,28821,36895,2024-10-04 19:39:47,0,0,0,0,0,0
4,201392389,2170660915,28821,36895,2024-10-04 19:39:48,0,0,0,0,0,0
4,201392389,2170660915,28821,36895,2024-10-04 19:39:49,0,0,0,0,0,0
4,201392389,2170660915,28821,36895,2024-10-04 19:39:50,0,0,0,0,0,0
4,201392389,2170660915,28821,36895,2024-10-04 19:39:51,0,0,0,0,0,0
4,201392389,2170660915,28821,36895,2024-10-04 19:39:52,0,0,0,0,0,0
4,201392389,2170660915,28821,36895,2024-10-04 19:39:53,0,0,0,0,0,0
4,201392389,2170660915,28821,36895,2024-10-04 19:39:54,0,0,0,0,0,0
4,201392389,2170660915,28821,36895,2024-10-04 19:39:55,0,0,0,0,0,0
4,201392389,2170660915,28821,36895,2024-10-04 19:39:56,0,0,0,0,0,0
4,201392389,2170660915,28821,36895,2024-10-04 19:39:57,0,0,0,0,0,0
4,201392389,2170660915,28821,36895,2024-10-04 19:39:58,0,0,0,0,0,0
4,201392389,2170660915,28821,36895,2024-10-04 19:39:59,0,0,0,0,0,0
4,201392389,2170660915,28821,36895,2024-10-04 19:40:00,0,0,0,0,0,0
4,201392389,2170660915,28821,36895,2024-10-04 19:40:01,0,0,0,0,0,0
4,201392389,2170660915,28821,36895,2024-10-04 19:40:02,0,0,0,0,0,0
4,201392389,2170660915,28821,36895,2024-10-04 19:40:03,0,0,0,0,0,0
4,201392389,2170660915,28821,36895,2024-10-04 19:40:04,0,0,0,0,0,0
4,201392389,2170660915,28821,36895,2024-10-04 19:40:05,0,0,0,0,0,0
4,201392389,2170660915,28821,36895,2024-10-04 19:40:06,0,0,0,0,0,0
4,201392389,2170660915,28821,36895,2024-10-04 19:40:07,0,0,0,0,0,0
4,201392389,2170660915,28821,36895,2024-10-04 19:40:08,0,0,0,0,0,0
4,201392389,2170660915,28821,36895,2024-10-04 19:40:09,0,0,0,0,0,0
4,201392389,2170660915,28821,36895,2024-10-04 19:40:10,0,0,0,0,0,0
4,201392389,2170660915,28821,36895,2024-10-04 19:40:11,0,0,0,0,0,0
4,201392389,2170660915,28821,36895,2024-10-04 19:40:12,0,0,0,0,0,0
4,201392389,2170660915,28821,36895,2024-10-04 19:40:13,0,0,0,0,0,0
4,201392389,2170660915,28821,36895,2024-10-04 19:40:14,0,0,0,0,0,0
4,201392389,2170660915,28821,36895,2024-10-04 19:40:15,0,0,0,0,0,0
4,201392389,2170660915,28821,36895,2024-10-04 19:40:16,0,0,0,0,0,0
4,201392389,2170660915,28821,36895,2024-10-04 19:40:17,0,0,0,0,0,0
4,201392389,2170660915,28821,36895,2024-10-04 19:40:18,0,0,0,0,0,0
4,201392389,2170660915,28821,36895,2024-10-04 19:40:19,0,0,0,0,0,0
4,201392389,2170660915,28821,36895,2024-10-04 19:40:20,0,0,0,0,0,0
4,201392389,2170660915,28821,36895,2024-10-04 19:40:21,0,0,0,0,0,0
4,201392389,2170660915,28821,36895,2024-10-04 19:40:22,0,0,0,0,0,0
4,201392389,2170660915,28821,36895,2024-10-04 19:40:23,0,0,0,0,0,0
4,201392389,2170660915,28821,36895,2024-10-04 19:40:24,0,0,0,0,0,0
4,201392389,2170660915,28821,36895,2024-10-04 19:40:25,0,0,0,0,0,0
4,201392389,2170660915,28821,36895,2024-10-04 19:40:26,0,0,0,0,0,0
4,201392389,2170660915,28821,36895,2024-10-04 19:40:27,0,0,0,0,0,0
4,201392389,2170660915,28821,36895,2024-10-04 19:40:28,0,0,0,0,0,0
4,201392389,2170660915,28821,36895,2024-10-04 19:40:29,0,0,0,0,0,0
4,201392389,2170660915,28821,36895,2024-10-04 19:40:30,0,0,0,0,0,0
4,201392389,2170660915,28821,36895,2024-10-04 19:40:31,0,0,0,0,0,0
4,201392389,2170660915,28821,36895,2024-10-04 19:40:32,0,0,0,0,0,0
4,201392389,2170660915,28821,36895,2024-10-04 19:40:33,0,0,0,0,0,0
4,201392389,2170660915,28821,36895,2024-10-04 19:40:34,0,0,0,0,0,0
4,201392389,2170660915,28821,36895,2024-10-04 19:40:35,0,0,0,0,0,0
4,201392389,2170660915,28821,36895,2024-10-04 19:40:36,0,0,0,0,0,0
4,201392389,2170660915,28821,36895,2024-10-04 19:40:37,0,0,0,0,0,0
4,201392389,2170660915,28821,36895,2024-10-04 19:40:38,0,0,0,0,0,0
4,201392389,2170660915,28821,36895,2024-10-04 19:40:39,0,0,0,0,0,0
4,201392389,2170660915,28821,36895,2024-10-04 19:40:40,0,0,0,0,0,0
4,201392389,2170660915,28821,36895,2024-10-04 19:40:41,0,0,0,0,0,0
4,201392389,2170660915,28821,36895,2024-10-04 19:40:42,0,0,0,0,0,0
4,201392389,2170660915,28821,36895,2024-10-04 19:40:43,0,0,0,0,0,0
4,201392389,2170660915,28821,36895,2024-10-04 19:40:44,0,0,0,0,0,0
4,201392389,2170660915,28821,36895,2024-10-04 19:40:45,0,0,0,0,0,0
4,201392389,2170660915,28821,36895,2024-10-04 19:40:46,0,0,0,0,0,0
4,201392389,2170660915,28821,36895,2024-10-04 19:40:47,0,0,0,0,0,0
4,201392389,2170660915,28821,36895,2024-10-04 19:40:48,0,0,0,0,0,0
4,201392389,2170660915,28821,36895,2024-10-04 19:40:49,0,0,0,0,0,0
4,201392389,2170660915,28821,36895,2024-10-04 19:40:50,0,0,0,0,0,0
4,201392389,2170660915,28821,36895,2024-10-04 19:40:51,0,0,0,0,0,0
4,201392389,2170660915,28821,36895,2024-10-04 19:40:52,0,0,0,0,0,0
4,201392389,2170660915,28821,36895,2024-10-04 19:40:53,0,0,0,0,0,0
4,201392389,2170660915,28821,36895,2024-10-04 19:40:54,0,0,0,0,0,0
4,201392389,2170660915,28821,36895,2024-10-04 19:40:55,0,0,0,0,0,0
4,201392389,2170660915,28821,36895,2024-10-04 19:40:56,0,0,0,0,0,0
4,201392389,2170660915,28821,36895,2024-10-04 19:40:57,0,0,0,0,0,0
4,201392389,2170660915,28821,36895,2024-10-04 19:40:58,0,0,0,0,0,0
4,201392389,2170660915,28821,36895,2024-10-04 19:40:59,0,0,0,0,0,0
4,201392389,2170660915,28821,36895,2024-10-04 19:41:00,0,0,0,0,0,0
4,201392389,2170660915,28821,36895,2024-10-04 19:41:01,0,0,0,0,0,0
4,201392389,2170660915,28821,36895,2024-10-04 19:41:02,0,0,0,0,0,0
4,201392389,2170660915,28821,36895,2024-10-04 19:41:03,0,0,0,0,0,0
4,201392389,2170660915,28821,36895,2024-10-04 19:41:04,0,0,0,0,0,0
4,201392389,2170660915,28821,36895,2024-10-04 19:41:05,0,0,0,0,0,0
4,201392389,2170660915,28821,36895,2024-10-04 19:41:06,0,0,0,0,0,0
4,201392389,2170660915,28821,36895,2024-10-04 19:41:07,0,0,0,0,0,0
4,201392389,2170660915,28821,36895,2024-10-04 19:41:08,0,0,0,0,0,0
4,201392389,2170660915,28821,36895,2024-10-04 19:41:09,0,0,0,0,0,0
4,201392389,2170660915,28821,36895,2024-10-04 19:41:10,0,0,0,0,0,0
4,201392389,2170660915,28821,36895,2024-10-04 19:41:11,0,0,0,0,0,0
4,201392389,2170660915,28821,36895,2024-10-04 19:41:12,0,0,0,0,0,0
4,201392389,2170660915,28821,36895,2024-10-04 19:41:13,0,0,0,0,0,0
4,201392389,2170660915,28821,36895,2024-10-04 19:41:14,0,0,0,0,0,0
4,201392389,2170660915,28821,36895,2024-10-04 19:41:15,0,0,0,0,0,0
4,201392389,2170660915,28821,36895,2024-10-04 19:41:16,0,0,0,0,0,0
4,201392389,2170660915,28821,36895,2024-10-04 19:41:17,0,0,0,0,0,0
4,201392389,2170660915,28821,36895,2024-10-04 19:41:18,0,0,0,0,0,0
4,201392389,2170660915,28821,36895,2024-10-04 19:41:19,0,0,0,0,0,0
4,201392389,2170660915,28821,36895,2024-10-04 19:41:20,0,0,0,0,0,0
4,201392389,2170660915,28821,36895,2024-10-04 19:41:21,0,0,0,0,0,0
4,201392389,2170660915,28821,36895,2024-10-04 19:41:22,0,0,0,0,0,0
4,201392389,2170660915,28821,36895,2024-10-04 19:41:23,0,0,0,0,0,0
4,201392389,2170660915,28821,36895,2024-10-04 19:41:24,0,0,0,0,0,0
4,201392389,2170660915,28821,36895,2024-10-04 19:41:25,0,0,0,0,0,0
4,201392389,2170660915,28821,36895,2024-10-04 19:41:26,0,0,0,0,0,0
4,201392389,2170660915,28821,36895,2024-10-04 19:41:27,0,0,0,0,0,0
4,201392389,2170660915,28821,36895,2024-10-04 19:41:28,0,0,0,0,0,0
4,201392389,2170660915,28821,36895,2024-10-04 19:41:29,0,0,0,0,0,0
4,201392389,2170660915,28821,36895,2024-10-04 19:41:30,0,0,0,0,0,0
4,201392389,2170660915,28821,36895,2024-10-04 19:41:31,0,0,0,0,0,0
4,201392389,2170660915,28821,36895,2024-10-04 19:41:32,0,0,0,0,0,0
4,201392389,2170660915,28821,36895,2024-10-04 19:41:33,0,0,0,0,0,0
4,201392389,2170660915,28821,36895,2024-10-04 19:41:34,0,0,0,0,0,0
4,201392389,2170660915,28821,36895,2024-10-04 19:41:35,0,0,0,0,0,0
4,201392389,2170660915,28821,36895,2024-10-04 19:41:36,0,0,0,0,0,0
4,201392389,2170660915,28821,36895,2024-10-04 19:41:37,0,0,0,0,0,0
4,201392389,2170660915,28821,36895,2024-10-04 19:41:38,0,0,0,0,0,0
4,201392389,2170660915,28821,36895,2024-10-04 19:41:39,0,0,0,0,0,0
4,201392389,2170660915,28821,36895,2024-10-04 19:41:40,0,0,0,0,0,0
4,201392389,2170660915,28821,36895,2024-10-04 19:41:41,0,0,0,0,0,0
4,201392389,2170660915,28821,36895,2024-10-04 19:41:42,0,0,0,0,0,0
4,201392389,2170660915,28821,36895,2024-10-04 19:41:43,0,0,0,0,0,0
4,201392389,2170660915,28821,36895,2024-10-04 19:41:44,0,0,0,0,0,0
4,201392389,2170660915,28821,36895,2024-10-04 19:41:45,0,0,0,0,0,0
4,201392389,2170660915,28821,36895,2024-10-04 19:41:46,0,0,0,0,0,0
4,201392389,2170660915,28821,36895,2024-10-04 19:41:47,0,0,0,0,0,0
4,201392389,2170660915,28821,36895,2024-10-04 19:41:48,0,0,0,0,0,0
4,201392389,2170660915,28821,36895,2024-10-04 19:41:49,0,0,0,0,0,0
4,201392389,2170660915,28821,36895,2024-10-04 19:41:50,0,0,0,0,0,0
4,201392389,2170660915,28821,36895,2024-10-04 19:41:51,0,0,0,0,0,0
4,201392389,2170660915,28821,36895,2024-10-04 19:41:52,0,0,0,0,0,0
4,201392389,2170660915,28821,36895,2024-10-04 19:41:53,0,0,0,0,0,0
4,201392389,2170660915,28821,36895,2024-10-04 19:41:54,0,0,0,0,0,0
4,201392389,2170660915,28821,36895,2024-10-04 19:41:55,0,0,0,0,0,0
4,201392389,2170660915,28821,36895,2024-10-04 19:41:56,0,0,0,0,0,0
4,201392389,2170660915,28821,36895,2024-10-04 19:41:57,0,0,0,0,0,0
4,201392389,2170660915,28821,36895,2024-10-04 19:41:58,0,0,0,0,0,0
4,201392389,2170660915,28821,36895,2024-10-04 19:41:59,0,0,0,0,0,0
4,201392389,2170660915,28821,36895,2024-10-04 19:42:00,0,0,0,0,0,0
4,201392389,2170660915,28821,36895,2024-10-04 19:42:01,0,0,0,0,0,0
4,201392389,2170660915,28821,36895,2024-10-04 19:42:02,0,0,0,0,0,0
4,201392389,2170660915,28821,36895,2024-10-04 19:42:03,0,0,0,0,0,0
4,201392389,2170660915,28821,36895,2024-10-04 19:42:04,0,0,0,0,0,0
4,201392389,2170660915,28821,36895,2024-10-04 19:42:05,0,0,0,0,0,0
4,201392389,2170660915,28821,36895,2024-10-04 19:42:06,0,0,0,0,0,0
4,201392389,2170660915,28821,36895,2024-10-04 19:42:07,0,0,0,0,0,0
4,201392389,2170660915,28821,36895,2024-10-04 19:42:08,0,0,0,0,0,0
4,201392389,2170660915,28821,36895,2024-10-04 19:42:09,0,0,0,0,0,0
4,201392389,2170660915,28821,36895,2024-10-04 19:42:10,0,0,0,0,0,0
4,201392389,2170660915,28821,36895,2024-10-04 19:42:11,0,0,0,0,0,0
4,201392389,2170660915,28821,36895,2024-10-04 19:42:12,0,0,0,0,0,0
4,201392389,2170660915,28821,36895,2024-10-04 19:42:13,0,0,0,0,0,0
4,201392389,2170660915,28821,36895,2024-10-04 19:42:14,0,0,0,0,0,0
4,201392389,2170660915,28821,36895,2024-10-04 19:42:15,0,0,0,0,0,0
4,201392389,2170660915,28821,36895,2024-10-04 19:42:16,0,0,0,0,0,0
4,201392389,2170660915,28821,36895,2024-10-04 19:42:17,0,0,0,0,0,0
4,201392389,2170660915,28821,36895,2024-10-04 19:42:18,0,0,0,0,0,0
4,201392389,2170660915,28821,36895,2024-10-04 19:42:19,0,0,0,0,0,0
4,201392389,2170660915,28821,36895,2024-10-04 19:42:20,0,0,0,0,0,0
4,201392389,2170660915,28821,36895,2024-10-04 19:42:21,0,0,0,0,0,0
4,201392389,2170660915,28821,36895,2024-10-04 19:42:22,0,0,0,0,0,0
4,201392389,2170660915,28821,36895,2024-10-04 19:42:23,0,0,0,0,0,0
4,201392389,2170660915,28821,36895,2024-10-04 19:42:24,0,0,0,0,0,0
4,201392389,2170660915,28821,36895,2024-10-04 19:42:25,0,0,0,0,0,0
4,201392389,2170660915,28821,36895,2024-10-04 19:42:26,0,0,0,0,0,0
4,201392389,2170660915,28821,36895,2024-10-04 19:42:27,0,0,0,0,0,0
4,201392389,2170660915,28821,36895,2024-10-04 19:42:28,0,0,0,0,0,0
4,201392389,2170660915,28821,36895,2024-10-04 19:42:29,0,0,0,0,0,0
4,201392389,2170660915,28821,36895,2024-10-04 19:42:30,0,0,0,0,0,0
4,201392389,2170660915,28821,36895,2024-10-04 19:42:31,0,0,0,0,0,0
4,201392389,2170660915,28821,36895,2024-10-04 19:42:32,0,0,0,0,0,0
4,201392389,2170660915,28821,36895,2024-10-04 19:42:33,0,0,0,0,0,0
4,201392389,2170660915,28821,36895,2024-10-04 19:42:34,0,0,0,0,0,0
4,201392389,2170660915,28821,36895,2024-10-04 19:42:35,0,0,0,0,0,0
4,201392389,2170660915,28821,36895,2024-10-04 19:42:36,0,0,0,0,0,0
4,201392389,2170660915,28821,36895,2024-10-04 19:42:37,0,0,0,0,0,0
4,201392389,2170660915,28821,36895,2024-10-04 19:42:38,0,0,0,0,0,0
4,201392389,2170660915,28821,36895,2024-10-04 19:42:39,0,0,0,0,0,0
4,201392389,2170660915,28821,36895,2024-10-04 19:42:40,0,0,0,0,0,0
4,201392389,2170660915,28821,36895,2024-10-04 19:42:41,0,0,0,0,0,0
4,201392389,2170660915,28821,36895,2024-10-04 19:42:42,0,0,0,0,0,0
4,201392389,2170660915,28821,36895,2024-10-04 19:42:43,0,0,0,0,0,0
4,201392389,2170660915,28821,36895,2024-10-04 19:42:44,0,0,0,0,0,0
4,201392389,2170660915,28821,36895,2024-10-04 19:42:45,0,0,0,0,0,0
4,201392389,2170660915,28821,36895,2024-10-04 19:42:46,0,0,0,0,0,0
4,201392389,2170660915,28821,36895,2024-10-04 19:42:47,0,0,0,0,0,0
4,201392389,2170660915,28821,36895,2024-10-04 19:42:48,0,0,0,0,0,0
4,201392389,2170660915,28821,36895,2024-10-04 19:42:49,0,0,0,0,0,0
4,201392389,2170660915,28821,36895,2024-10-04 19:42:50,0,0,0,0,0,0
4,201392389,2170660915,28821,36895,2024-10-04 19:42:51,0,0,0,0,0,0
4,201392389,2170660915,28821,36895,2024-10-04 19:42:52,0,0,0,0,0,0
4,201392389,2170660915,28821,36895,2024-10-04 19:42:53,0,0,0,0,0,0
4,201392389,2170660915,28821,36895,2024-10-04 19:42:54,0,0,0,0,0,0
4,201392389,2170660915,28821,36895,2024-10-04 19:42:55,0,0,0,0,0,0
4,201392389,2170660915,28821,36895,2024-10-04 19:42:56,0,0,0,0,0,0
4,201392389,2170660915,28821,36895,2024-10-04 19:42:57,0,0,0,0,0,0
4,201392389,2170660915,28821,36895,2024-10-04 19:42:58,0,0,0,0,0,0
4,201392389,2170660915,28821,36895,2024-10-04 19:42:59,0,0,0,0,0,0
4,201392389,2170660915,28821,36895,2024-10-04 19:43:00,0,0,0,0,0,0
4,201392389,2170660915,28821,36895,2024-10-04 19:43:01,0,0,0,0,0,0
4,201392389,2170660915,28821,36895,2024-10-04 19:43:02,0,0,0,0,0,0
4,201392389,2170660915,28821,36895,2024-10-04 19:43:03,0,0,0,0,0,0
4,201392389,2170660915,28821,36895,2024-10-04 19:43:04,0,0,0,0,0,0
4,201392389,2170660915,28821,36895,2024-10-04 19:43:05,0,0,0,0,0,0
4,201392389,2170660915,28821,36895,2024-10-04 19:43:06,0,0,0,0,0,0
4,201392389,2170660915,28821,36895,2024-10-04 19:43:07,0,0,0,0,0,0
4,201392389,2170660915,28821,36895,2024-10-04 19:43:08,0,0,0,0,0,0
4,201392389,2170660915,28821,36895,2024-10-04 19:43:09,0,0,0,0,0,0
4,201392389,2170660915,28821,36895,2024-10-04 19:43:10,0,0,0,0,0,0
4,201392389,2170660915,28821,36895,2024-10-04 19:43:11,0,0,0,0,0,0
4,201392389,2170660915,28821,36895,2024-10-04 19:43:12,0,0,0,0,0,0
4,201392389,2170660915,28821,36895,2024-10-04 19:43:13,0,0,0,0,0,0
4,201392389,2170660915,28821,36895,2024-10-04 19:43:14,0,0,0,0,0,0
4,201392389,2170660915,28821,36895,2024-10-04 19:43:15,0,0,0,0,0,0
4,201392389,2170660915,28821,36895,2024-10-04 19:43:16,0,0,0,0,0,0
4,201392389,2170660915,28821,36895,2024-10-04 19:43:17,0,0,0,0,0,0
4,201392389,2170660915,28821,36895,2024-10-04 19:43:18,0,0,0,0,0,0
4,201392389,2170660915,28821,36895,2024-10-04 19:43:19,0,0,0,0,0,0
4,201392389,2170660915,28821,36895,2024-10-04 19:43:20,0,0,0,0,0,0
4,201392389,2170660915,28821,36895,2024-10-04 19:43:21,0,0,0,0,0,0
4,201392389,2170660915,28821,36895,2024-10-04 19:43:22,0,0,0,0,0,0
4,201392389,2170660915,28821,36895,2024-10-04 19:43:23,0,0,0,0,0,0
4,201392389,2170660915,28821,36895,2024-10-04 19:43:24,0,0,0,0,0,0
4,201392389,2170660915,28821,36895,2024-10-04 19:43:25,0,0,0,0,0,0
4,201392389,2170660915,28821,36895,2024-10-04 19:43:26,0,0,0,0,0,0
4,201392389,2170660915,28821,36895,2024-10-04 19:43:27,0,0,0,0,0,0
4,201392389,2170660915,28821,36895,2024-10-04 19:43:28,0,0,0,0,0,0
4,201392389,2170660915,28821,36895,2024-10-04 19:43:29,0,0,0,0,0,0
4,201392389,2170660915,28821,36895,2024-10-04 19:43:30,0,0,0,0,0,0
4,201392389,2170660915,28821,36895,2024-10-04 19:43:31,0,0,0,0,0,0
4,201392389,2170660915,28821,36895,2024-10-04 19:43:32,0,0,0,0,0,0
4,201392389,2170660915,28821,36895,2024-10-04 19:43:33,0,0,0,0,0,0
4,201392389,2170660915,28821,36895,2024-10-04 19:43:34,0,0,0,0,0,0
4,201392389,2170660915,28821,36895,2024-10-04 19:43:35,0,0,0,0,0,0
4,201392389,2170660915,28821,36895,2024-10-04 19:43:36,0,0,0,0,0,0
4,201392389,2170660915,28821,36895,2024-10-04 19:43:37,0,0,0,0,0,0
4,201392389,2170660915,28821,36895,2024-10-04 19:43:38,0,0,0,0,0,0
4,201392389,2170660915,28821,36895,2024-10-04 19:43:39,0,0,0,0,0,0
4,201392389,2170660915,28821,36895,2024-10-04 19:43:40,0,0,0,0,0,0
4,201392389,2170660915,28821,36895,2024-10-04 19:43:41,0,0,0,0,0,0
4,201392389,2170660915,28821,36895,2024-10-04 19:43:42,0,0,0,0,0,0
4,201392389,2170660915,28821,36895,2024-10-04 19:43:43,0,0,0,0,0,0
4,201392389,2170660915,28821,36895,2024-10-04 19:43:44,0,0,0,0,0,0
4,201392389,2170660915,28821,36895,2024-10-04 19:43:45,0,0,0,0,0,0
4,201392389,2170660915,28821,36895,2024-10-04 19:43:46,0,0,0,0,0,0
4,201392389,2170660915,28821,36895,2024-10-04 19:43:47,0,0,0,0,0,0
4,201392389,2170660915,28821,36895,2024-10-04 19:43:48,0,0,0,0,0,0
4,201392389,2170660915,28821,36895,2024-10-04 19:43:49,0,0,0,0,0,0
4,201392389,2170660915,28821,36895,2024-10-04 19:43:50,0,0,0,0,0,0
4,201392389,2170660915,28821,36895,2024-10-04 19:43:51,0,0,0,0,0,0
4,201392389,2170660915,28821,36895,2024-10-04 19:43:52,0,0,0,0,0,0
4,201392389,2170660915,28821,36895,2024-10-04 19:43:53,0,0,0,0,0,0
4,201392389,2170660915,28821,36895,2024-10-04 19:43:54,0,0,0,0,0,0
4,201392389,2170660915,28821,36895,2024-10-04 19:43:55,0,0,0,0,0,0
4,201392389,2170660915,28821,36895,2024-10-04 19:43:56,0,0,0,0,0,0
4,201392389,2170660915,28821,36895,2024-10-04 19:43:57,0,0,0,0,0,0
4,201392389,2170660915,28821,36895,2024-10-04 19:43:58,0,0,0,0,0,0
4,201392389,2170660915,28821,36895,2024-10-04 19:43:59,0,0,0,0,0,0
4,201392389,2170660915,28821,36895,2024-10-04 19:44:00,0,0,0,0,0,0
4,201392389,2170660915,28821,36895,2024-10-04 19:44:01,0,0,0,0,0,0
4,201392389,2170660915,28821,36895,2024-10-04 19:44:02,0,0,0,0,0,0
4,201392389,2170660915,28821,36895,2024-10-04 19:44:03,0,0,0,0,0,0
4,201392389,2170660915,28821,36895,2024-10-04 19:44:04,0,0,0,0,0,0
4,201392389,2170660915,28821,36895,2024-10-04 19:44:05,0,0,0,0,0,0
4,201392389,2170660915,28821,36895,2024-10-04 19:44:06,0,0,0,0,0,0
4,201392389,2170660915,28821,36895,2024-10-04 19:44:07,0,0,0,0,0,0
4,201392389,2170660915,28821,36895,2024-10-04 19:44:08,0,0,0,0,0,0
4,201392389,2170660915,28821,36895,2024-10-04 19:44:09,0,0,0,0,0,0
4,201392389,2170660915,28821,36895,2024-10-04 19:44:10,0,0,0,0,0,0
4,201392389,2170660915,28821,36895,2024-10-04 19:44:11,0,0,0,0,0,0
4,201392389,2170660915,28821,36895,2024-10-04 19:44:12,0,0,0,0,0,0
4,201392389,2170660915,28821,36895,2024-10-04 19:44:13,0,0,0,0,0,0
4,201392389,2170660915,28821,36895,2024-10-04 19:44:14,0,0,0,0,0,0
4,201392389,2170660915,28821,36895,2024-10-04 19:44:15,0,0,0,0,0,0
4,201392389,2170660915,28821,36895,2024-10-04 19:44:16,0,0,0,0,0,0
4,201392389,2170660915,28821,36895,2024-10-04 19:44:17,0,0,0,0,0,0
4,201392389,2170660915,28821,36895,2024-10-04 19:44:18,0,0,0,0,0,0
4,201392389,2170660915,28821,36895,2024-10-04 19:44:19,0,0,0,0,0,0
4,201392389,2170660915,28821,36895,2024-10-04 19:44:20,0,0,0,0,0,0
4,201392389,2170660915,28821,36895,2024-10-04 19:44:21,0,0,0,0,0,0
4,201392389,2170660915,28821,36895,2024-10-04 19:44:22,0,0,0,0,0,0
4,201392389,2170660915,28821,36895,2024-10-04 19:44:23,0,0,0,0,0,0
4,201392389,2170660915,28821,36895,2024-10-04 19:44:24,0,0,0,0,0,0
4,201392389,2170660915,28821,36895,2024-10-04 19:44:25,0,0,0,0,0,0
4,201392389,2170660915,28821,36895,2024-10-04 19:44:26,0,0,0,0,0,0
4,201392389,2170660915,28821,36895,2024-10-04 19:44:27,0,0,0,0,0,0
4,201392389,2170660915,28821,36895,2024-10-04 19:44:28,0,0,0,0,0,0
4,201392389,2170660915,28821,36895,2024-10-04 19:44:29,0,0,0,0,0,0
4,201392389,2170660915,28821,36895,2024-10-04 19:44:30,0,0,0,0,0,0
4,201392389,2170660915,28821,36895,2024-10-04 19:44:31,0,0,0,0,0,0
4,201392389,2170660915,28821,36895,2024-10-04 19:44:32,0,0,0,0,0,0
4,201392389,2170660915,28821,36895,2024-10-04 19:44:33,0,0,0,0,0,0
4,201392389,2170660915,28821,36895,2024-10-04 19:44:34,0,0,0,0,0,0
4,201392389,2170660915,28821,36895,2024-10-04 19:44:35,0,0,0,0,0,0
4,201392389,2170660915,28821,36895,2024-10-04 19:44:36,0,0,0,0,0,0
4,201392389,2170660915,28821,36895,2024-10-04 19:44:37,0,0,0,0,0,0
4,201392389,2170660915,28821,36895,2024-10-04 19:44:38,0,0,0,0,0,0
4,201392389,2170660915,28821,36895,2024-10-04 19:44:39,0,0,0,0,0,0
4,201392389,2170660915,28821,36895,2024-10-04 19:44:40,0,0,0,0,0,0
4,201392389,2170660915,28821,36895,2024-10-04 19:44:41,0,0,0,0,0,0
4,201392389,2170660915,28821,36895,2024-10-04 19:44:42,0,0,0,0,0,0
4,201392389,2170660915,28821,36895,2024-10-04 19:44:43,0,0,0,0,0,0
4,201392389,2170660915,28821,36895,2024-10-04 19:44:44,0,0,0,0,0,0
4,201392389,2170660915,28821,36895,2024-10-04 19:44:45,0,0,0,0,0,0
4,201392389,2170660915,28821,36895,2024-10-04 19:44:46,0,0,0,0,0,0
4,201392389,2170660915,28821,36895,2024-10-04 19:44:47,0,0,0,0,0,0
4,201392389,2170660915,28821,36895,2024-10-04 19:44:48,0,0,0,0,0,0
4,201392389,2170660915,28821,36895,2024-10-04 19:44:49,0,0,0,0,0,0
4,201392389,2170660915,28821,36895,2024-10-04 19:44:50,0,0,0,0,0,0
4,201392389,2170660915,28821,36895,2024-10-04 19:44:51,0,0,0,0,0,0
4,201392389,2170660915,28821,36895,2024-10-04 19:44:52,0,0,0,0,0,0
4,201392389,2170660915,28821,36895,2024-10-04 19:44:53,0,0,0,0,0,0
4,201392389,2170660915,28821,36895,2024-10-04 19:44:54,0,0,0,0,0,0
4,201392389,2170660915,28821,36895,2024-10-04 19:44:55,0,0,0,0,0,0
4,201392389,2170660915,28821,36895,2024-10-04 19:44:56,0,0,0,0,0,0
4,201392389,2170660915,28821,36895,2024-10-04 19:44:57,0,0,0,0,0,0
4,201392389,2170660915,28821,36895,2024-10-04 19:44:58,0,0,0,0,0,0
4,201392389,2170660915,28821,36895,2024-10-04 19:44:59,0,0,0,0,0,0
4,201392389,2170660915,28821,36895,2024-10-04 19:45:00,0,0,0,0,0,0
4,201392389,2170660915,28821,36895,2024-10-04 19:45:01,0,0,0,0,0,0
4,201392389,2170660915,28821,36895,2024-10-04 19:45:02,0,0,0,0,0,0
4,201392389,2170660915,28821,36895,2024-10-04 19:45:03,0,0,0,0,0,0
4,201392389,2170660915,28821,36895,2024-10-04 19:45:04,0,0,0,0,0,0
4,201392389,2170660915,28821,36895,2024-10-04 19:45:05,0,0,0,0,0,0
4,201392389,2170660915,28821,36895,2024-10-04 19:45:06,0,0,0,0,0,0
4,201392389,2170660915,28821,36895,2024-10-04 19:45:07,0,0,0,0,0,0
4,201392389,2170660915,28821,36895,2024-10-04 19:45:08,0,0,0,0,0,0
4,201392389,2170660915,28821,36895,2024-10-04 19:45:09,0,0,0,0,0,0
4,201392389,2170660915,28821,36895,2024-10-04 19:45:10,0,0,0,0,0,0
4,201392389,2170660915,28821,36895,2024-10-04 19:45:11,0,0,0,0,0,0
4,201392389,2170660915,28821,36895,2024-10-04 19:45:12,0,0,0,0,0,0
4,201392389,2170660915,28821,36895,2024-10-04 19:45:13,0,0,0,0,0,0
4,201392389,2170660915,28821,36895,2024-10-04 19:45:14,0,0,0,0,0,0
4,201392389,2170660915,28821,36895,2024-10-04 19:45:15,0,0,0,0,0,0
4,201392389,2170660915,28821,36895,2024-10-04 19:45:16,0,0,0,0,0,0
4,201392389,2170660915,28821,36895,2024-10-04 19:45:17,0,0,0,0,0,0
4,201392389,2170660915,28821,36895,2024-10-04 19:45:18,0,0,0,0,0,0
4,201392389,2170660915,28821,36895,2024-10-04 19:45:19,0,0,0,0,0,0
4,201392389,2170660915,28821,36895,2024-10-04 19:45:20,0,0,0,0,0,0
4,201392389,2170660915,28821,36895,2024-10-04 19:45:21,0,0,0,0,0,0
4,201392389,2170660915,28821,36895,2024-10-04 19:45:22,0,0,0,0,0,0
4,201392389,2170660915,28821,36895,2024-10-04 19:45:23,0,0,0,0,0,0
4,201392389,2170660915,28821,36895,2024-10-04 19:45:24,0,0,0,0,0,0
4,201392389,2170660915,28821,36895,2024-10-04 19:45:25,0,0,0,0,0,0
4,201392389,2170660915,28821,36895,2024-10-04 19:45:26,0,0,0,0,0,0
4,201392389,2170660915,28821,36895,2024-10-04 19:45:27,0,0,0,0,0,0
4,201392389,2170660915,28821,36895,2024-10-04 19:45:28,0,0,0,0,0,0
4,201392389,2170660915,28821,36895,2024-10-04 19:45:29,0,0,0,0,0,0
4,201392389,2170660915,28821,36895,2024-10-04 19:45:30,0,0,0,0,0,0
4,201392389,2170660915,28821,36895,2024-10-04 19:45:31,0,0,0,0,0,0
4,201392389,2170660915,28821,36895,2024-10-04 19:45:32,0,0,0,0,0,0
4,201392389,2170660915,28821,36895,2024-10-04 19:45:33,0,0,0,0,0,0
4,201392389,2170660915,28821,36895,2024-10-04 19:45:34,0,0,0,0,0,0
4,201392389,2170660915,28821,36895,2024-10-04 19:45:35,0,0,0,0,0,0
4,201392389,2170660915,28821,36895,2024-10-04 19:45:36,0,0,0,0,0,0
4,201392389,2170660915,28821,36895,2024-10-04 19:45:37,0,0,0,0,0,0
4,201392389,2170660915,28821,36895,2024-10-04 19:45:38,0,0,0,0,0,0
4,201392389,2170660915,28821,36895,2024-10-04 19:45:39,0,0,0,0,0,0
4,201392389,2170660915,28821,36895,2024-10-04 19:45:40,0,0,0,0,0,0
4,201392389,2170660915,28821,36895,2024-10-04 19:45:41,0,0,0,0,0,0
4,201392389,2170660915,28821,36895,2024-10-04 19:45:42,0,0,0,0,0,0
4,201392389,2170660915,28821,36895,2024-10-04 19:45:43,0,0,0,0,0,0
4,201392389,2170660915,28821,36895,2024-10-04 19:45:44,0,0,0,0,0,0
4,201392389,2170660915,28821,36895,2024-10-04 19:45:45,0,0,0,0,0,0
4,201392389,2170660915,28821,36895,2024-10-04 19:45:46,0,0,0,0,0,0
4,201392389,2170660915,28821,36895,2024-10-04 19:45:47,0,0,0,0,0,0
4,201392389,2170660915,28821,36895,2024-10-04 19:45:48,0,0,0,0,0,0
4,201392389,2170660915,28821,36895,2024-10-04 19:45:49,0,0,0,0,0,0
4,201392389,2170660915,28821,36895,2024-10-04 19:45:50,0,0,0,0,0,0
4,201392389,2170660915,28821,36895,2024-10-04 19:45:51,0,0,0,0,0,0
4,201392389,2170660915,28821,36895,2024-10-04 19:45:52,0,0,0,0,0,0
4,201392389,2170660915,28821,36895,2024-10-04 19:45:53,0,0,0,0,0,0
4,201392389,2170660915,28821,36895,2024-10-04 19:45:54,0,0,0,0,0,0
4,201392389,2170660915,28821,36895,2024-10-04 19:45:55,0,0,0,0,0,0
4,201392389,2170660915,28821,36895,2024-10-04 19:45:56,0,0,0,0,0,0
4,201392389,2170660915,28821,36895,2024-10-04 19:45:57,0,0,0,0,0,0
4,201392389,2170660915,28821,36895,2024-10-04 19:45:58,0,0,0,0,0,0
4,201392389,2170660915,28821,36895,2024-10-04 19:45:59,0,0,0,0,0,0
4,201392389,2170660915,28821,36895,2024-10-04 19:46:00,0,0,0,0,0,0
4,201392389,2170660915,28821,36895,2024-10-04 19:46:01,0,0,0,0,0,0
4,201392389,2170660915,28821,36895,2024-10-04 19:46:02,0,0,0,0,0,0
4,201392389,2170660915,28821,36895,2024-10-04 19:46:03,0,0,0,0,0,0
4,201392389,2170660915,28821,36895,2024-10-04 19:46:04,0,0,0,0,0,0
4,201392389,2170660915,28821,36895,2024-10-04 19:46:05,0,0,0,0,0,0
4,201392389,2170660915,28821,36895,2024-10-04 19:46:06,0,0,0,0,0,0
4,201392389,2170660915,28821,36895,2024-10-04 19:46:07,0,0,0,0,0,0
4,201392389,2170660915,28821,36895,2024-10-04 19:46:08,0,0,0,0,0,0
4,201392389,2170660915,28821,36895,2024-10-04 19:46:09,0,0,0,0,0,0
4,201392389,2170660915,28821,36895,2024-10-04 19:46:10,0,0,0,0,0,0
4,201392389,2170660915,28821,36895,2024-10-04 19:46:11,0,0,0,0,0,0
4,201392389,2170660915,28821,36895,2024-10-04 19:46:12,0,0,0,0,0,0
4,201392389,2170660915,28821,36895,2024-10-04 19:46:13,0,0,0,0,0,0
4,201392389,2170660915,28821,36895,2024-10-04 19:46:14,0,0,0,0,0,0
4,201392389,2170660915,28821,36895,2024-10-04 19:46:15,0,0,0,0,0,0
4,201392389,2170660915,28821,36895,2024-10-04 19:46:16,0,0,0,0,0,0
4,201392389,2170660915,28821,36895,2024-10-04 19:46:17,0,0,0,0,0,0
4,201392389,2170660915,28821,36895,2024-10-04 19:46:18,0,0,0,0,0,0
4,201392389,2170660915,28821,36895,2024-10-04 19:46:19,0,0,0,0,0,0
4,201392389,2170660915,28821,36895,2024-10-04 19:46:20,0,0,0,0,0,0
4,201392389,2170660915,28821,36895,2024-10-04 19:46:21,0,0,0,0,0,0
4,201392389,2170660915,28821,36895,2024-10-04 19:46:22,0,0,0,0,0,0
4,201392389,2170660915,28821,36895,2024-10-04 19:46:23,0,0,0,0,0,0
4,201392389,2170660915,28821,36895,2024-10-04 19:46:24,0,0,0,0,0,0
4,201392389,2170660915,28821,36895,2024-10-04 19:46:25,0,0,0,0,0,0
4,201392389,2170660915,28821,36895,2024-10-04 19:46:26,0,0,0,0,0,0
4,201392389,2170660915,28821,36895,2024-10-04 19:46:27,0,0,0,0,0,0
4,201392389,2170660915,28821,36895,2024-10-04 19:46:28,0,0,0,0,0,0
4,201392389,2170660915,28821,36895,2024-10-04 19:46:29,0,0,0,0,0,0
4,201392389,2170660915,28821,36895,2024-10-04 19:46:30,0,0,0,0,0,0
4,201392389,2170660915,28821,36895,2024-10-04 19:46:31,0,0,0,0,0,0
4,201392389,2170660915,28821,36895,2024-10-04 19:46:32,0,0,0,0,0,0
4,201392389,2170660915,28821,36895,2024-10-04 19:46:33,0,0,0,0,0,0
4,201392389,2170660915,28821,36895,2024-10-04 19:46:34,0,0,0,0,0,0
4,201392389,2170660915,28821,36895,2024-10-04 19:46:35,0,0,0,0,0,0
4,201392389,2170660915,28821,36895,2024-10-04 19:46:36,0,0,0,0,0,0
4,201392389,2170660915,28821,36895,2024-10-04 19:46:37,0,0,0,0,0,0
4,201392389,2170660915,28821,36895,2024-10-04 19:46:38,0,0,0,0,0,0
4,201392389,2170660915,28821,36895,2024-10-04 19:46:39,0,0,0,0,0,0
4,201392389,2170660915,28821,36895,2024-10-04 19:46:40,0,0,0,0,0,0
4,201392389,2170660915,28821,36895,2024-10-04 19:46:41,0,0,0,0,0,0
4,201392389,2170660915,28821,36895,2024-10-04 19:46:42,0,0,0,0,0,0
4,201392389,2170660915,28821,36895,2024-10-04 19:46:43,0,0,0,0,0,0
4,201392389,2170660915,28821,36895,2024-10-04 19:46:44,0,0,0,0,0,0
4,201392389,2170660915,28821,36895,2024-10-04 19:46:45,0,0,0,0,0,0
4,201392389,2170660915,28821,36895,2024-10-04 19:46:46,0,0,0,0,0,0
4,201392389,2170660915,28821,36895,2024-10-04 19:46:47,0,0,0,0,0,0
4,201392389,2170660915,28821,36895,2024-10-04 19:46:48,0,0,0,0,0,0
4,201392389,2170660915,28821,36895,2024-10-04 19:46:49,0,0,0,0,0,0
4,201392389,2170660915,28821,36895,2024-10-04 19:46:50,0,0,0,0,0,0
4,201392389,2170660915,28821,36895,2024-10-04 19:46:51,0,0,0,0,0,0
4,201392389,2170660915,28821,36895,2024-10-04 19:46:52,0,0,0,0,0,0
4,201392389,2170660915,28821,36895,2024-10-04 19:46:53,0,0,0,0,0,0
4,201392389,2170660915,28821,36895,2024-10-04 19:46:54,0,0,0,0,0,0
4,201392389,2170660915,28821,36895,2024-10-04 19:46:55,0,0,0,0,0,0
4,201392389,2170660915,28821,36895,2024-10-04 19:46:56,0,0,0,0,0,0
4,201392389,2170660915,28821,36895,2024-10-04 19:46:57,0,0,0,0,0,0
4,201392389,2170660915,28821,36895,2024-10-04 19:46:58,0,0,0,0,0,0
4,201392389,2170660915,28821,36895,2024-10-04 19:46:59,0,0,0,0,0,0
4,201392389,2170660915,28821,36895,2024-10-04 19:47:00,0,0,0,0,0,0
4,201392389,2170660915,28821,36895,2024-10-04 19:47:01,0,0,0,0,0,0
4,201392389,2170660915,28821,36895,2024-10-04 19:47:02,0,0,0,0,0,0
4,201392389,2170660915,28821,36895,2024-10-04 19:47:03,0,0,0,0,0,0
4,201392389,2170660915,28821,36895,2024-10-04 19:47:04,0,0,0,0,0,0
4,201392389,2170660915,28821,36895,2024-10-04 19:47:05,0,0,0,0,0,0
4,201392389,2170660915,28821,36895,2024-10-04 19:47:06,0,0,0,0,0,0
4,201392389,2170660915,28821,36895,2024-10-04 19:47:07,0,0,0,0,0,0
4,201392389,2170660915,28821,36895,2024-10-04 19:47:08,0,0,0,0,0,0
4,201392389,2170660915,28821,36895,2024-10-04 19:47:09,0,0,0,0,0,0
4,201392389,2170660915,28821,36895,2024-10-04 19:47:10,0,0,0,0,0,0
4,201392389,2170660915,28821,36895,2024-10-04 19:47:11,0,0,0,0,0,0
4,201392389,2170660915,28821,36895,2024-10-04 19:47:12,0,0,0,0,0,0
4,201392389,2170660915,28821,36895,2024-10-04 19:47:13,0,0,0,0,0,0
4,201392389,2170660915,28821,36895,2024-10-04 19:47:14,0,0,0,0,0,0
4,201392389,2170660915,28821,36895,2024-10-04 19:47:15,0,0,0,0,0,0
4,201392389,2170660915,28821,36895,2024-10-04 19:47:16,0,0,0,0,0,0
4,201392389,2170660915,28821,36895,2024-10-04 19:47:17,0,0,0,0,0,0
4,201392389,2170660915,28821,36895,2024-10-04 19:47:18,0,0,0,0,0,0
4,201392389,2170660915,28821,36895,2024-10-04 19:47:19,0,0,0,0,0,0
4,201392389,2170660915,28821,36895,2024-10-04 19:47:20,0,0,0,0,0,0
4,201392389,2170660915,28821,36895,2024-10-04 19:47:21,0,0,0,0,0,0
4,201392389,2170660915,28821,36895,2024-10-04 19:47:22,0,0,0,0,0,0
4,201392389,2170660915,28821,36895,2024-10-04 19:47:23,0,0,0,0,0,0
4,201392389,2170660915,28821,36895,2024-10-04 19:47:24,0,0,0,0,0,0
4,201392389,2170660915,28821,36895,2024-10-04 19:47:25,0,0,0,0,0,0
4,201392389,2170660915,28821,36895,2024-10-04 19:47:26,0,0,0,0,0,0
4,201392389,2170660915,28821,36895,2024-10-04 19:47:27,0,0,0,0,0,0
4,201392389,2170660915,28821,36895,2024-10-04 19:47:28,0,0,0,0,0,0
4,201392389,2170660915,28821,36895,2024-10-04 19:47:29,0,0,0,0,0,0
4,201392389,2170660915,28821,36895,2024-10-04 19:47:30,0,0,0,0,0,0
4,201392389,2170660915,28821,36895,2024-10-04 19:47:31,0,0,0,0,0,0
4,201392389,2170660915,28821,36895,2024-10-04 19:47:32,0,0,0,0,0,0
4,201392389,2170660915,28821,36895,2024-10-04 19:47:33,0,0,0,0,0,0
4,201392389,2170660915,28821,36895,2024-10-04 19:47:34,0,0,0,0,0,0
4,201392389,2170660915,28821,36895,2024-10-04 19:47:35,0,0,0,0,0,0
4,201392389,2170660915,28821,36895,2024-10-04 19:47:36,0,0,0,0,0,0
4,201392389,2170660915,28821,36895,2024-10-04 19:47:37,0,0,0,0,0,0
4,201392389,2170660915,28821,36895,2024-10-04 19:47:38,0,0,0,0,0,0
4,201392389,2170660915,28821,36895,2024-10-04 19:47:39,0,0,0,0,0,0
4,201392389,2170660915,28821,36895,2024-10-04 19:47:40,0,0,0,0,0,0
4,201392389,2170660915,28821,36895,2024-10-04 19:47:41,0,0,0,0,0,0
4,201392389,2170660915,28821,36895,2024-10-04 19:47:42,0,0,0,0,0,0
4,201392389,2170660915,28821,36895,2024-10-04 19:47:43,0,0,0,0,0,0
4,201392389,2170660915,28821,36895,2024-10-04 19:47:44,0,0,0,0,0,0
4,201392389,2170660915,28821,36895,2024-10-04 19:47:45,0,0,0,0,0,0
4,201392389,2170660915,28821,36895,2024-10-04 19:47:46,0,0,0,0,0,0
4,201392389,2170660915,28821,36895,2024-10-04 19:47:47,0,0,0,0,0,0
4,201392389,2170660915,28821,36895,2024-10-04 19:47:48,0,0,0,0,0,0
4,201392389,2170660915,28821,36895,2024-10-04 19:47:49,0,0,0,0,0,0
4,201392389,2170660915,28821,36895,2024-10-04 19:47:50,0,0,0,0,0,0
4,201392389,2170660915,28821,36895,2024-10-04 19:47:51,0,0,0,0,0,0
4,201392389,2170660915,28821,36895,2024-10-04 19:47:52,0,0,0,0,0,0
4,201392389,2170660915,28821,36895,2024-10-04 19:47:53,0,0,0,0,0,0
4,201392389,2170660915,28821,36895,2024-10-04 19:47:54,0,0,0,0,0,0
4,201392389,2170660915,28821,36895,2024-10-04 19:47:55,0,0,0,0,0,0
4,201392389,2170660915,28821,36895,2024-10-04 19:47:56,0,0,0,0,0,0
4,201392389,2170660915,28821,36895,2024-10-04 19:47:57,0,0,0,0,0,0
4,201392389,2170660915,28821,36895,2024-10-04 19:47:58,0,0,0,0,0,0
4,201392389,2170660915,28821,36895,2024-10-04 19:47:59,0,0,0,0,0,0
4,201392389,2170660915,28821,36895,2024-10-04 19:48:00,0,0,0,0,0,0
4,201392389,2170660915,28821,36895,2024-10-04 19:48:01,0,0,0,0,0,0
4,201392389,2170660915,28821,36895,2024-10-04 19:48:02,0,0,0,0,0,0
4,201392389,2170660915,28821,36895,2024-10-04 19:48:03,0,0,0,0,0,0
4,201392389,2170660915,28821,36895,2024-10-04 19:48:04,0,0,0,0,0,0
4,201392389,2170660915,28821,36895,2024-10-04 19:48:05,0,0,0,0,0,0
4,201392389,2170660915,28821,36895,2024-10-04 19:48:06,0,0,0,0,0,0
4,201392389,2170660915,28821,36895,2024-10-04 19:48:07,0,0,0,0,0,0
4,201392389,2170660915,28821,36895,2024-10-04 19:48:08,0,0,0,0,0,0
4,201392389,2170660915,28821,36895,2024-10-04 19:48:09,0,0,0,0,0,0
4,201392389,2170660915,28821,36895,2024-10-04 19:48:10,0,0,0,0,0,0
3,201392388,2170660915,0,0,2024-10-04 19:18:51,128,84,212,1,1,2
3,201392388,2170660915,0,0,2024-10-04 19:18:52,128,84,212,1,1,2
3,201392388,2170660915,0,0,2024-10-04 19:18:53,128,84,212,1,1,2
3,201392388,2170660915,0,0,2024-10-04 19:18:54,128,84,212,1,1,2
3,201392388,2170660915,0,0,2024-10-04 19:18:55,128,84,212,1,1,2
3,201392388,2170660915,0,0,2024-10-04 19:18:56,128,84,212,1,1,2
3,201392388,2170660915,0,0,2024-10-04 19:18:57,128,84,212,1,1,2
3,201392388,2170660915,0,0,2024-10-04 19:18:58,128,84,212,1,1,2
3,201392388,2170660915,0,0,2024-10-04 19:18:59,128,84,212,1,1,2
3,201392388,2170660915,0,0,2024-10-04 19:19:00,128,84,212,1,1,2
3,201392388,2170660915,0,0,2024-10-04 19:19:01,0,0,0,0,0,0
3,201392388,2170660915,35489,36895,2024-10-04 19:19:02,666,507,1173,6,6,12
3,201392388,2170660915,0,0,2024-10-04 19:19:02,0,0,0,0,0,0
3,201392388,2170660915,35489,36895,2024-10-04 19:19:03,0,0,0,0,0,0
3,201392388,2170660915,0,0,2024-10-04 19:19:03,128,84,212,1,1,2
3,201392388,2170660915,35489,36895,2024-10-04 19:19:04,0,0,0,0,0,0
3,201392388,2170660915,0,0,2024-10-04 19:19:04,128,84,212,1,1,2
3,201392388,2170660915,35489,36895,2024-10-04 19:19:05,0,0,0,0,0,0
3,201392388,2170660915,0,0,2024-10-04 19:19:05,128,84,212,1,1,2
3,201392388,2170660915,35489,36895,2024-10-04 19:19:06,0,0,0,0,0,0
3,201392388,2170660915,0,0,2024-10-04 19:19:06,0,0,0,0,0,0
3,201392388,2170660915,35489,36895,2024-10-04 19:19:07,0,0,0,0,0,0
3,201392388,2170660915,0,0,2024-10-04 19:19:07,0,0,0,0,0,0
3,201392388,2170660915,35489,36895,2024-10-04 19:19:08,0,0,0,0,0,0
3,201392388,2170660915,0,0,2024-10-04 19:19:08,0,0,0,0,0,0
3,201392388,2170660915,35489,36895,2024-10-04 19:19:09,0,0,0,0,0,0
3,201392388,2170660915,0,0,2024-10-04 19:19:09,128,84,212,1,1,2
3,201392388,2170660915,35489,36895,2024-10-04 19:19:10,0,0,0,0,0,0
3,201392388,2170660915,0,0,2024-10-04 19:19:10,128,84,212,1,1,2
3,201392388,2170660915,35489,36895,2024-10-04 19:19:11,0,0,0,0,0,0
3,201392388,1145490690,18086,47873,2024-10-04 19:19:11,3163,34801,37964,23,32,55
3,201392388,2170660915,0,0,2024-10-04 19:19:11,128,84,212,1,1,2
3,201392388,2170660915,35489,36895,2024-10-04 19:19:12,0,0,0,0,0,0
3,201392388,1145490690,18086,47873,2024-10-04 19:19:12,2424,45670,48094,24,30,54
3,201392388,2170660915,0,0,2024-10-04 19:19:12,0,0,0,0,0,0
3,201392388,2170660915,35489,36895,2024-10-04 19:19:13,0,0,0,0,0,0
3,201392388,1145490690,18086,47873,2024-10-04 19:19:13,0,0,0,0,0,0
3,201392388,2170660915,0,0,2024-10-04 19:19:13,0,0,0,0,0,0
3,201392388,1145490690,18086,47873,2024-10-04 19:19:14,1524,22911,24435,15,18,33
3,201392388,2170660915,0,0,2024-10-04 19:19:14,0,0,0,0,0,0
3,201392388,1145490690,18086,47873,2024-10-04 19:19:15,0,0,0,0,0,0
3,201392388,2170660915,0,0,2024-10-04 19:19:15,0,0,0,0,0,0
3,201392388,1145490690,18086,47873,2024-10-04 19:19:16,0,0,0,0,0,0
3,201392388,2170660915,0,0,2024-10-04 19:19:16,0,0,0,0,0,0
3,201392388,1145490690,18086,47873,2024-10-04 19:19:17,0,0,0,0,0,0
3,201392388,2170660915,0,0,2024-10-04 19:19:17,0,0,0,0,0,0
3,201392388,1145490690,18086,47873,2024-10-04 19:19:18,0,0,0,0,0,0
3,201392388,2170660915,0,0,2024-10-04 19:19:18,0,0,0,0,0,0
3,201392388,1145490690,18086,47873,2024-10-04 19:19:19,0,0,0,0,0,0
3,201392388,2170660915,0,0,2024-10-04 19:19:19,0,0,0,0,0,0
3,201392388,1145490690,18086,47873,2024-10-04 19:19:20,0,0,0,0,0,0
3,201392388,2170660915,0,0,2024-10-04 19:19:20,0,0,0,0,0,0
3,201392388,1145490690,18086,47873,2024-10-04 19:19:21,0,0,0,0,0,0
3,201392388,2170660915,0,0,2024-10-04 19:19:21,0,0,0,0,0,0
3,201392388,1145490690,18086,47873,2024-10-04 19:19:22,0,0,0,0,0,0
3,201392388,2170660915,0,0,2024-10-04 19:19:22,0,0,0,0,0,0
3,201392388,2170660915,0,0,2024-10-04 19:19:23,128,84,212,1,1,2
3,201392388,2170660915,0,0,2024-10-04 19:19:24,0,0,0,0,0,0
3,201392388,2170660915,0,0,2024-10-04 19:19:25,128,84,212,1,1,2
3,201392388,2170660915,0,0,2024-10-04 19:19:26,128,84,212,1,1,2
3,201392388,2170660915,0,0,2024-10-04 19:19:27,128,84,212,1,1,2
3,201392388,2170660915,0,0,2024-10-04 19:19:28,128,84,212,1,1,2
3,201392388,2170660915,0,0,2024-10-04 19:19:29,128,84,212,1,1,2
3,201392388,2170660915,0,0,2024-10-04 19:19:30,128,84,212,1,1,2
3,201392388,2170660915,0,0,2024-10-04 19:19:31,128,84,212,1,1,2
3,201392388,2170660915,0,0,2024-10-04 19:19:32,256,168,424,2,2,4
3,201392388,2170660915,0,0,2024-10-04 19:19:33,0,0,0,0,0,0
3,201392388,2170660915,0,0,2024-10-04 19:19:34,0,0,0,0,0,0
3,201392388,2170660915,17133,36895,2024-10-04 19:19:35,570,455,1025,5,5,10
3,201392388,2170660915,0,0,2024-10-04 19:19:35,0,0,0,0,0,0
3,201392388,2170660915,17133,36895,2024-10-04 19:19:36,0,0,0,0,0,0
3,201392388,2170660915,0,0,2024-10-04 19:19:36,128,84,212,1,1,2
3,201392388,2170660915,17133,36895,2024-10-04 19:19:37,0,0,0,0,0,0
3,201392388,2170660915,0,0,2024-10-04 19:19:37,256,84,340,2,1,3
3,201392388,2170660915,17133,36895,2024-10-04 19:19:38,0,0,0,0,0,0
3,201392388,2170660915,0,0,2024-10-04 19:19:38,0,0,0,0,0,0
3,201392388,2170660915,17133,36895,2024-10-04 19:19:39,0,0,0,0,0,0
3,201392388,2170660915,0,0,2024-10-04 19:19:39,0,84,84,0,1,1
3,201392388,2170660915,17133,36895,2024-10-04 19:19:40,0,0,0,0,0,0
3,201392388,2170660915,0,0,2024-10-04 19:19:40,0,0,0,0,0,0
3,201392388,2170660915,17133,36895,2024-10-04 19:19:41,0,0,0,0,0,0
3,201392388,2170660915,0,0,2024-10-04 19:19:41,128,84,212,1,1,2
3,201392388,2170660915,17133,36895,2024-10-04 19:19:42,0,0,0,0,0,0
3,201392388,2170660915,0,0,2024-10-04 19:19:42,128,84,212,1,1,2
3,201392388,1145490689,43664,47873,2024-10-04 19:19:43,3184,40839,44023,23,34,57
3,201392388,2170660915,17133,36895,2024-10-04 19:19:43,0,0,0,0,0,0
3,201392388,2170660915,0,0,2024-10-04 19:19:43,128,84,212,1,1,2
3,201392388,1145490689,43664,47873,2024-10-04 19:19:44,0,0,0,0,0,0
3,201392388,2170660915,17133,36895,2024-10-04 19:19:44,0,0,0,0,0,0
3,201392388,2170660915,0,0,2024-10-04 19:19:44,0,0,0,0,0,0
3,201392388,1145490689,43664,47873,2024-10-04 19:19:45,0,0,0,0,0,0
3,201392388,2170660915,17133,36895,2024-10-04 19:19:45,0,0,0,0,0,0
3,201392388,2170660915,0,0,2024-10-04 19:19:45,0,0,0,0,0,0
3,201392388,1145490689,43664,47873,2024-10-04 19:19:46,0,0,0,0,0,0
3,201392388,2170660915,17133,36895,2024-10-04 19:19:46,0,0,0,0,0,0
3,201392388,2170660915,0,0,2024-10-04 19:19:46,0,0,0,0,0,0
3,201392388,1145490689,43664,47873,2024-10-04 19:19:47,0,0,0,0,0,0
3,201392388,2170660915,17133,36895,2024-10-04 19:19:47,0,0,0,0,0,0
3,201392388,2170660915,0,0,2024-10-04 19:19:47,0,0,0,0,0,0
3,201392388,1145490689,43664,47873,2024-10-04 19:19:48,0,0,0,0,0,0
3,201392388,2170660915,17133,36895,2024-10-04 19:19:48,0,0,0,0,0,0
3,201392388,2170660915,0,0,2024-10-04 19:19:48,0,0,0,0,0,0
3,201392388,1145490689,43664,47873,2024-10-04 19:19:49,0,0,0,0,0,0
3,201392388,2170660915,17133,36895,2024-10-04 19:19:49,0,0,0,0,0,0
3,201392388,2170660915,0,0,2024-10-04 19:19:49,0,0,0,0,0,0
3,201392388,1145490689,43664,47873,2024-10-04 19:19:50,0,0,0,0,0,0
3,201392388,2170660915,17133,36895,2024-10-04 19:19:50,0,0,0,0,0,0
3,201392388,2170660915,0,0,2024-10-04 19:19:50,0,0,0,0,0,0
3,201392388,1145490689,43664,47873,2024-10-04 19:19:51,0,0,0,0,0,0
3,201392388,2170660915,17133,36895,2024-10-04 19:19:51,0,0,0,0,0,0
3,201392388,2170660915,0,0,2024-10-04 19:19:51,0,0,0,0,0,0
3,201392388,1145490689,43664,47873,2024-10-04 19:19:52,3156,62427,65583,31,44,75
3,201392388,2170660915,17133,36895,2024-10-04 19:19:52,0,0,0,0,0,0
3,201392388,2170660915,0,0,2024-10-04 19:19:52,0,0,0,0,0,0
3,201392388,1145490689,43664,47873,2024-10-04 19:19:53,0,0,0,0,0,0
3,201392388,2170660915,17133,36895,2024-10-04 19:19:53,0,0,0,0,0,0
3,201392388,2170660915,0,0,2024-10-04 19:19:53,0,0,0,0,0,0
3,201392388,1145490689,43664,47873,2024-10-04 19:19:54,0,0,0,0,0,0
3,201392388,2170660915,17133,36895,2024-10-04 19:19:54,0,0,0,0,0,0
3,201392388,2170660915,0,0,2024-10-04 19:19:54,128,84,212,1,1,2
3,201392388,1145490689,43664,47873,2024-10-04 19:19:55,0,0,0,0,0,0
3,201392388,2170660915,17133,36895,2024-10-04 19:19:55,0,0,0,0,0,0
3,201392388,2170660915,0,0,2024-10-04 19:19:55,128,84,212,1,1,2
3,201392388,1145490689,43664,47873,2024-10-04 19:19:56,0,0,0,0,0,0
3,201392388,2170660915,17133,36895,2024-10-04 19:19:56,0,0,0,0,0,0
3,201392388,2170660915,0,0,2024-10-04 19:19:56,128,84,212,1,1,2
3,201392388,1145490689,43664,47873,2024-10-04 19:19:57,0,0,0,0,0,0
3,201392388,2170660915,17133,36895,2024-10-04 19:19:57,0,0,0,0,0,0
3,201392388,2170660915,0,0,2024-10-04 19:19:57,128,84,212,1,1,2
3,201392388,1145490689,43664,47873,2024-10-04 19:19:58,0,0,0,0,0,0
3,201392388,2170660915,17133,36895,2024-10-04 19:19:58,0,0,0,0,0,0
3,201392388,2170660915,0,0,2024-10-04 19:19:58,128,84,212,1,1,2
3,201392388,1145490689,43664,47873,2024-10-04 19:19:59,0,0,0,0,0,0
3,201392388,2170660915,17133,36895,2024-10-04 19:19:59,0,0,0,0,0,0
3,201392388,2170660915,0,0,2024-10-04 19:19:59,128,84,212,1,1,2
3,201392388,1145490689,43664,47873,2024-10-04 19:20:00,0,0,0,0,0,0
3,201392388,2170660915,17133,36895,2024-10-04 19:20:00,0,0,0,0,0,0
3,201392388,2170660915,0,0,2024-10-04 19:20:00,128,84,212,1,1,2
3,201392388,1145490689,43664,47873,2024-10-04 19:20:01,0,0,0,0,0,0
3,201392388,2170660915,17133,36895,2024-10-04 19:20:01,0,0,0,0,0,0
3,201392388,2170660915,0,0,2024-10-04 19:20:01,128,84,212,1,1,2
3,201392388,1145490689,43664,47873,2024-10-04 19:20:02,0,0,0,0,0,0
3,201392388,2170660915,17133,36895,2024-10-04 19:20:02,0,0,0,0,0,0
3,201392388,2170660915,0,0,2024-10-04 19:20:02,128,84,212,1,1,2
3,201392388,2170660915,17133,36895,2024-10-04 19:20:03,0,0,0,0,0,0
3,201392388,2170660915,0,0,2024-10-04 19:20:03,128,84,212,1,1,2
3,201392388,2170660915,0,0,2024-10-04 19:20:04,0,0,0,0,0,0
3,201392388,2170660915,29885,36895,2024-10-04 19:20:05,666,507,1173,6,6,12
3,201392388,2170660915,0,0,2024-10-04 19:20:05,0,0,0,0,0,0
3,201392388,2170660915,29885,36895,2024-10-04 19:20:06,0,0,0,0,0,0
3,201392388,2170660915,0,0,2024-10-04 19:20:06,128,84,212,1,1,2
3,201392388,2170660915,29885,36895,2024-10-04 19:20:07,0,0,0,0,0,0
3,201392388,2170660915,0,0,2024-10-04 19:20:07,128,84,212,1,1,2
3,201392388,2170660915,29885,36895,2024-10-04 19:20:08,0,0,0,0,0,0
3,201392388,2170660915,0,0,2024-10-04 19:20:08,0,0,0,0,0,0
3,201392388,2170660915,29885,36895,2024-10-04 19:20:09,0,0,0,0,0,0
3,201392388,2170660915,0,0,2024-10-04 19:20:09,0,0,0,0,0,0
3,201392388,2170660915,29885,36895,2024-10-04 19:20:10,0,0,0,0,0,0
3,201392388,2170660915,0,0,2024-10-04 19:20:10,128,84,212,1,1,2
3,201392388,2170660915,29885,36895,2024-10-04 19:20:11,0,0,0,0,0,0
3,201392388,2170660915,0,0,2024-10-04 19:20:11,128,84,212,1,1,2
3,201392388,2170660915,29885,36895,2024-10-04 19:20:12,0,0,0,0,0,0
3,201392388,2170660915,0,0,2024-10-04 19:20:12,128,0,128,1,0,1
3,201392388,2170660915,29885,36895,2024-10-04 19:20:13,0,0,0,0,0,0
3,201392388,2170660915,0,0,2024-10-04 19:20:13,0,84,84,0,1,1
3,201392388,2170660915,29885,36895,2024-10-04 19:20:14,0,0,0,0,0,0
3,201392388,1145490691,14557,47873,2024-10-04 19:20:14,6272,91062,97334,53,72,125
3,201392388,2170660915,0,0,2024-10-04 19:20:14,128,84,212,1,1,2
3,201392388,2170660915,29885,36895,2024-10-04 19:20:15,0,0,0,0,0,0
3,201392388,1145490691,14557,47873,2024-10-04 19:20:15,0,0,0,0,0,0
3,201392388,2170660915,0,0,2024-10-04 19:20:15,0,0,0,0,0,0
3,201392388,2170660915,29885,36895,2024-10-04 19:20:16,0,0,0,0,0,0
3,201392388,1145490691,14557,47873,2024-10-04 19:20:16,0,0,0,0,0,0
3,201392388,2170660915,0,0,2024-10-04 19:20:16,0,0,0,0,0,0
3,201392388,2170660915,29885,36895,2024-10-04 19:20:17,0,0,0,0,0,0
3,201392388,1145490691,14557,47873,2024-10-04 19:20:17,0,0,0,0,0,0
3,201392388,2170660915,0,0,2024-10-04 19:20:17,0,0,0,0,0,0
3,201392388,2170660915,29885,36895,2024-10-04 19:20:18,0,0,0,0,0,0
3,201392388,1145490691,14557,47873,2024-10-04 19:20:18,0,0,0,0,0,0
3,201392388,2170660915,0,0,2024-10-04 19:20:18,0,0,0,0,0,0
3,201392388,2170660915,29885,36895,2024-10-04 19:20:19,0,0,0,0,0,0
3,201392388,1145490691,14557,47873,2024-10-04 19:20:19,0,0,0,0,0,0
3,201392388,2170660915,0,0,2024-10-04 19:20:19,0,0,0,0,0,0
3,201392388,2170660915,29885,36895,2024-10-04 19:20:20,0,0,0,0,0,0
3,201392388,1145490691,14557,47873,2024-10-04 19:20:20,0,0,0,0,0,0
3,201392388,2170660915,0,0,2024-10-04 19:20:20,0,0,0,0,0,0
3,201392388,2170660915,29885,36895,2024-10-04 19:20:21,0,0,0,0,0,0
3,201392388,1145490691,14557,47873,2024-10-04 19:20:21,0,0,0,0,0,0
3,201392388,2170660915,0,0,2024-10-04 19:20:21,0,0,0,0,0,0
3,201392388,2170660915,29885,36895,2024-10-04 19:20:22,0,0,0,0,0,0
3,201392388,1145490691,14557,47873,2024-10-04 19:20:22,0,0,0,0,0,0
3,201392388,2170660915,0,0,2024-10-04 19:20:22,0,0,0,0,0,0
3,201392388,2170660915,29885,36895,2024-10-04 19:20:23,0,0,0,0,0,0
3,201392388,1145490691,14557,47873,2024-10-04 19:20:23,0,0,0,0,0,0
3,201392388,2170660915,0,0,2024-10-04 19:20:23,128,0,128,1,0,1
3,201392388,2170660915,29885,36895,2024-10-04 19:20:24,0,0,0,0,0,0
3,201392388,1145490691,14557,47873,2024-10-04 19:20:24,0,0,0,0,0,0
3,201392388,2170660915,0,0,2024-10-04 19:20:24,128,84,212,1,1,2
3,201392388,2170660915,29885,36895,2024-10-04 19:20:25,0,0,0,0,0,0
3,201392388,1145490691,14557,47873,2024-10-04 19:20:25,0,0,0,0,0,0
3,201392388,2170660915,0,0,2024-10-04 19:20:25,128,84,212,1,1,2
3,201392388,2170660915,29885,36895,2024-10-04 19:20:26,0,0,0,0,0,0
3,201392388,1145490691,14557,47873,2024-10-04 19:20:26,0,0,0,0,0,0
3,201392388,2170660915,0,0,2024-10-04 19:20:26,128,84,212,1,1,2
3,201392388,2170660915,29885,36895,2024-10-04 19:20:27,0,0,0,0,0,0
3,201392388,1145490691,14557,47873,2024-10-04 19:20:27,0,0,0,0,0,0
3,201392388,2170660915,0,0,2024-10-04 19:20:27,128,84,212,1,1,2
3,201392388,2170660915,29885,36895,2024-10-04 19:20:28,0,0,0,0,0,0
3,201392388,1145490691,14557,47873,2024-10-04 19:20:28,0,0,0,0,0,0
3,201392388,2170660915,0,0,2024-10-04 19:20:28,128,84,212,1,1,2
3,201392388,2170660915,29885,36895,2024-10-04 19:20:29,0,0,0,0,0,0
3,201392388,1145490691,14557,47873,2024-10-04 19:20:29,0,0,0,0,0,0
3,201392388,2170660915,0,0,2024-10-04 19:20:29,128,84,212,1,1,2
3,201392388,2170660915,29885,36895,2024-10-04 19:20:30,0,0,0,0,0,0
3,201392388,1145490691,14557,47873,2024-10-04 19:20:30,0,0,0,0,0,0
3,201392388,2170660915,0,0,2024-10-04 19:20:30,128,84,212,1,1,2
3,201392388,2170660915,29885,36895,2024-10-04 19:20:31,0,0,0,0,0,0
3,201392388,1145490691,14557,47873,2024-10-04 19:20:31,0,0,0,0,0,0
3,201392388,2170660915,0,0,2024-10-04 19:20:31,128,84,212,1,1,2
3,201392388,2170660915,29885,36895,2024-10-04 19:20:32,0,0,0,0,0,0
3,201392388,1145490691,14557,47873,2024-10-04 19:20:32,0,0,0,0,0,0
3,201392388,2170660915,0,0,2024-10-04 19:20:32,128,84,212,1,1,2
3,201392388,2170660915,29885,36895,2024-10-04 19:20:33,0,0,0,0,0,0
3,201392388,1145490691,14557,47873,2024-10-04 19:20:33,0,0,0,0,0,0
3,201392388,2170660915,0,0,2024-10-04 19:20:33,0,84,84,0,1,1
3,201392388,2170660915,29885,36895,2024-10-04 19:20:34,0,0,0,0,0,0
3,201392388,2170660915,18049,36895,2024-10-04 19:20:34,666,507,1173,6,6,12
3,201392388,1145490691,14557,47873,2024-10-04 19:20:34,0,0,0,0,0,0
3,201392388,2170660915,0,0,2024-10-04 19:20:34,0,0,0,0,0,0
3,201392388,2170660915,18049,36895,2024-10-04 19:20:35,0,0,0,0,0,0
3,201392388,2170660915,0,0,2024-10-04 19:20:35,128,84,212,1,1,2
3,201392388,2170660915,18049,36895,2024-10-04 19:20:36,0,0,0,0,0,0
3,201392388,2170660915,0,0,2024-10-04 19:20:36,128,84,212,1,1,2
3,201392388,2170660915,18049,36895,2024-10-04 19:20:37,0,0,0,0,0,0
3,201392388,2170660915,0,0,2024-10-04 19:20:37,128,84,212,1,1,2
3,201392388,2170660915,18049,36895,2024-10-04 19:20:38,0,0,0,0,0,0
3,201392388,2170660915,0,0,2024-10-04 19:20:38,0,0,0,0,0,0
3,201392388,2170660915,18049,36895,2024-10-04 19:20:39,0,0,0,0,0,0
3,201392388,2170660915,0,0,2024-10-04 19:20:39,0,0,0,0,0,0
3,201392388,2170660915,18049,36895,2024-10-04 19:20:40,0,0,0,0,0,0
3,201392388,2170660915,0,0,2024-10-04 19:20:40,128,0,128,1,0,1
3,201392388,2170660915,18049,36895,2024-10-04 19:20:41,0,0,0,0,0,0
3,201392388,2170660915,0,0,2024-10-04 19:20:41,0,84,84,0,1,1
3,201392388,2170660915,18049,36895,2024-10-04 19:20:42,0,0,0,0,0,0
3,201392388,2170660915,0,0,2024-10-04 19:20:42,128,84,212,1,1,2
3,201392388,1145490692,52923,47873,2024-10-04 19:20:43,6444,91062,97506,54,72,126
3,201392388,2170660915,18049,36895,2024-10-04 19:20:43,0,0,0,0,0,0
3,201392388,2170660915,0,0,2024-10-04 19:20:43,128,84,212,1,1,2
3,201392388,1145490692,52923,47873,2024-10-04 19:20:44,0,0,0,0,0,0
3,201392388,2170660915,18049,36895,2024-10-04 19:20:44,0,0,0,0,0,0
3,201392388,2170660915,0,0,2024-10-04 19:20:44,0,0,0,0,0,0
3,201392388,1145490692,52923,47873,2024-10-04 19:20:45,0,0,0,0,0,0
3,201392388,2170660915,18049,36895,2024-10-04 19:20:45,0,0,0,0,0,0
3,201392388,2170660915,0,0,2024-10-04 19:20:45,0,0,0,0,0,0
3,201392388,1145490692,52923,47873,2024-10-04 19:20:46,0,0,0,0,0,0
3,201392388,2170660915,18049,36895,2024-10-04 19:20:46,0,0,0,0,0,0
3,201392388,2170660915,0,0,2024-10-04 19:20:46,0,0,0,0,0,0
3,201392388,1145490692,52923,47873,2024-10-04 19:20:47,0,0,0,0,0,0
3,201392388,2170660915,18049,36895,2024-10-04 19:20:47,0,0,0,0,0,0
3,201392388,2170660915,0,0,2024-10-04 19:20:47,0,0,0,0,0,0
3,201392388,1145490692,52923,47873,2024-10-04 19:20:48,0,0,0,0,0,0
3,201392388,2170660915,18049,36895,2024-10-04 19:20:48,0,0,0,0,0,0
3,201392388,2170660915,0,0,2024-10-04 19:20:48,0,0,0,0,0,0
3,201392388,1145490692,52923,47873,2024-10-04 19:20:49,0,0,0,0,0,0
3,201392388,2170660915,18049,36895,2024-10-04 19:20:49,0,0,0,0,0,0
3,201392388,2170660915,0,0,2024-10-04 19:20:49,0,0,0,0,0,0
3,201392388,1145490692,52923,47873,2024-10-04 19:20:50,0,0,0,0,0,0
3,201392388,2170660915,18049,36895,2024-10-04 19:20:50,0,0,0,0,0,0
3,201392388,2170660915,0,0,2024-10-04 19:20:50,0,0,0,0,0,0
3,201392388,1145490692,52923,47873,2024-10-04 19:20:51,0,0,0,0,0,0
3,201392388,2170660915,18049,36895,2024-10-04 19:20:51,0,0,0,0,0,0
3,201392388,2170660915,0,0,2024-10-04 19:20:51,0,0,0,0,0,0
3,201392388,1145490692,52923,47873,2024-10-04 19:20:52,0,0,0,0,0,0
3,201392388,2170660915,18049,36895,2024-10-04 19:20:52,0,0,0,0,0,0
3,201392388,2170660915,0,0,2024-10-04 19:20:52,0,0,0,0,0,0
3,201392388,1145490692,52923,47873,2024-10-04 19:20:53,0,0,0,0,0,0
3,201392388,2170660915,18049,36895,2024-10-04 19:20:53,0,0,0,0,0,0
3,201392388,2170660915,0,0,2024-10-04 19:20:53,128,0,128,1,0,1
3,201392388,1145490692,52923,47873,2024-10-04 19:20:54,0,0,0,0,0,0
3,201392388,2170660915,18049,36895,2024-10-04 19:20:54,0,0,0,0,0,0
3,201392388,2170660915,0,0,2024-10-04 19:20:54,128,168,296,1,2,3
3,201392388,1145490692,52923,47873,2024-10-04 19:20:55,0,0,0,0,0,0
3,201392388,2170660915,18049,36895,2024-10-04 19:20:55,0,0,0,0,0,0
3,201392388,2170660915,0,0,2024-10-04 19:20:55,128,84,212,1,1,2
3,201392388,1145490692,52923,47873,2024-10-04 19:20:56,0,0,0,0,0,0
3,201392388,2170660915,18049,36895,2024-10-04 19:20:56,0,0,0,0,0,0
3,201392388,2170660915,0,0,2024-10-04 19:20:56,128,84,212,1,1,2
3,201392388,1145490692,52923,47873,2024-10-04 19:20:57,0,0,0,0,0,0
3,201392388,2170660915,18049,36895,2024-10-04 19:20:57,0,0,0,0,0,0
3,201392388,2170660915,0,0,2024-10-04 19:20:57,128,84,212,1,1,2
3,201392388,1145490692,52923,47873,2024-10-04 19:20:58,0,0,0,0,0,0
3,201392388,2170660915,18049,36895,2024-10-04 19:20:58,0,0,0,0,0,0
3,201392388,2170660915,0,0,2024-10-04 19:20:58,128,84,212,1,1,2
3,201392388,1145490692,52923,47873,2024-10-04 19:20:59,0,0,0,0,0,0
3,201392388,2170660915,18049,36895,2024-10-04 19:20:59,0,0,0,0,0,0
3,201392388,2170660915,0,0,2024-10-04 19:20:59,128,84,212,1,1,2
3,201392388,1145490692,52923,47873,2024-10-04 19:21:00,0,0,0,0,0,0
3,201392388,2170660915,18049,36895,2024-10-04 19:21:00,0,0,0,0,0,0
3,201392388,2170660915,0,0,2024-10-04 19:21:00,128,84,212,1,1,2
3,201392388,1145490692,52923,47873,2024-10-04 19:21:01,0,0,0,0,0,0
3,201392388,2170660915,18049,36895,2024-10-04 19:21:01,0,0,0,0,0,0
3,201392388,2170660915,0,0,2024-10-04 19:21:01,128,84,212,1,1,2
3,201392388,1145490692,52923,47873,2024-10-04 19:21:02,0,0,0,0,0,0
3,201392388,2170660915,18049,36895,2024-10-04 19:21:02,0,0,0,0,0,0
3,201392388,2170660915,0,0,2024-10-04 19:21:02,128,84,212,1,1,2
3,201392388,1145490692,52923,47873,2024-10-04 19:21:03,0,0,0,0,0,0
3,201392388,2170660915,18049,36895,2024-10-04 19:21:03,0,0,0,0,0,0
3,201392388,2170660915,0,0,2024-10-04 19:21:03,0,0,0,0,0,0
3,201392388,1145490692,52923,47873,2024-10-04 19:21:04,0,0,0,0,0,0
3,201392388,2170660915,18049,36895,2024-10-04 19:21:04,0,0,0,0,0,0
3,201392388,2170660915,0,0,2024-10-04 19:21:04,0,0,0,0,0,0
3,201392388,2170660915,26794,36895,2024-10-04 19:21:04,666,507,1173,6,6,12
3,201392388,1145490692,52923,47873,2024-10-04 19:21:05,0,0,0,0,0,0
3,201392388,2170660915,18049,36895,2024-10-04 19:21:05,0,0,0,0,0,0
3,201392388,2170660915,0,0,2024-10-04 19:21:05,0,0,0,0,0,0
3,201392388,2170660915,26794,36895,2024-10-04 19:21:05,0,0,0,0,0,0
3,201392388,2170660915,18049,36895,2024-10-04 19:21:06,0,0,0,0,0,0
3,201392388,2170660915,0,0,2024-10-04 19:21:06,128,84,212,1,1,2
3,201392388,2170660915,26794,36895,2024-10-04 19:21:06,0,0,0,0,0,0
3,201392388,2170660915,18049,36895,2024-10-04 19:21:07,0,0,0,0,0,0
3,201392388,2170660915,0,0,2024-10-04 19:21:07,128,84,212,1,1,2
3,201392388,2170660915,26794,36895,2024-10-04 19:21:07,0,0,0,0,0,0
3,201392388,2170660915,18049,36895,2024-10-04 19:21:08,0,0,0,0,0,0
3,201392388,2170660915,0,0,2024-10-04 19:21:08,128,84,212,1,1,2
3,201392388,2170660915,26794,36895,2024-10-04 19:21:08,0,0,0,0,0,0
3,201392388,2170660915,18049,36895,2024-10-04 19:21:09,0,0,0,0,0,0
3,201392388,2170660915,0,0,2024-10-04 19:21:09,0,0,0,0,0,0
3,201392388,2170660915,26794,36895,2024-10-04 19:21:09,0,0,0,0,0,0
3,201392388,2170660915,18049,36895,2024-10-04 19:21:10,0,0,0,0,0,0
3,201392388,2170660915,0,0,2024-10-04 19:21:10,128,0,128,1,0,1
3,201392388,2170660915,26794,36895,2024-10-04 19:21:10,0,0,0,0,0,0
3,201392388,2170660915,18049,36895,2024-10-04 19:21:11,0,0,0,0,0,0
3,201392388,2170660915,0,0,2024-10-04 19:21:11,0,84,84,0,1,1
3,201392388,2170660915,26794,36895,2024-10-04 19:21:11,0,0,0,0,0,0
3,201392388,2170660915,18049,36895,2024-10-04 19:21:12,0,0,0,0,0,0
3,201392388,2170660915,0,0,2024-10-04 19:21:12,128,84,212,1,1,2
3,201392388,2170660915,26794,36895,2024-10-04 19:21:12,0,0,0,0,0,0
3,201392388,2170660915,18049,36895,2024-10-04 19:21:13,0,0,0,0,0,0
3,201392388,2170660915,0,0,2024-10-04 19:21:13,128,84,212,1,1,2
3,201392388,1145490691,63721,47873,2024-10-04 19:21:13,3564,45979,49543,27,39,66
3,201392388,2170660915,26794,36895,2024-10-04 19:21:13,0,0,0,0,0,0
3,201392388,2170660915,18049,36895,2024-10-04 19:21:14,0,0,0,0,0,0
3,201392388,2170660915,0,0,2024-10-04 19:21:14,0,0,0,0,0,0
3,201392388,1145490691,63721,47873,2024-10-04 19:21:14,3336,55275,58611,33,38,71
3,201392388,2170660915,26794,36895,2024-10-04 19:21:14,0,0,0,0,0,0
3,201392388,2170660915,18049,36895,2024-10-04 19:21:15,0,0,0,0,0,0
3,201392388,2170660915,0,0,2024-10-04 19:21:15,0,0,0,0,0,0
3,201392388,1145490691,63721,47873,2024-10-04 19:21:15,0,0,0,0,0,0
3,201392388,2170660915,26794,36895,2024-10-04 19:21:15,0,0,0,0,0,0
3,201392388,2170660915,18049,36895,2024-10-04 19:21:16,0,0,0,0,0,0
3,201392388,2170660915,0,0,2024-10-04 19:21:16,0,0,0,0,0,0
3,201392388,1145490691,63721,47873,2024-10-04 19:21:16,0,0,0,0,0,0
3,201392388,2170660915,26794,36895,2024-10-04 19:21:16,0,0,0,0,0,0
3,201392388,2170660915,18049,36895,2024-10-04 19:21:17,0,0,0,0,0,0
3,201392388,2170660915,0,0,2024-10-04 19:21:17,0,0,0,0,0,0
3,201392388,1145490691,63721,47873,2024-10-04 19:21:17,0,0,0,0,0,0
3,201392388,2170660915,26794,36895,2024-10-04 19:21:17,0,0,0,0,0,0
3,201392388,2170660915,18049,36895,2024-10-04 19:21:18,0,0,0,0,0,0
3,201392388,2170660915,0,0,2024-10-04 19:21:18,0,0,0,0,0,0
3,201392388,1145490691,63721,47873,2024-10-04 19:21:18,0,0,0,0,0,0
3,201392388,2170660915,26794,36895,2024-10-04 19:21:18,0,0,0,0,0,0
3,201392388,2170660915,18049,36895,2024-10-04 19:21:19,0,0,0,0,0,0
3,201392388,2170660915,0,0,2024-10-04 19:21:19,0,0,0,0,0,0
3,201392388,1145490691,63721,47873,2024-10-04 19:21:19,0,0,0,0,0,0
3,201392388,2170660915,26794,36895,2024-10-04 19:21:19,0,0,0,0,0,0
3,201392388,2170660915,18049,36895,2024-10-04 19:21:20,0,0,0,0,0,0
3,201392388,2170660915,0,0,2024-10-04 19:21:20,0,0,0,0,0,0
3,201392388,1145490691,63721,47873,2024-10-04 19:21:20,0,0,0,0,0,0
3,201392388,2170660915,26794,36895,2024-10-04 19:21:20,0,0,0,0,0,0
3,201392388,2170660915,18049,36895,2024-10-04 19:21:21,0,0,0,0,0,0
3,201392388,2170660915,0,0,2024-10-04 19:21:21,0,0,0,0,0,0
3,201392388,1145490691,63721,47873,2024-10-04 19:21:21,0,0,0,0,0,0
3,201392388,2170660915,26794,36895,2024-10-04 19:21:21,0,0,0,0,0,0
3,201392388,2170660915,18049,36895,2024-10-04 19:21:22,0,0,0,0,0,0
3,201392388,2170660915,0,0,2024-10-04 19:21:22,0,0,0,0,0,0
3,201392388,1145490691,63721,47873,2024-10-04 19:21:22,0,0,0,0,0,0
3,201392388,2170660915,26794,36895,2024-10-04 19:21:22,0,0,0,0,0,0
3,201392388,2170660915,18049,36895,2024-10-04 19:21:23,0,0,0,0,0,0
3,201392388,2170660915,0,0,2024-10-04 19:21:23,0,0,0,0,0,0
3,201392388,1145490691,63721,47873,2024-10-04 19:21:23,0,0,0,0,0,0
3,201392388,2170660915,26794,36895,2024-10-04 19:21:23,0,0,0,0,0,0
3,201392388,2170660915,18049,36895,2024-10-04 19:21:24,0,0,0,0,0,0
3,201392388,2170660915,0,0,2024-10-04 19:21:24,128,84,212,1,1,2
3,201392388,1145490691,63721,47873,2024-10-04 19:21:24,0,0,0,0,0,0
3,201392388,2170660915,26794,36895,2024-10-04 19:21:24,0,0,0,0,0,0
3,201392388,2170660915,18049,36895,2024-10-04 19:21:25,0,0,0,0,0,0
3,201392388,2170660915,0,0,2024-10-04 19:21:25,128,84,212,1,1,2
3,201392388,1145490691,63721,47873,2024-10-04 19:21:25,0,0,0,0,0,0
3,201392388,2170660915,26794,36895,2024-10-04 19:21:25,0,0,0,0,0,0
3,201392388,2170660915,18049,36895,2024-10-04 19:21:26,0,0,0,0,0,0
3,201392388,2170660915,0,0,2024-10-04 19:21:26,128,84,212,1,1,2
3,201392388,1145490691,63721,47873,2024-10-04 19:21:26,0,0,0,0,0,0
3,201392388,2170660915,26794,36895,2024-10-04 19:21:26,0,0,0,0,0,0
3,201392388,2170660915,18049,36895,2024-10-04 19:21:27,0,0,0,0,0,0
3,201392388,2170660915,0,0,2024-10-04 19:21:27,128,84,212,1,1,2
3,201392388,1145490691,63721,47873,2024-10-04 19:21:27,0,0,0,0,0,0
3,201392388,2170660915,26794,36895,2024-10-04 19:21:27,0,0,0,0,0,0
3,201392388,2170660915,18049,36895,2024-10-04 19:21:28,0,0,0,0,0,0
3,201392388,2170660915,0,0,2024-10-04 19:21:28,128,84,212,1,1,2
3,201392388,1145490691,63721,47873,2024-10-04 19:21:28,0,0,0,0,0,0
3,201392388,2170660915,26794,36895,2024-10-04 19:21:28,0,0,0,0,0,0
3,201392388,2170660915,18049,36895,2024-10-04 19:21:29,0,0,0,0,0,0
3,201392388,2170660915,0,0,2024-10-04 19:21:29,128,84,212,1,1,2
3,201392388,1145490691,63721,47873,2024-10-04 19:21:29,0,0,0,0,0,0
3,201392388,2170660915,26794,36895,2024-10-04 19:21:29,0,0,0,0,0,0
3,201392388,2170660915,18049,36895,2024-10-04 19:21:30,0,0,0,0,0,0
3,201392388,2170660915,0,0,2024-10-04 19:21:30,128,84,212,1,1,2
3,201392388,1145490691,63721,47873,2024-10-04 19:21:30,0,0,0,0,0,0
3,201392388,2170660915,26794,36895,2024-10-04 19:21:30,0,0,0,0,0,0
3,201392388,2170660915,18049,36895,2024-10-04 19:21:31,0,0,0,0,0,0
3,201392388,2170660915,0,0,2024-10-04 19:21:31,128,84,212,1,1,2
3,201392388,1145490691,63721,47873,2024-10-04 19:21:31,0,0,0,0,0,0
3,201392388,2170660915,26794,36895,2024-10-04 19:21:31,0,0,0,0,0,0
3,201392388,2170660915,18049,36895,2024-10-04 19:21:32,0,0,0,0,0,0
3,201392388,2170660915,0,0,2024-10-04 19:21:32,128,0,128,1,0,1
3,201392388,1145490691,63721,47873,2024-10-04 19:21:32,0,0,0,0,0,0
3,201392388,2170660915,26794,36895,2024-10-04 19:21:32,0,0,0,0,0,0
3,201392388,2170660915,18049,36895,2024-10-04 19:21:33,0,0,0,0,0,0
3,201392388,2170660915,0,0,2024-10-04 19:21:33,128,84,212,1,1,2
3,201392388,1145490691,63721,47873,2024-10-04 19:21:33,0,0,0,0,0,0
3,201392388,2170660915,26794,36895,2024-10-04 19:21:33,0,0,0,0,0,0
3,201392388,2170660915,18049,36895,2024-10-04 19:21:34,0,0,0,0,0,0
3,201392388,2170660915,0,0,2024-10-04 19:21:34,0,84,84,0,1,1
3,201392388,1145490691,63721,47873,2024-10-04 19:21:34,0,0,0,0,0,0
3,201392388,2170660915,26794,36895,2024-10-04 19:21:34,0,0,0,0,0,0
3,201392388,2170660915,18049,36895,2024-10-04 19:21:35,0,0,0,0,0,0
3,201392388,2170660915,0,0,2024-10-04 19:21:35,0,0,0,0,0,0
3,201392388,2170660915,54421,36895,2024-10-04 19:21:35,666,507,1173,6,6,12
3,201392388,2170660915,0,0,2024-10-04 19:21:36,128,84,212,1,1,2
3,201392388,2170660915,54421,36895,2024-10-04 19:21:36,0,0,0,0,0,0
3,201392388,2170660915,0,0,2024-10-04 19:21:37,128,84,212,1,1,2
3,201392388,2170660915,54421,36895,2024-10-04 19:21:37,0,0,0,0,0,0
3,201392388,2170660915,0,0,2024-10-04 19:21:38,128,84,212,1,1,2
3,201392388,2170660915,54421,36895,2024-10-04 19:21:38,0,0,0,0,0,0
3,201392388,2170660915,0,0,2024-10-04 19:21:39,0,0,0,0,0,0
3,201392388,2170660915,54421,36895,2024-10-04 19:21:39,0,0,0,0,0,0
3,201392388,2170660915,0,0,2024-10-04 19:21:40,0,0,0,0,0,0
3,201392388,2170660915,54421,36895,2024-10-04 19:21:40,0,0,0,0,0,0
3,201392388,2170660915,0,0,2024-10-04 19:21:41,0,0,0,0,0,0
3,201392388,2170660915,54421,36895,2024-10-04 19:21:41,0,0,0,0,0,0
3,201392388,2170660915,0,0,2024-10-04 19:21:42,128,84,212,1,1,2
3,201392388,2170660915,54421,36895,2024-10-04 19:21:42,0,0,0,0,0,0
3,201392388,2170660915,0,0,2024-10-04 19:21:43,128,84,212,1,1,2
3,201392388,2170660915,54421,36895,2024-10-04 19:21:43,0,0,0,0,0,0
3,201392388,1145490691,15040,47873,2024-10-04 19:21:44,5216,86317,91533,42,63,105
3,201392388,2170660915,0,0,2024-10-04 19:21:44,128,84,212,1,1,2
3,201392388,2170660915,54421,36895,2024-10-04 19:21:44,0,0,0,0,0,0
3,201392388,1145490691,15040,47873,2024-10-04 19:21:45,0,0,0,0,0,0
3,201392388,2170660915,0,0,2024-10-04 19:21:45,0,0,0,0,0,0
3,201392388,2170660915,54421,36895,2024-10-04 19:21:45,0,0,0,0,0,0
3,201392388,1145490691,15040,47873,2024-10-04 19:21:46,0,0,0,0,0,0
3,201392388,2170660915,0,0,2024-10-04 19:21:46,0,0,0,0,0,0
3,201392388,2170660915,54421,36895,2024-10-04 19:21:46,0,0,0,0,0,0
3,201392388,1145490691,15040,47873,2024-10-04 19:21:47,0,0,0,0,0,0
3,201392388,2170660915,0,0,2024-10-04 19:21:47,0,0,0,0,0,0
3,201392388,2170660915,54421,36895,2024-10-04 19:21:47,0,0,0,0,0,0
3,201392388,1145490691,15040,47873,2024-10-04 19:21:48,0,0,0,0,0,0
3,201392388,2170660915,0,0,2024-10-04 19:21:48,0,0,0,0,0,0
3,201392388,2170660915,54421,36895,2024-10-04 19:21:48,0,0,0,0,0,0
3,201392388,1145490691,15040,47873,2024-10-04 19:21:49,0,0,0,0,0,0
3,201392388,2170660915,0,0,2024-10-04 19:21:49,0,0,0,0,0,0
3,201392388,2170660915,54421,36895,2024-10-04 19:21:49,0,0,0,0,0,0
3,201392388,1145490691,15040,47873,2024-10-04 19:21:50,0,0,0,0,0,0
3,201392388,2170660915,0,0,2024-10-04 19:21:50,0,0,0,0,0,0
3,201392388,2170660915,54421,36895,2024-10-04 19:21:50,0,0,0,0,0,0
3,201392388,1145490691,15040,47873,2024-10-04 19:21:51,0,0,0,0,0,0
3,201392388,2170660915,0,0,2024-10-04 19:21:51,0,0,0,0,0,0
3,201392388,2170660915,54421,36895,2024-10-04 19:21:51,0,0,0,0,0,0
3,201392388,1145490691,15040,47873,2024-10-04 19:21:52,0,0,0,0,0,0
3,201392388,2170660915,0,0,2024-10-04 19:21:52,0,0,0,0,0,0
3,201392388,2170660915,54421,36895,2024-10-04 19:21:52,0,0,0,0,0,0
3,201392388,1145490691,15040,47873,2024-10-04 19:21:53,0,0,0,0,0,0
3,201392388,2170660915,0,0,2024-10-04 19:21:53,0,0,0,0,0,0
3,201392388,2170660915,54421,36895,2024-10-04 19:21:53,0,0,0,0,0,0
3,201392388,1145490691,15040,47873,2024-10-04 19:21:54,0,0,0,0,0,0
3,201392388,2170660915,0,0,2024-10-04 19:21:54,0,0,0,0,0,0
3,201392388,2170660915,54421,36895,2024-10-04 19:21:54,0,0,0,0,0,0
3,201392388,1145490691,15040,47873,2024-10-04 19:21:55,1788,23051,24839,18,18,36
3,201392388,2170660915,0,0,2024-10-04 19:21:55,128,0,128,1,0,1
3,201392388,2170660915,54421,36895,2024-10-04 19:21:55,0,0,0,0,0,0
3,201392388,1145490691,15040,47873,2024-10-04 19:21:56,0,0,0,0,0,0
3,201392388,2170660915,0,0,2024-10-04 19:21:56,128,84,212,1,1,2
3,201392388,2170660915,54421,36895,2024-10-04 19:21:56,0,0,0,0,0,0
3,201392388,1145490691,15040,47873,2024-10-04 19:21:57,0,0,0,0,0,0
3,201392388,2170660915,0,0,2024-10-04 19:21:57,128,84,212,1,1,2
3,201392388,2170660915,54421,36895,2024-10-04 19:21:57,0,0,0,0,0,0
3,201392388,1145490691,15040,47873,2024-10-04 19:21:58,0,0,0,0,0,0
3,201392388,2170660915,0,0,2024-10-04 19:21:58,128,84,212,1,1,2
3,201392388,2170660915,54421,36895,2024-10-04 19:21:58,0,0,0,0,0,0
3,201392388,1145490691,15040,47873,2024-10-04 19:21:59,0,0,0,0,0,0
3,201392388,2170660915,0,0,2024-10-04 19:21:59,128,84,212,1,1,2
3,201392388,2170660915,54421,36895,2024-10-04 19:21:59,0,0,0,0,0,0
3,201392388,1145490691,15040,47873,2024-10-04 19:22:00,0,0,0,0,0,0
3,201392388,2170660915,0,0,2024-10-04 19:22:00,128,168,296,1,2,3
3,201392388,2170660915,54421,36895,2024-10-04 19:22:00,0,0,0,0,0,0
3,201392388,1145490691,15040,47873,2024-10-04 19:22:01,0,0,0,0,0,0
3,201392388,2170660915,0,0,2024-10-04 19:22:01,128,84,212,1,1,2
3,201392388,2170660915,54421,36895,2024-10-04 19:22:01,0,0,0,0,0,0
3,201392388,1145490691,15040,47873,2024-10-04 19:22:02,0,0,0,0,0,0
3,201392388,2170660915,0,0,2024-10-04 19:22:02,128,84,212,1,1,2
3,201392388,2170660915,54421,36895,2024-10-04 19:22:02,0,0,0,0,0,0
3,201392388,1145490691,15040,47873,2024-10-04 19:22:03,0,0,0,0,0,0
3,201392388,2170660915,0,0,2024-10-04 19:22:03,128,84,212,1,1,2
3,201392388,2170660915,54421,36895,2024-10-04 19:22:03,0,0,0,0,0,0
3,201392388,1145490691,15040,47873,2024-10-04 19:22:04,0,0,0,0,0,0
3,201392388,2170660915,0,0,2024-10-04 19:22:04,128,84,212,1,1,2
3,201392388,2170660915,54421,36895,2024-10-04 19:22:04,0,0,0,0,0,0
3,201392388,1145490691,15040,47873,2024-10-04 19:22:05,0,0,0,0,0,0
3,201392388,2170660915,0,0,2024-10-04 19:22:05,0,0,0,0,0,0
3,201392388,2170660915,54421,36895,2024-10-04 19:22:05,0,0,0,0,0,0
3,201392388,2170660915,25287,36895,2024-10-04 19:22:06,666,507,1173,6,6,12
3,201392388,2170660915,0,0,2024-10-04 19:22:06,128,0,128,1,0,1
3,201392388,2170660915,54421,36895,2024-10-04 19:22:06,0,0,0,0,0,0
3,201392388,2170660915,25287,36895,2024-10-04 19:22:07,0,0,0,0,0,0
3,201392388,2170660915,0,0,2024-10-04 19:22:07,128,84,212,1,1,2
3,201392388,2170660915,54421,36895,2024-10-04 19:22:07,0,0,0,0,0,0
3,201392388,2170660915,25287,36895,2024-10-04 19:22:08,0,0,0,0,0,0
3,201392388,2170660915,0,0,2024-10-04 19:22:08,128,84,212,1,1,2
3,201392388,2170660915,54421,36895,2024-10-04 19:22:08,0,0,0,0,0,0
3,201392388,2170660915,25287,36895,2024-10-04 19:22:09,0,0,0,0,0,0
3,201392388,2170660915,0,0,2024-10-04 19:22:09,0,0,0,0,0,0
3,201392388,2170660915,54421,36895,2024-10-04 19:22:09,0,0,0,0,0,0
3,201392388,2170660915,25287,36895,2024-10-04 19:22:10,0,0,0,0,0,0
3,201392388,2170660915,0,0,2024-10-04 19:22:10,0,0,0,0,0,0
3,201392388,2170660915,54421,36895,2024-10-04 19:22:10,0,0,0,0,0,0
3,201392388,2170660915,25287,36895,2024-10-04 19:22:11,0,0,0,0,0,0
3,201392388,2170660915,0,0,2024-10-04 19:22:11,0,0,0,0,0,0
3,201392388,2170660915,54421,36895,2024-10-04 19:22:11,0,0,0,0,0,0
3,201392388,2170660915,25287,36895,2024-10-04 19:22:12,0,0,0,0,0,0
3,201392388,2170660915,0,0,2024-10-04 19:22:12,128,168,296,1,2,3
3,201392388,2170660915,54421,36895,2024-10-04 19:22:12,0,0,0,0,0,0
3,201392388,2170660915,25287,36895,2024-10-04 19:22:13,0,0,0,0,0,0
3,201392388,2170660915,0,0,2024-10-04 19:22:13,128,84,212,1,1,2
3,201392388,2170660915,54421,36895,2024-10-04 19:22:13,0,0,0,0,0,0
3,201392388,1145490690,52363,47873,2024-10-04 19:22:14,3540,38575,42115,27,35,62
3,201392388,2170660915,25287,36895,2024-10-04 19:22:14,0,0,0,0,0,0
3,201392388,2170660915,0,0,2024-10-04 19:22:14,128,84,212,1,1,2
3,201392388,2170660915,54421,36895,2024-10-04 19:22:14,0,0,0,0,0,0
3,201392388,1145490690,52363,47873,2024-10-04 19:22:15,2988,56607,59595,29,40,69
3,201392388,2170660915,25287,36895,2024-10-04 19:22:15,0,0,0,0,0,0
3,201392388,2170660915,0,0,2024-10-04 19:22:15,0,0,0,0,0,0
3,201392388,2170660915,54421,36895,2024-10-04 19:22:15,0,0,0,0,0,0
3,201392388,1145490690,52363,47873,2024-10-04 19:22:16,0,0,0,0,0,0
3,201392388,2170660915,25287,36895,2024-10-04 19:22:16,0,0,0,0,0,0
3,201392388,2170660915,0,0,2024-10-04 19:22:16,0,0,0,0,0,0
3,201392388,2170660915,54421,36895,2024-10-04 19:22:16,0,0,0,0,0,0
3,201392388,1145490690,52363,47873,2024-10-04 19:22:17,0,0,0,0,0,0
3,201392388,2170660915,25287,36895,2024-10-04 19:22:17,0,0,0,0,0,0
3,201392388,2170660915,0,0,2024-10-04 19:22:17,0,0,0,0,0,0
3,201392388,2170660915,54421,36895,2024-10-04 19:22:17,0,0,0,0,0,0
3,201392388,1145490690,52363,47873,2024-10-04 19:22:18,0,0,0,0,0,0
3,201392388,2170660915,25287,36895,2024-10-04 19:22:18,0,0,0,0,0,0
3,201392388,2170660915,0,0,2024-10-04 19:22:18,0,0,0,0,0,0
3,201392388,2170660915,54421,36895,2024-10-04 19:22:18,0,0,0,0,0,0
3,201392388,1145490690,52363,47873,2024-10-04 19:22:19,0,0,0,0,0,0
3,201392388,2170660915,25287,36895,2024-10-04 19:22:19,0,0,0,0,0,0
3,201392388,2170660915,0,0,2024-10-04 19:22:19,0,0,0,0,0,0
3,201392388,2170660915,54421,36895,2024-10-04 19:22:19,0,0,0,0,0,0
3,201392388,1145490690,52363,47873,2024-10-04 19:22:20,0,0,0,0,0,0
3,201392388,2170660915,25287,36895,2024-10-04 19:22:20,0,0,0,0,0,0
3,201392388,2170660915,0,0,2024-10-04 19:22:20,0,0,0,0,0,0
3,201392388,2170660915,54421,36895,2024-10-04 19:22:20,0,0,0,0,0,0
3,201392388,1145490690,52363,47873,2024-10-04 19:22:21,0,0,0,0,0,0
3,201392388,2170660915,25287,36895,2024-10-04 19:22:21,0,0,0,0,0,0
3,201392388,2170660915,0,0,2024-10-04 19:22:21,0,0,0,0,0,0
3,201392388,2170660915,54421,36895,2024-10-04 19:22:21,0,0,0,0,0,0
3,201392388,1145490690,52363,47873,2024-10-04 19:22:22,0,0,0,0,0,0
3,201392388,2170660915,25287,36895,2024-10-04 19:22:22,0,0,0,0,0,0
3,201392388,2170660915,0,0,2024-10-04 19:22:22,0,0,0,0,0,0
3,201392388,2170660915,54421,36895,2024-10-04 19:22:22,0,0,0,0,0,0
3,201392388,1145490690,52363,47873,2024-10-04 19:22:23,0,0,0,0,0,0
3,201392388,2170660915,25287,36895,2024-10-04 19:22:23,0,0,0,0,0,0
3,201392388,2170660915,0,0,2024-10-04 19:22:23,0,0,0,0,0,0
3,201392388,2170660915,54421,36895,2024-10-04 19:22:23,0,0,0,0,0,0
3,201392388,1145490690,52363,47873,2024-10-04 19:22:24,0,0,0,0,0,0
3,201392388,2170660915,25287,36895,2024-10-04 19:22:24,0,0,0,0,0,0
3,201392388,2170660915,0,0,2024-10-04 19:22:24,0,0,0,0,0,0
3,201392388,2170660915,54421,36895,2024-10-04 19:22:24,0,0,0,0,0,0
3,201392388,1145490690,52363,47873,2024-10-04 19:22:25,0,0,0,0,0,0
3,201392388,2170660915,25287,36895,2024-10-04 19:22:25,0,0,0,0,0,0
3,201392388,2170660915,0,0,2024-10-04 19:22:25,128,0,128,1,0,1
3,201392388,2170660915,54421,36895,2024-10-04 19:22:25,0,0,0,0,0,0
3,201392388,1145490690,52363,47873,2024-10-04 19:22:26,0,0,0,0,0,0
3,201392388,2170660915,25287,36895,2024-10-04 19:22:26,0,0,0,0,0,0
3,201392388,2170660915,0,0,2024-10-04 19:22:26,0,84,84,0,1,1
3,201392388,2170660915,54421,36895,2024-10-04 19:22:26,0,0,0,0,0,0
3,201392388,1145490690,52363,47873,2024-10-04 19:22:27,0,0,0,0,0,0
3,201392388,2170660915,25287,36895,2024-10-04 19:22:27,0,0,0,0,0,0
3,201392388,2170660915,0,0,2024-10-04 19:22:27,128,84,212,1,1,2
3,201392388,2170660915,54421,36895,2024-10-04 19:22:27,0,0,0,0,0,0
3,201392388,1145490690,52363,47873,2024-10-04 19:22:28,0,0,0,0,0,0
3,201392388,2170660915,25287,36895,2024-10-04 19:22:28,0,0,0,0,0,0
3,201392388,2170660915,0,0,2024-10-04 19:22:28,128,84,212,1,1,2
3,201392388,2170660915,54421,36895,2024-10-04 19:22:28,0,0,0,0,0,0
3,201392388,1145490690,52363,47873,2024-10-04 19:22:29,0,0,0,0,0,0
3,201392388,2170660915,25287,36895,2024-10-04 19:22:29,0,0,0,0,0,0
3,201392388,2170660915,0,0,2024-10-04 19:22:29,128,84,212,1,1,2
3,201392388,2170660915,54421,36895,2024-10-04 19:22:29,0,0,0,0,0,0
3,201392388,1145490690,52363,47873,2024-10-04 19:22:30,0,0,0,0,0,0
3,201392388,2170660915,25287,36895,2024-10-04 19:22:30,0,0,0,0,0,0
3,201392388,2170660915,0,0,2024-10-04 19:22:30,128,84,212,1,1,2
3,201392388,2170660915,54421,36895,2024-10-04 19:22:30,0,0,0,0,0,0
3,201392388,1145490690,52363,47873,2024-10-04 19:22:31,0,0,0,0,0,0
3,201392388,2170660915,25287,36895,2024-10-04 19:22:31,0,0,0,0,0,0
3,201392388,2170660915,0,0,2024-10-04 19:22:31,128,84,212,1,1,2
3,201392388,2170660915,54421,36895,2024-10-04 19:22:31,0,0,0,0,0,0
3,201392388,1145490690,52363,47873,2024-10-04 19:22:32,0,0,0,0,0,0
3,201392388,2170660915,25287,36895,2024-10-04 19:22:32,0,0,0,0,0,0
3,201392388,2170660915,0,0,2024-10-04 19:22:32,256,84,340,2,1,3
3,201392388,2170660915,54421,36895,2024-10-04 19:22:32,0,0,0,0,0,0
3,201392388,1145490690,52363,47873,2024-10-04 19:22:33,0,0,0,0,0,0
3,201392388,2170660915,25287,36895,2024-10-04 19:22:33,0,0,0,0,0,0
3,201392388,2170660915,0,0,2024-10-04 19:22:33,128,84,212,1,1,2
3,201392388,2170660915,54421,36895,2024-10-04 19:22:33,0,0,0,0,0,0
3,201392388,1145490690,52363,47873,2024-10-04 19:22:34,0,0,0,0,0,0
3,201392388,2170660915,25287,36895,2024-10-04 19:22:34,0,0,0,0,0,0
3,201392388,2170660915,0,0,2024-10-04 19:22:34,128,84,212,1,1,2
3,201392388,2170660915,54421,36895,2024-10-04 19:22:34,0,0,0,0,0,0
3,201392388,1145490690,52363,47873,2024-10-04 19:22:35,0,0,0,0,0,0
3,201392388,2170660915,25287,36895,2024-10-04 19:22:35,0,0,0,0,0,0
3,201392388,2170660915,0,0,2024-10-04 19:22:35,0,84,84,0,1,1
3,201392388,2170660915,54421,36895,2024-10-04 19:22:35,0,0,0,0,0,0
3,201392388,2170660915,25287,36895,2024-10-04 19:22:36,0,0,0,0,0,0
3,201392388,2170660915,0,0,2024-10-04 19:22:36,0,0,0,0,0,0
3,201392388,2170660915,54421,36895,2024-10-04 19:22:36,0,0,0,0,0,0
3,201392388,2170660915,31460,36895,2024-10-04 19:22:37,666,507,1173,6,6,12
3,201392388,2170660915,25287,36895,2024-10-04 19:22:37,0,0,0,0,0,0
3,201392388,2170660915,0,0,2024-10-04 19:22:37,128,0,128,1,0,1
3,201392388,2170660915,54421,36895,2024-10-04 19:22:37,0,0,0,0,0,0
3,201392388,2170660915,31460,36895,2024-10-04 19:22:38,0,0,0,0,0,0
3,201392388,2170660915,25287,36895,2024-10-04 19:22:38,0,0,0,0,0,0
3,201392388,2170660915,0,0,2024-10-04 19:22:38,0,84,84,0,1,1
3,201392388,2170660915,54421,36895,2024-10-04 19:22:38,0,0,0,0,0,0
3,201392388,2170660915,31460,36895,2024-10-04 19:22:39,0,0,0,0,0,0
3,201392388,2170660915,25287,36895,2024-10-04 19:22:39,0,0,0,0,0,0
3,201392388,2170660915,0,0,2024-10-04 19:22:39,128,84,212,1,1,2
3,201392388,2170660915,54421,36895,2024-10-04 19:22:39,0,0,0,0,0,0
3,201392388,2170660915,31460,36895,2024-10-04 19:22:40,0,0,0,0,0,0
3,201392388,2170660915,25287,36895,2024-10-04 19:22:40,0,0,0,0,0,0
3,201392388,2170660915,0,0,2024-10-04 19:22:40,0,0,0,0,0,0
3,201392388,2170660915,54421,36895,2024-10-04 19:22:40,0,0,0,0,0,0
3,201392388,2170660915,31460,36895,2024-10-04 19:22:41,0,0,0,0,0,0
3,201392388,2170660915,25287,36895,2024-10-04 19:22:41,0,0,0,0,0,0
3,201392388,2170660915,0,0,2024-10-04 19:22:41,0,0,0,0,0,0
3,201392388,2170660915,54421,36895,2024-10-04 19:22:41,0,0,0,0,0,0
3,201392388,2170660915,31460,36895,2024-10-04 19:22:42,0,0,0,0,0,0
3,201392388,2170660915,25287,36895,2024-10-04 19:22:42,0,0,0,0,0,0
3,201392388,2170660915,0,0,2024-10-04 19:22:42,0,0,0,0,0,0
3,201392388,2170660915,54421,36895,2024-10-04 19:22:42,0,0,0,0,0,0
3,201392388,2170660915,31460,36895,2024-10-04 19:22:43,0,0,0,0,0,0
3,201392388,2170660915,25287,36895,2024-10-04 19:22:43,0,0,0,0,0,0
3,201392388,2170660915,0,0,2024-10-04 19:22:43,128,84,212,1,1,2
3,201392388,2170660915,54421,36895,2024-10-04 19:22:43,0,0,0,0,0,0
3,201392388,2170660915,31460,36895,2024-10-04 19:22:44,0,0,0,0,0,0
3,201392388,2170660915,25287,36895,2024-10-04 19:22:44,0,0,0,0,0,0
3,201392388,2170660915,0,0,2024-10-04 19:22:44,128,84,212,1,1,2
3,201392388,2170660915,54421,36895,2024-10-04 19:22:44,0,0,0,0,0,0
3,201392388,2170660915,31460,36895,2024-10-04 19:22:45,0,0,0,0,0,0
3,201392388,2170660915,25287,36895,2024-10-04 19:22:45,0,0,0,0,0,0
3,201392388,2170660915,0,0,2024-10-04 19:22:45,256,168,424,2,2,4
3,201392388,1145490690,51911,47873,2024-10-04 19:22:45,2412,20781,23193,16,23,39
3,201392388,2170660915,54421,36895,2024-10-04 19:22:45,0,0,0,0,0,0
3,201392388,2170660915,31460,36895,2024-10-04 19:22:46,0,0,0,0,0,0
3,201392388,2170660915,25287,36895,2024-10-04 19:22:46,0,0,0,0,0,0
3,201392388,2170660915,0,0,2024-10-04 19:22:46,0,0,0,0,0,0
3,201392388,1145490690,51911,47873,2024-10-04 19:22:46,1032,28630,29662,10,18,28
3,201392388,2170660915,54421,36895,2024-10-04 19:22:46,0,0,0,0,0,0
3,201392388,2170660915,31460,36895,2024-10-04 19:22:47,0,0,0,0,0,0
3,201392388,2170660915,25287,36895,2024-10-04 19:22:47,0,0,0,0,0,0
3,201392388,2170660915,0,0,2024-10-04 19:22:47,0,0,0,0,0,0
3,201392388,1145490690,51911,47873,2024-10-04 19:22:47,1236,34924,36160,12,22,34
3,201392388,2170660915,54421,36895,2024-10-04 19:22:47,0,0,0,0,0,0
3,201392388,2170660915,31460,36895,2024-10-04 19:22:48,0,0,0,0,0,0
3,201392388,2170660915,25287,36895,2024-10-04 19:22:48,0,0,0,0,0,0
3,201392388,2170660915,0,0,2024-10-04 19:22:48,0,0,0,0,0,0
3,201392388,1145490690,51911,47873,2024-10-04 19:22:48,0,0,0,0,0,0
3,201392388,2170660915,54421,36895,2024-10-04 19:22:48,0,0,0,0,0,0
3,201392388,2170660915,31460,36895,2024-10-04 19:22:49,0,0,0,0,0,0
3,201392388,2170660915,25287,36895,2024-10-04 19:22:49,0,0,0,0,0,0
3,201392388,2170660915,0,0,2024-10-04 19:22:49,0,0,0,0,0,0
3,201392388,1145490690,51911,47873,2024-10-04 19:22:49,0,0,0,0,0,0
3,201392388,2170660915,54421,36895,2024-10-04 19:22:49,0,0,0,0,0,0
3,201392388,2170660915,31460,36895,2024-10-04 19:22:50,0,0,0,0,0,0
3,201392388,2170660915,25287,36895,2024-10-04 19:22:50,0,0,0,0,0,0
3,201392388,2170660915,0,0,2024-10-04 19:22:50,0,0,0,0,0,0
3,201392388,1145490690,51911,47873,2024-10-04 19:22:50,0,0,0,0,0,0
3,201392388,2170660915,54421,36895,2024-10-04 19:22:50,0,0,0,0,0,0
3,201392388,2170660915,31460,36895,2024-10-04 19:22:51,0,0,0,0,0,0
3,201392388,2170660915,25287,36895,2024-10-04 19:22:51,0,0,0,0,0,0
3,201392388,2170660915,0,0,2024-10-04 19:22:51,0,0,0,0,0,0
3,201392388,1145490690,51911,47873,2024-10-04 19:22:51,0,0,0,0,0,0
3,201392388,2170660915,54421,36895,2024-10-04 19:22:51,0,0,0,0,0,0
3,201392388,2170660915,31460,36895,2024-10-04 19:22:52,0,0,0,0,0,0
3,201392388,2170660915,25287,36895,2024-10-04 19:22:52,0,0,0,0,0,0
3,201392388,2170660915,0,0,2024-10-04 19:22:52,0,0,0,0,0,0
3,201392388,1145490690,51911,47873,2024-10-04 19:22:52,0,0,0,0,0,0
3,201392388,2170660915,54421,36895,2024-10-04 19:22:52,0,0,0,0,0,0
3,201392388,2170660915,31460,36895,2024-10-04 19:22:53,0,0,0,0,0,0
3,201392388,2170660915,25287,36895,2024-10-04 19:22:53,0,0,0,0,0,0
3,201392388,2170660915,0,0,2024-10-04 19:22:53,0,0,0,0,0,0
3,201392388,1145490690,51911,47873,2024-10-04 19:22:53,0,0,0,0,0,0
3,201392388,2170660915,54421,36895,2024-10-04 19:22:53,0,0,0,0,0,0
3,201392388,2170660915,31460,36895,2024-10-04 19:22:54,0,0,0,0,0,0
3,201392388,2170660915,25287,36895,2024-10-04 19:22:54,0,0,0,0,0,0
3,201392388,2170660915,0,0,2024-10-04 19:22:54,0,0,0,0,0,0
3,201392388,1145490690,51911,47873,2024-10-04 19:22:54,0,0,0,0,0,0
3,201392388,2170660915,54421,36895,2024-10-04 19:22:54,0,0,0,0,0,0
3,201392388,2170660915,31460,36895,2024-10-04 19:22:55,0,0,0,0,0,0
3,201392388,2170660915,25287,36895,2024-10-04 19:22:55,0,0,0,0,0,0
3,201392388,2170660915,0,0,2024-10-04 19:22:55,0,0,0,0,0,0
3,201392388,1145490690,51911,47873,2024-10-04 19:22:55,0,0,0,0,0,0
3,201392388,2170660915,54421,36895,2024-10-04 19:22:55,0,0,0,0,0,0
3,201392388,2170660915,31460,36895,2024-10-04 19:22:56,0,0,0,0,0,0
3,201392388,2170660915,25287,36895,2024-10-04 19:22:56,0,0,0,0,0,0
3,201392388,2170660915,0,0,2024-10-04 19:22:56,0,0,0,0,0,0
3,201392388,1145490690,51911,47873,2024-10-04 19:22:56,1428,25085,26513,14,19,33
3,201392388,2170660915,54421,36895,2024-10-04 19:22:56,0,0,0,0,0,0
3,201392388,2170660915,31460,36895,2024-10-04 19:22:57,0,0,0,0,0,0
3,201392388,2170660915,25287,36895,2024-10-04 19:22:57,0,0,0,0,0,0
3,201392388,2170660915,0,0,2024-10-04 19:22:57,128,0,128,1,0,1
3,201392388,1145490690,51911,47873,2024-10-04 19:22:57,0,0,0,0,0,0
3,201392388,2170660915,54421,36895,2024-10-04 19:22:57,0,0,0,0,0,0
3,201392388,2170660915,31460,36895,2024-10-04 19:22:58,0,0,0,0,0,0
3,201392388,2170660915,25287,36895,2024-10-04 19:22:58,0,0,0,0,0,0
3,201392388,2170660915,0,0,2024-10-04 19:22:58,128,84,212,1,1,2
3,201392388,1145490690,51911,47873,2024-10-04 19:22:58,0,0,0,0,0,0
3,201392388,2170660915,54421,36895,2024-10-04 19:22:58,0,0,0,0,0,0
3,201392388,2170660915,31460,36895,2024-10-04 19:22:59,0,0,0,0,0,0
3,201392388,2170660915,25287,36895,2024-10-04 19:22:59,0,0,0,0,0,0
3,201392388,2170660915,0,0,2024-10-04 19:22:59,128,84,212,1,1,2
3,201392388,1145490690,51911,47873,2024-10-04 19:22:59,0,0,0,0,0,0
3,201392388,2170660915,54421,36895,2024-10-04 19:22:59,0,0,0,0,0,0
3,201392388,2170660915,31460,36895,2024-10-04 19:23:00,0,0,0,0,0,0
3,201392388,2170660915,25287,36895,2024-10-04 19:23:00,0,0,0,0,0,0
3,201392388,2170660915,0,0,2024-10-04 19:23:00,128,84,212,1,1,2
3,201392388,1145490690,51911,47873,2024-10-04 19:23:00,0,0,0,0,0,0
3,201392388,2170660915,54421,36895,2024-10-04 19:23:00,0,0,0,0,0,0
3,201392388,2170660915,31460,36895,2024-10-04 19:23:01,0,0,0,0,0,0
3,201392388,2170660915,25287,36895,2024-10-04 19:23:01,0,0,0,0,0,0
3,201392388,2170660915,0,0,2024-10-04 19:23:01,0,84,84,0,1,1
3,201392388,1145490690,51911,47873,2024-10-04 19:23:01,0,0,0,0,0,0
3,201392388,2170660915,54421,36895,2024-10-04 19:23:01,0,0,0,0,0,0
3,201392388,2170660915,31460,36895,2024-10-04 19:23:02,0,0,0,0,0,0
3,201392388,2170660915,25287,36895,2024-10-04 19:23:02,0,0,0,0,0,0
3,201392388,2170660915,0,0,2024-10-04 19:23:02,128,84,212,1,1,2
3,201392388,1145490690,51911,47873,2024-10-04 19:23:02,0,0,0,0,0,0
3,201392388,2170660915,54421,36895,2024-10-04 19:23:02,0,0,0,0,0,0
3,201392388,2170660915,31460,36895,2024-10-04 19:23:03,0,0,0,0,0,0
3,201392388,2170660915,25287,36895,2024-10-04 19:23:03,0,0,0,0,0,0
3,201392388,2170660915,0,0,2024-10-04 19:23:03,128,84,212,1,1,2
3,201392388,1145490690,51911,47873,2024-10-04 19:23:03,0,0,0,0,0,0
3,201392388,2170660915,54421,36895,2024-10-04 19:23:03,0,0,0,0,0,0
3,201392388,2170660915,31460,36895,2024-10-04 19:23:04,0,0,0,0,0,0
3,201392388,2170660915,25287,36895,2024-10-04 19:23:04,0,0,0,0,0,0
3,201392388,2170660915,0,0,2024-10-04 19:23:04,128,84,212,1,1,2
3,201392388,1145490690,51911,47873,2024-10-04 19:23:04,0,0,0,0,0,0
3,201392388,2170660915,54421,36895,2024-10-04 19:23:04,0,0,0,0,0,0
3,201392388,2170660915,31460,36895,2024-10-04 19:23:05,0,0,0,0,0,0
3,201392388,2170660915,25287,36895,2024-10-04 19:23:05,0,0,0,0,0,0
3,201392388,2170660915,0,0,2024-10-04 19:23:05,128,84,212,1,1,2
3,201392388,1145490690,51911,47873,2024-10-04 19:23:05,0,0,0,0,0,0
3,201392388,2170660915,54421,36895,2024-10-04 19:23:05,0,0,0,0,0,0
3,201392388,2170660915,31460,36895,2024-10-04 19:23:06,0,0,0,0,0,0
3,201392388,2170660915,25287,36895,2024-10-04 19:23:06,0,0,0,0,0,0
3,201392388,2170660915,0,0,2024-10-04 19:23:06,128,84,212,1,1,2
3,201392388,2170660915,54421,36895,2024-10-04 19:23:06,0,0,0,0,0,0
3,201392388,2170660915,31460,36895,2024-10-04 19:23:07,0,0,0,0,0,0
3,201392388,2170660915,25287,36895,2024-10-04 19:23:07,0,0,0,0,0,0
3,201392388,2170660915,0,0,2024-10-04 19:23:07,128,84,212,1,1,2
3,201392388,2170660915,54421,36895,2024-10-04 19:23:07,0,0,0,0,0,0
3,201392388,2170660915,25287,36895,2024-10-04 19:23:08,0,0,0,0,0,0
3,201392388,2170660915,0,0,2024-10-04 19:23:08,0,0,0,0,0,0
3,201392388,2170660915,23778,36895,2024-10-04 19:23:08,666,507,1173,6,6,12
3,201392388,2170660915,54421,36895,2024-10-04 19:23:08,0,0,0,0,0,0
3,201392388,2170660915,25287,36895,2024-10-04 19:23:09,0,0,0,0,0,0
3,201392388,2170660915,0,0,2024-10-04 19:23:09,128,84,212,1,1,2
3,201392388,2170660915,23778,36895,2024-10-04 19:23:09,0,0,0,0,0,0
3,201392388,2170660915,54421,36895,2024-10-04 19:23:09,0,0,0,0,0,0
3,201392388,2170660915,25287,36895,2024-10-04 19:23:10,0,0,0,0,0,0
3,201392388,2170660915,0,0,2024-10-04 19:23:10,128,84,212,1,1,2
3,201392388,2170660915,23778,36895,2024-10-04 19:23:10,0,0,0,0,0,0
3,201392388,2170660915,54421,36895,2024-10-04 19:23:10,0,0,0,0,0,0
3,201392388,2170660915,25287,36895,2024-10-04 19:23:11,0,0,0,0,0,0
3,201392388,2170660915,0,0,2024-10-04 19:23:11,0,0,0,0,0,0
3,201392388,2170660915,23778,36895,2024-10-04 19:23:11,0,0,0,0,0,0
3,201392388,2170660915,54421,36895,2024-10-04 19:23:11,0,0,0,0,0,0
3,201392388,2170660915,25287,36895,2024-10-04 19:23:12,0,0,0,0,0,0
3,201392388,2170660915,0,0,2024-10-04 19:23:12,0,0,0,0,0,0
3,201392388,2170660915,23778,36895,2024-10-04 19:23:12,0,0,0,0,0,0
3,201392388,2170660915,54421,36895,2024-10-04 19:23:12,0,0,0,0,0,0
3,201392388,2170660915,25287,36895,2024-10-04 19:23:13,0,0,0,0,0,0
3,201392388,2170660915,0,0,2024-10-04 19:23:13,128,84,212,1,1,2
3,201392388,2170660915,23778,36895,2024-10-04 19:23:13,0,0,0,0,0,0
3,201392388,2170660915,54421,36895,2024-10-04 19:23:13,0,0,0,0,0,0
3,201392388,2170660915,25287,36895,2024-10-04 19:23:14,0,0,0,0,0,0
3,201392388,2170660915,0,0,2024-10-04 19:23:14,0,0,0,0,0,0
3,201392388,2170660915,23778,36895,2024-10-04 19:23:14,0,0,0,0,0,0
3,201392388,2170660915,54421,36895,2024-10-04 19:23:14,0,0,0,0,0,0
3,201392388,2170660915,25287,36895,2024-10-04 19:23:15,0,0,0,0,0,0
3,201392388,2170660915,0,0,2024-10-04 19:23:15,128,84,212,1,1,2
3,201392388,2170660915,23778,36895,2024-10-04 19:23:15,0,0,0,0,0,0
3,201392388,2170660915,54421,36895,2024-10-04 19:23:15,0,0,0,0,0,0
3,201392388,2170660915,25287,36895,2024-10-04 19:23:16,0,0,0,0,0,0
3,201392388,2170660915,0,0,2024-10-04 19:23:16,128,84,212,1,1,2
3,201392388,2170660915,23778,36895,2024-10-04 19:23:16,0,0,0,0,0,0
3,201392388,2170660915,54421,36895,2024-10-04 19:23:16,0,0,0,0,0,0
3,201392388,2170660915,25287,36895,2024-10-04 19:23:17,0,0,0,0,0,0
3,201392388,2170660915,0,0,2024-10-04 19:23:17,128,84,212,1,1,2
3,201392388,2170660915,23778,36895,2024-10-04 19:23:17,0,0,0,0,0,0
3,201392388,1145490690,1745,47873,2024-10-04 19:23:17,2412,20781,23193,16,23,39
3,201392388,2170660915,54421,36895,2024-10-04 19:23:17,0,0,0,0,0,0
3,201392388,2170660915,25287,36895,2024-10-04 19:23:18,0,0,0,0,0,0
3,201392388,2170660915,0,0,2024-10-04 19:23:18,0,0,0,0,0,0
3,201392388,2170660915,23778,36895,2024-10-04 19:23:18,0,0,0,0,0,0
3,201392388,1145490690,1745,47873,2024-10-04 19:23:18,0,0,0,0,0,0
3,201392388,2170660915,54421,36895,2024-10-04 19:23:18,0,0,0,0,0,0
3,201392388,2170660915,25287,36895,2024-10-04 19:23:19,0,0,0,0,0,0
3,201392388,2170660915,0,0,2024-10-04 19:23:19,0,0,0,0,0,0
3,201392388,2170660915,23778,36895,2024-10-04 19:23:19,0,0,0,0,0,0
3,201392388,1145490690,1745,47873,2024-10-04 19:23:19,0,0,0,0,0,0
3,201392388,2170660915,54421,36895,2024-10-04 19:23:19,0,0,0,0,0,0
3,201392388,2170660915,25287,36895,2024-10-04 19:23:20,0,0,0,0,0,0
3,201392388,2170660915,0,0,2024-10-04 19:23:20,0,0,0,0,0,0
3,201392388,2170660915,23778,36895,2024-10-04 19:23:20,0,0,0,0,0,0
3,201392388,1145490690,1745,47873,2024-10-04 19:23:20,0,0,0,0,0,0
3,201392388,2170660915,54421,36895,2024-10-04 19:23:20,0,0,0,0,0,0
3,201392388,2170660915,25287,36895,2024-10-04 19:23:21,0,0,0,0,0,0
3,201392388,2170660915,0,0,2024-10-04 19:23:21,0,0,0,0,0,0
3,201392388,2170660915,23778,36895,2024-10-04 19:23:21,0,0,0,0,0,0
3,201392388,1145490690,1745,47873,2024-10-04 19:23:21,0,0,0,0,0,0
3,201392388,2170660915,54421,36895,2024-10-04 19:23:21,0,0,0,0,0,0
3,201392388,2170660915,25287,36895,2024-10-04 19:23:22,0,0,0,0,0,0
3,201392388,2170660915,0,0,2024-10-04 19:23:22,0,0,0,0,0,0
3,201392388,2170660915,23778,36895,2024-10-04 19:23:22,0,0,0,0,0,0
3,201392388,1145490690,1745,47873,2024-10-04 19:23:22,0,0,0,0,0,0
3,201392388,2170660915,54421,36895,2024-10-04 19:23:22,0,0,0,0,0,0
3,201392388,2170660915,25287,36895,2024-10-04 19:23:23,0,0,0,0,0,0
3,201392388,2170660915,0,0,2024-10-04 19:23:23,0,0,0,0,0,0
3,201392388,2170660915,23778,36895,2024-10-04 19:23:23,0,0,0,0,0,0
3,201392388,1145490690,1745,47873,2024-10-04 19:23:23,0,0,0,0,0,0
3,201392388,2170660915,54421,36895,2024-10-04 19:23:23,0,0,0,0,0,0
3,201392388,2170660915,25287,36895,2024-10-04 19:23:24,0,0,0,0,0,0
3,201392388,2170660915,0,0,2024-10-04 19:23:24,0,0,0,0,0,0
3,201392388,2170660915,23778,36895,2024-10-04 19:23:24,0,0,0,0,0,0
3,201392388,1145490690,1745,47873,2024-10-04 19:23:24,0,0,0,0,0,0
3,201392388,2170660915,54421,36895,2024-10-04 19:23:24,0,0,0,0,0,0
3,201392388,2170660915,25287,36895,2024-10-04 19:23:25,0,0,0,0,0,0
3,201392388,2170660915,0,0,2024-10-04 19:23:25,0,0,0,0,0,0
3,201392388,2170660915,23778,36895,2024-10-04 19:23:25,0,0,0,0,0,0
3,201392388,1145490690,1745,47873,2024-10-04 19:23:25,0,0,0,0,0,0
3,201392388,2170660915,54421,36895,2024-10-04 19:23:25,0,0,0,0,0,0
3,201392388,2170660915,25287,36895,2024-10-04 19:23:26,0,0,0,0,0,0
3,201392388,2170660915,0,0,2024-10-04 19:23:26,0,0,0,0,0,0
3,201392388,2170660915,23778,36895,2024-10-04 19:23:26,0,0,0,0,0,0
3,201392388,1145490690,1745,47873,2024-10-04 19:23:26,3648,72419,76067,36,52,88
3,201392388,2170660915,54421,36895,2024-10-04 19:23:26,0,0,0,0,0,0
3,201392388,2170660915,25287,36895,2024-10-04 19:23:27,0,0,0,0,0,0
3,201392388,2170660915,0,0,2024-10-04 19:23:27,0,0,0,0,0,0
3,201392388,2170660915,23778,36895,2024-10-04 19:23:27,0,0,0,0,0,0
3,201392388,1145490690,1745,47873,2024-10-04 19:23:27,0,0,0,0,0,0
3,201392388,2170660915,54421,36895,2024-10-04 19:23:27,0,0,0,0,0,0
3,201392388,2170660915,25287,36895,2024-10-04 19:23:28,0,0,0,0,0,0
3,201392388,2170660915,0,0,2024-10-04 19:23:28,128,84,212,1,1,2
3,201392388,2170660915,23778,36895,2024-10-04 19:23:28,0,0,0,0,0,0
3,201392388,1145490690,1745,47873,2024-10-04 19:23:28,0,0,0,0,0,0
3,201392388,2170660915,54421,36895,2024-10-04 19:23:28,0,0,0,0,0,0
3,201392388,2170660915,25287,36895,2024-10-04 19:23:29,0,0,0,0,0,0
3,201392388,2170660915,0,0,2024-10-04 19:23:29,128,84,212,1,1,2
3,201392388,2170660915,23778,36895,2024-10-04 19:23:29,0,0,0,0,0,0
3,201392388,1145490690,1745,47873,2024-10-04 19:23:29,0,0,0,0,0,0
3,201392388,2170660915,54421,36895,2024-10-04 19:23:29,0,0,0,0,0,0
3,201392388,2170660915,25287,36895,2024-10-04 19:23:30,0,0,0,0,0,0
3,201392388,2170660915,0,0,2024-10-04 19:23:30,128,84,212,1,1,2
3,201392388,2170660915,23778,36895,2024-10-04 19:23:30,0,0,0,0,0,0
3,201392388,1145490690,1745,47873,2024-10-04 19:23:30,0,0,0,0,0,0
3,201392388,2170660915,54421,36895,2024-10-04 19:23:30,0,0,0,0,0,0
3,201392388,2170660915,25287,36895,2024-10-04 19:23:31,0,0,0,0,0,0
3,201392388,2170660915,0,0,2024-10-04 19:23:31,128,84,212,1,1,2
3,201392388,2170660915,23778,36895,2024-10-04 19:23:31,0,0,0,0,0,0
3,201392388,1145490690,1745,47873,2024-10-04 19:23:31,0,0,0,0,0,0
3,201392388,2170660915,54421,36895,2024-10-04 19:23:31,0,0,0,0,0,0
3,201392388,2170660915,25287,36895,2024-10-04 19:23:32,0,0,0,0,0,0
3,201392388,2170660915,0,0,2024-10-04 19:23:32,128,84,212,1,1,2
3,201392388,2170660915,23778,36895,2024-10-04 19:23:32,0,0,0,0,0,0
3,201392388,1145490690,1745,47873,2024-10-04 19:23:32,0,0,0,0,0,0
3,201392388,2170660915,54421,36895,2024-10-04 19:23:32,0,0,0,0,0,0
3,201392388,2170660915,25287,36895,2024-10-04 19:23:33,0,0,0,0,0,0
3,201392388,2170660915,0,0,2024-10-04 19:23:33,128,84,212,1,1,2
3,201392388,2170660915,23778,36895,2024-10-04 19:23:33,0,0,0,0,0,0
3,201392388,1145490690,1745,47873,2024-10-04 19:23:33,0,0,0,0,0,0
3,201392388,2170660915,54421,36895,2024-10-04 19:23:33,0,0,0,0,0,0
3,201392388,2170660915,25287,36895,2024-10-04 19:23:34,0,0,0,0,0,0
3,201392388,2170660915,0,0,2024-10-04 19:23:34,128,84,212,1,1,2
3,201392388,2170660915,23778,36895,2024-10-04 19:23:34,0,0,0,0,0,0
3,201392388,1145490690,1745,47873,2024-10-04 19:23:34,0,0,0,0,0,0
3,201392388,2170660915,54421,36895,2024-10-04 19:23:34,0,0,0,0,0,0
3,201392388,2170660915,25287,36895,2024-10-04 19:23:35,0,0,0,0,0,0
3,201392388,2170660915,0,0,2024-10-04 19:23:35,128,84,212,1,1,2
3,201392388,2170660915,23778,36895,2024-10-04 19:23:35,0,0,0,0,0,0
3,201392388,1145490690,1745,47873,2024-10-04 19:23:35,0,0,0,0,0,0
3,201392388,2170660915,54421,36895,2024-10-04 19:23:35,0,0,0,0,0,0
3,201392388,2170660915,25287,36895,2024-10-04 19:23:36,0,0,0,0,0,0
3,201392388,2170660915,0,0,2024-10-04 19:23:36,128,84,212,1,1,2
3,201392388,2170660915,23778,36895,2024-10-04 19:23:36,0,0,0,0,0,0
3,201392388,1145490690,1745,47873,2024-10-04 19:23:36,0,0,0,0,0,0
3,201392388,2170660915,54421,36895,2024-10-04 19:23:36,0,0,0,0,0,0
3,201392388,2170660915,25287,36895,2024-10-04 19:23:37,0,0,0,0,0,0
3,201392388,2170660915,0,0,2024-10-04 19:23:37,128,84,212,1,1,2
3,201392388,2170660915,23778,36895,2024-10-04 19:23:37,0,0,0,0,0,0
3,201392388,2170660915,54421,36895,2024-10-04 19:23:37,0,0,0,0,0,0
3,201392388,2170660915,64660,36895,2024-10-04 19:23:38,666,507,1173,6,6,12
3,201392388,2170660915,25287,36895,2024-10-04 19:23:38,0,0,0,0,0,0
3,201392388,2170660915,0,0,2024-10-04 19:23:38,0,0,0,0,0,0
3,201392388,2170660915,54421,36895,2024-10-04 19:23:38,0,0,0,0,0,0
3,201392388,2170660915,64660,36895,2024-10-04 19:23:39,0,0,0,0,0,0
3,201392388,2170660915,25287,36895,2024-10-04 19:23:39,0,0,0,0,0,0
3,201392388,2170660915,0,0,2024-10-04 19:23:39,128,84,212,1,1,2
3,201392388,2170660915,54421,36895,2024-10-04 19:23:39,0,0,0,0,0,0
3,201392388,2170660915,64660,36895,2024-10-04 19:23:40,0,0,0,0,0,0
3,201392388,2170660915,25287,36895,2024-10-04 19:23:40,0,0,0,0,0,0
3,201392388,2170660915,0,0,2024-10-04 19:23:40,128,84,212,1,1,2
3,201392388,2170660915,54421,36895,2024-10-04 19:23:40,0,0,0,0,0,0
3,201392388,2170660915,64660,36895,2024-10-04 19:23:41,0,0,0,0,0,0
3,201392388,2170660915,25287,36895,2024-10-04 19:23:41,0,0,0,0,0,0
3,201392388,2170660915,0,0,2024-10-04 19:23:41,128,0,128,1,0,1
3,201392388,2170660915,54421,36895,2024-10-04 19:23:41,0,0,0,0,0,0
3,201392388,2170660915,64660,36895,2024-10-04 19:23:42,0,0,0,0,0,0
3,201392388,2170660915,25287,36895,2024-10-04 19:23:42,0,0,0,0,0,0
3,201392388,2170660915,0,0,2024-10-04 19:23:42,0,0,0,0,0,0
3,201392388,2170660915,54421,36895,2024-10-04 19:23:42,0,0,0,0,0,0
3,201392388,2170660915,64660,36895,2024-10-04 19:23:43,0,0,0,0,0,0
3,201392388,2170660915,25287,36895,2024-10-04 19:23:43,0,0,0,0,0,0
3,201392388,2170660915,0,0,2024-10-04 19:23:43,0,0,0,0,0,0
3,201392388,2170660915,54421,36895,2024-10-04 19:23:43,0,0,0,0,0,0
3,201392388,2170660915,64660,36895,2024-10-04 19:23:44,0,0,0,0,0,0
3,201392388,2170660915,25287,36895,2024-10-04 19:23:44,0,0,0,0,0,0
3,201392388,2170660915,0,0,2024-10-04 19:23:44,0,84,84,0,1,1
3,201392388,2170660915,54421,36895,2024-10-04 19:23:44,0,0,0,0,0,0
3,201392388,2170660915,64660,36895,2024-10-04 19:23:45,0,0,0,0,0,0
3,201392388,2170660915,25287,36895,2024-10-04 19:23:45,0,0,0,0,0,0
3,201392388,2170660915,0,0,2024-10-04 19:23:45,128,84,212,1,1,2
3,201392388,2170660915,54421,36895,2024-10-04 19:23:45,0,0,0,0,0,0
3,201392388,2170660915,25287,36895,2024-10-04 19:23:46,0,0,0,0,0,0
3,201392388,2170660915,0,0,2024-10-04 19:23:46,128,84,212,1,1,2
3,201392388,2170660915,54421,36895,2024-10-04 19:23:46,0,0,0,0,0,0
3,201392388,1145490690,32997,47873,2024-10-04 19:23:47,2316,17941,20257,15,21,36
3,201392388,2170660915,25287,36895,2024-10-04 19:23:47,0,0,0,0,0,0
3,201392388,2170660915,0,0,2024-10-04 19:23:47,128,84,212,1,1,2
3,201392388,2170660915,54421,36895,2024-10-04 19:23:47,0,0,0,0,0,0
3,201392388,1145490690,32997,47873,2024-10-04 19:23:48,3156,75298,78454,31,50,81
3,201392388,2170660915,25287,36895,2024-10-04 19:23:48,0,0,0,0,0,0
3,201392388,2170660915,0,0,2024-10-04 19:23:48,0,0,0,0,0,0
3,201392388,2170660915,54421,36895,2024-10-04 19:23:48,0,0,0,0,0,0
3,201392388,1145490690,32997,47873,2024-10-04 19:23:49,0,0,0,0,0,0
3,201392388,2170660915,25287,36895,2024-10-04 19:23:49,0,0,0,0,0,0
3,201392388,2170660915,0,0,2024-10-04 19:23:49,0,0,0,0,0,0
3,201392388,2170660915,54421,36895,2024-10-04 19:23:49,0,0,0,0,0,0
3,201392388,1145490690,32997,47873,2024-10-04 19:23:50,0,0,0,0,0,0
3,201392388,2170660915,25287,36895,2024-10-04 19:23:50,0,0,0,0,0,0
3,201392388,2170660915,0,0,2024-10-04 19:23:50,0,0,0,0,0,0
3,201392388,2170660915,54421,36895,2024-10-04 19:23:50,0,0,0,0,0,0
3,201392388,1145490690,32997,47873,2024-10-04 19:23:51,0,0,0,0,0,0
3,201392388,2170660915,25287,36895,2024-10-04 19:23:51,0,0,0,0,0,0
3,201392388,2170660915,0,0,2024-10-04 19:23:51,0,0,0,0,0,0
3,201392388,2170660915,54421,36895,2024-10-04 19:23:51,0,0,0,0,0,0
3,201392388,1145490690,32997,47873,2024-10-04 19:23:52,0,0,0,0,0,0
3,201392388,2170660915,25287,36895,2024-10-04 19:23:52,0,0,0,0,0,0
3,201392388,2170660915,0,0,2024-10-04 19:23:52,0,0,0,0,0,0
3,201392388,2170660915,54421,36895,2024-10-04 19:23:52,0,0,0,0,0,0
3,201392388,1145490690,32997,47873,2024-10-04 19:23:53,0,0,0,0,0,0
3,201392388,2170660915,25287,36895,2024-10-04 19:23:53,0,0,0,0,0,0
3,201392388,2170660915,0,0,2024-10-04 19:23:53,0,0,0,0,0,0
3,201392388,2170660915,54421,36895,2024-10-04 19:23:53,0,0,0,0,0,0
3,201392388,1145490690,32997,47873,2024-10-04 19:23:54,0,0,0,0,0,0
3,201392388,2170660915,25287,36895,2024-10-04 19:23:54,0,0,0,0,0,0
3,201392388,2170660915,0,0,2024-10-04 19:23:54,0,0,0,0,0,0
3,201392388,2170660915,54421,36895,2024-10-04 19:23:54,0,0,0,0,0,0
3,201392388,1145490690,32997,47873,2024-10-04 19:23:55,0,0,0,0,0,0
3,201392388,2170660915,25287,36895,2024-10-04 19:23:55,0,0,0,0,0,0
3,201392388,2170660915,0,0,2024-10-04 19:23:55,0,0,0,0,0,0
3,201392388,2170660915,54421,36895,2024-10-04 19:23:55,0,0,0,0,0,0
3,201392388,1145490690,32997,47873,2024-10-04 19:23:56,0,0,0,0,0,0
3,201392388,2170660915,25287,36895,2024-10-04 19:23:56,0,0,0,0,0,0
3,201392388,2170660915,0,0,2024-10-04 19:23:56,0,0,0,0,0,0
3,201392388,2170660915,54421,36895,2024-10-04 19:23:56,0,0,0,0,0,0
3,201392388,1145490690,32997,47873,2024-10-04 19:23:57,612,3977,4589,6,5,11
3,201392388,2170660915,25287,36895,2024-10-04 19:23:57,0,0,0,0,0,0
3,201392388,2170660915,0,0,2024-10-04 19:23:57,0,0,0,0,0,0
3,201392388,2170660915,54421,36895,2024-10-04 19:23:57,0,0,0,0,0,0
3,201392388,1145490690,32997,47873,2024-10-04 19:23:58,0,0,0,0,0,0
3,201392388,2170660915,25287,36895,2024-10-04 19:23:58,0,0,0,0,0,0
3,201392388,2170660915,0,0,2024-10-04 19:23:58,0,0,0,0,0,0
3,201392388,2170660915,54421,36895,2024-10-04 19:23:58,0,0,0,0,0,0
3,201392388,1145490690,32997,47873,2024-10-04 19:23:59,0,0,0,0,0,0
3,201392388,2170660915,25287,36895,2024-10-04 19:23:59,0,0,0,0,0,0
3,201392388,2170660915,0,0,2024-10-04 19:23:59,128,84,212,1,1,2
3,201392388,2170660915,54421,36895,2024-10-04 19:23:59,0,0,0,0,0,0
3,201392388,1145490690,32997,47873,2024-10-04 19:24:00,0,0,0,0,0,0
3,201392388,2170660915,25287,36895,2024-10-04 19:24:00,0,0,0,0,0,0
3,201392388,2170660915,0,0,2024-10-04 19:24:00,128,84,212,1,1,2
3,201392388,2170660915,54421,36895,2024-10-04 19:24:00,0,0,0,0,0,0
3,201392388,1145490690,32997,47873,2024-10-04 19:24:01,0,0,0,0,0,0
3,201392388,2170660915,25287,36895,2024-10-04 19:24:01,0,0,0,0,0,0
3,201392388,2170660915,0,0,2024-10-04 19:24:01,128,84,212,1,1,2
3,201392388,2170660915,54421,36895,2024-10-04 19:24:01,0,0,0,0,0,0
3,201392388,1145490690,32997,47873,2024-10-04 19:24:02,0,0,0,0,0,0
3,201392388,2170660915,25287,36895,2024-10-04 19:24:02,0,0,0,0,0,0
3,201392388,2170660915,0,0,2024-10-04 19:24:02,128,84,212,1,1,2
3,201392388,2170660915,54421,36895,2024-10-04 19:24:02,0,0,0,0,0,0
3,201392388,1145490690,32997,47873,2024-10-04 19:24:03,0,0,0,0,0,0
3,201392388,2170660915,25287,36895,2024-10-04 19:24:03,0,0,0,0,0,0
3,201392388,2170660915,0,0,2024-10-04 19:24:03,128,84,212,1,1,2
3,201392388,2170660915,54421,36895,2024-10-04 19:24:03,0,0,0,0,0,0
3,201392388,1145490690,32997,47873,2024-10-04 19:24:04,0,0,0,0,0,0
3,201392388,2170660915,25287,36895,2024-10-04 19:24:04,0,0,0,0,0,0
3,201392388,2170660915,0,0,2024-10-04 19:24:04,128,84,212,1,1,2
3,201392388,2170660915,54421,36895,2024-10-04 19:24:04,0,0,0,0,0,0
3,201392388,1145490690,32997,47873,2024-10-04 19:24:05,0,0,0,0,0,0
3,201392388,2170660915,25287,36895,2024-10-04 19:24:05,0,0,0,0,0,0
3,201392388,2170660915,0,0,2024-10-04 19:24:05,128,84,212,1,1,2
3,201392388,2170660915,54421,36895,2024-10-04 19:24:05,0,0,0,0,0,0
3,201392388,1145490690,32997,47873,2024-10-04 19:24:06,0,0,0,0,0,0
3,201392388,2170660915,25287,36895,2024-10-04 19:24:06,0,0,0,0,0,0
3,201392388,2170660915,0,0,2024-10-04 19:24:06,128,84,212,1,1,2
3,201392388,2170660915,54421,36895,2024-10-04 19:24:06,0,0,0,0,0,0
3,201392388,2170660915,25287,36895,2024-10-04 19:24:07,0,0,0,0,0,0
3,201392388,2170660915,0,0,2024-10-04 19:24:07,128,84,212,1,1,2
3,201392388,2170660915,54421,36895,2024-10-04 19:24:07,0,0,0,0,0,0
3,201392388,2170660915,25287,36895,2024-10-04 19:24:08,0,0,0,0,0,0
3,201392388,2170660915,0,0,2024-10-04 19:24:08,128,84,212,1,1,2
3,201392388,2170660915,54421,36895,2024-10-04 19:24:08,0,0,0,0,0,0
3,201392388,2170660915,25287,36895,2024-10-04 19:24:09,0,0,0,0,0,0
3,201392388,2170660915,0,0,2024-10-04 19:24:09,0,0,0,0,0,0
3,201392388,2170660915,54421,36895,2024-10-04 19:24:09,0,0,0,0,0,0
3,201392388,2170660915,50866,36895,2024-10-04 19:24:10,666,507,1173,6,6,12
3,201392388,2170660915,0,0,2024-10-04 19:24:10,128,0,128,1,0,1
3,201392388,2170660915,50866,36895,2024-10-04 19:24:11,0,0,0,0,0,0
3,201392388,2170660915,0,0,2024-10-04 19:24:11,128,84,212,1,1,2
3,201392388,2170660915,50866,36895,2024-10-04 19:24:12,0,0,0,0,0,0
3,201392388,2170660915,0,0,2024-10-04 19:24:12,128,84,212,1,1,2
3,201392388,2170660915,50866,36895,2024-10-04 19:24:13,0,0,0,0,0,0
3,201392388,2170660915,0,0,2024-10-04 19:24:13,0,0,0,0,0,0
3,201392388,2170660915,50866,36895,2024-10-04 19:24:14,0,0,0,0,0,0
3,201392388,2170660915,0,0,2024-10-04 19:24:14,0,0,0,0,0,0
3,201392388,2170660915,50866,36895,2024-10-04 19:24:15,0,0,0,0,0,0
3,201392388,2170660915,0,0,2024-10-04 19:24:15,0,84,84,0,1,1
3,201392388,2170660915,50866,36895,2024-10-04 19:24:16,0,0,0,0,0,0
3,201392388,2170660915,0,0,2024-10-04 19:24:16,0,0,0,0,0,0
3,201392388,2170660915,50866,36895,2024-10-04 19:24:17,0,0,0,0,0,0
3,201392388,2170660915,0,0,2024-10-04 19:24:17,256,168,424,2,2,4
3,201392388,1145490692,26268,47873,2024-10-04 19:24:18,2712,27075,29787,19,27,46
3,201392388,2170660915,50866,36895,2024-10-04 19:24:18,0,0,0,0,0,0
3,201392388,2170660915,0,0,2024-10-04 19:24:18,128,84,212,1,1,2
3,201392388,1145490692,26268,47873,2024-10-04 19:24:19,0,0,0,0,0,0
3,201392388,2170660915,50866,36895,2024-10-04 19:24:19,0,0,0,0,0,0
3,201392388,2170660915,0,0,2024-10-04 19:24:19,0,0,0,0,0,0
3,201392388,1145490692,26268,47873,2024-10-04 19:24:20,0,0,0,0,0,0
3,201392388,2170660915,50866,36895,2024-10-04 19:24:20,0,0,0,0,0,0
3,201392388,2170660915,0,0,2024-10-04 19:24:20,0,0,0,0,0,0
3,201392388,1145490692,26268,47873,2024-10-04 19:24:21,0,0,0,0,0,0
3,201392388,2170660915,50866,36895,2024-10-04 19:24:21,0,0,0,0,0,0
3,201392388,2170660915,0,0,2024-10-04 19:24:21,0,0,0,0,0,0
3,201392388,1145490692,26268,47873,2024-10-04 19:24:22,0,0,0,0,0,0
3,201392388,2170660915,50866,36895,2024-10-04 19:24:22,0,0,0,0,0,0
3,201392388,2170660915,0,0,2024-10-04 19:24:22,0,0,0,0,0,0
3,201392388,1145490692,26268,47873,2024-10-04 19:24:23,0,0,0,0,0,0
3,201392388,2170660915,50866,36895,2024-10-04 19:24:23,0,0,0,0,0,0
3,201392388,2170660915,0,0,2024-10-04 19:24:23,0,0,0,0,0,0
3,201392388,1145490692,26268,47873,2024-10-04 19:24:24,0,0,0,0,0,0
3,201392388,2170660915,50866,36895,2024-10-04 19:24:24,0,0,0,0,0,0
3,201392388,2170660915,0,0,2024-10-04 19:24:24,0,0,0,0,0,0
3,201392388,1145490692,26268,47873,2024-10-04 19:24:25,0,0,0,0,0,0
3,201392388,2170660915,50866,36895,2024-10-04 19:24:25,0,0,0,0,0,0
3,201392388,2170660915,0,0,2024-10-04 19:24:25,0,0,0,0,0,0
3,201392388,1145490692,26268,47873,2024-10-04 19:24:26,0,0,0,0,0,0
3,201392388,2170660915,50866,36895,2024-10-04 19:24:26,0,0,0,0,0,0
3,201392388,2170660915,0,0,2024-10-04 19:24:26,0,0,0,0,0,0
3,201392388,1145490692,26268,47873,2024-10-04 19:24:27,0,0,0,0,0,0
3,201392388,2170660915,50866,36895,2024-10-04 19:24:27,0,0,0,0,0,0
3,201392388,2170660915,0,0,2024-10-04 19:24:27,0,0,0,0,0,0
3,201392388,1145490692,26268,47873,2024-10-04 19:24:28,3168,74261,77429,31,52,83
3,201392388,2170660915,50866,36895,2024-10-04 19:24:28,0,0,0,0,0,0
3,201392388,2170660915,0,0,2024-10-04 19:24:28,128,0,128,1,0,1
3,201392388,1145490692,26268,47873,2024-10-04 19:24:29,0,0,0,0,0,0
3,201392388,2170660915,50866,36895,2024-10-04 19:24:29,0,0,0,0,0,0
3,201392388,2170660915,0,0,2024-10-04 19:24:29,128,84,212,1,1,2
3,201392388,1145490692,26268,47873,2024-10-04 19:24:30,0,0,0,0,0,0
3,201392388,2170660915,50866,36895,2024-10-04 19:24:30,0,0,0,0,0,0
3,201392388,2170660915,0,0,2024-10-04 19:24:30,128,84,212,1,1,2
3,201392388,1145490692,26268,47873,2024-10-04 19:24:31,0,0,0,0,0,0
3,201392388,2170660915,50866,36895,2024-10-04 19:24:31,0,0,0,0,0,0
3,201392388,2170660915,0,0,2024-10-04 19:24:31,128,84,212,1,1,2
3,201392388,1145490692,26268,47873,2024-10-04 19:24:32,0,0,0,0,0,0
3,201392388,2170660915,50866,36895,2024-10-04 19:24:32,0,0,0,0,0,0
3,201392388,2170660915,0,0,2024-10-04 19:24:32,128,84,212,1,1,2
3,201392388,1145490692,26268,47873,2024-10-04 19:24:33,0,0,0,0,0,0
3,201392388,2170660915,50866,36895,2024-10-04 19:24:33,0,0,0,0,0,0
3,201392388,2170660915,0,0,2024-10-04 19:24:33,128,84,212,1,1,2
3,201392388,1145490692,26268,47873,2024-10-04 19:24:34,0,0,0,0,0,0
3,201392388,2170660915,50866,36895,2024-10-04 19:24:34,0,0,0,0,0,0
3,201392388,2170660915,0,0,2024-10-04 19:24:34,128,84,212,1,1,2
3,201392388,1145490692,26268,47873,2024-10-04 19:24:35,0,0,0,0,0,0
3,201392388,2170660915,50866,36895,2024-10-04 19:24:35,0,0,0,0,0,0
3,201392388,2170660915,0,0,2024-10-04 19:24:35,128,84,212,1,1,2
3,201392388,1145490692,26268,47873,2024-10-04 19:24:36,0,0,0,0,0,0
3,201392388,2170660915,50866,36895,2024-10-04 19:24:36,0,0,0,0,0,0
3,201392388,2170660915,0,0,2024-10-04 19:24:36,128,84,212,1,1,2
3,201392388,1145490692,26268,47873,2024-10-04 19:24:37,0,0,0,0,0,0
3,201392388,2170660915,50866,36895,2024-10-04 19:24:37,0,0,0,0,0,0
3,201392388,2170660915,0,0,2024-10-04 19:24:37,128,84,212,1,1,2
3,201392388,1145490692,26268,47873,2024-10-04 19:24:38,0,0,0,0,0,0
3,201392388,2170660915,50866,36895,2024-10-04 19:24:38,0,0,0,0,0,0
3,201392388,2170660915,0,0,2024-10-04 19:24:38,0,84,84,0,1,1
3,201392388,2170660915,50866,36895,2024-10-04 19:24:39,0,0,0,0,0,0
3,201392388,2170660915,0,0,2024-10-04 19:24:39,0,0,0,0,0,0
3,201392388,2170660915,58003,36895,2024-10-04 19:24:39,570,455,1025,5,5,10
3,201392388,2170660915,50866,36895,2024-10-04 19:24:40,0,0,0,0,0,0
3,201392388,2170660915,0,0,2024-10-04 19:24:40,0,0,0,0,0,0
3,201392388,2170660915,58003,36895,2024-10-04 19:24:40,0,0,0,0,0,0
3,201392388,2170660915,0,0,2024-10-04 19:24:41,128,84,212,1,1,2
3,201392388,2170660915,58003,36895,2024-10-04 19:24:41,0,0,0,0,0,0
3,201392388,2170660915,0,0,2024-10-04 19:24:42,128,84,212,1,1,2
3,201392388,2170660915,58003,36895,2024-10-04 19:24:42,0,0,0,0,0,0
3,201392388,2170660915,0,0,2024-10-04 19:24:43,128,84,212,1,1,2
3,201392388,2170660915,58003,36895,2024-10-04 19:24:43,0,0,0,0,0,0
3,201392388,2170660915,0,0,2024-10-04 19:24:44,0,0,0,0,0,0
3,201392388,2170660915,58003,36895,2024-10-04 19:24:44,0,0,0,0,0,0
3,201392388,2170660915,0,0,2024-10-04 19:24:45,0,0,0,0,0,0
3,201392388,2170660915,58003,36895,2024-10-04 19:24:45,0,0,0,0,0,0
3,201392388,2170660915,0,0,2024-10-04 19:24:46,128,0,128,1,0,1
3,201392388,2170660915,58003,36895,2024-10-04 19:24:46,0,0,0,0,0,0
3,201392388,2170660915,0,0,2024-10-04 19:24:47,128,84,212,1,1,2
3,201392388,2170660915,58003,36895,2024-10-04 19:24:47,0,0,0,0,0,0
3,201392388,1145490689,23738,47873,2024-10-04 19:24:48,3384,37629,41013,25,34,59
3,201392388,2170660915,0,0,2024-10-04 19:24:48,128,168,296,1,2,3
3,201392388,2170660915,58003,36895,2024-10-04 19:24:48,0,0,0,0,0,0
3,201392388,1145490689,23738,47873,2024-10-04 19:24:49,0,0,0,0,0,0
3,201392388,2170660915,0,0,2024-10-04 19:24:49,0,0,0,0,0,0
3,201392388,2170660915,58003,36895,2024-10-04 19:24:49,0,0,0,0,0,0
3,201392388,1145490689,23738,47873,2024-10-04 19:24:50,0,0,0,0,0,0
3,201392388,2170660915,0,0,2024-10-04 19:24:50,0,0,0,0,0,0
3,201392388,2170660915,58003,36895,2024-10-04 19:24:50,0,0,0,0,0,0
3,201392388,1145490689,23738,47873,2024-10-04 19:24:51,0,0,0,0,0,0
3,201392388,2170660915,0,0,2024-10-04 19:24:51,0,0,0,0,0,0
3,201392388,2170660915,58003,36895,2024-10-04 19:24:51,0,0,0,0,0,0
3,201392388,1145490689,23738,47873,2024-10-04 19:24:52,0,0,0,0,0,0
3,201392388,2170660915,0,0,2024-10-04 19:24:52,0,0,0,0,0,0
3,201392388,2170660915,58003,36895,2024-10-04 19:24:52,0,0,0,0,0,0
3,201392388,1145490689,23738,47873,2024-10-04 19:24:53,0,0,0,0,0,0
3,201392388,2170660915,0,0,2024-10-04 19:24:53,0,0,0,0,0,0
3,201392388,2170660915,58003,36895,2024-10-04 19:24:53,0,0,0,0,0,0
3,201392388,1145490689,23738,47873,2024-10-04 19:24:54,0,0,0,0,0,0
3,201392388,2170660915,0,0,2024-10-04 19:24:54,0,0,0,0,0,0
3,201392388,2170660915,58003,36895,2024-10-04 19:24:54,0,0,0,0,0,0
3,201392388,1145490689,23738,47873,2024-10-04 19:24:55,0,0,0,0,0,0
3,201392388,2170660915,0,0,2024-10-04 19:24:55,0,0,0,0,0,0
3,201392388,2170660915,58003,36895,2024-10-04 19:24:55,0,0,0,0,0,0
3,201392388,1145490689,23738,47873,2024-10-04 19:24:56,0,0,0,0,0,0
3,201392388,2170660915,0,0,2024-10-04 19:24:56,0,0,0,0,0,0
3,201392388,2170660915,58003,36895,2024-10-04 19:24:56,0,0,0,0,0,0
3,201392388,1145490689,23738,47873,2024-10-04 19:24:57,0,0,0,0,0,0
3,201392388,2170660915,0,0,2024-10-04 19:24:57,0,0,0,0,0,0
3,201392388,2170660915,58003,36895,2024-10-04 19:24:57,0,0,0,0,0,0
3,201392388,1145490689,23738,47873,2024-10-04 19:24:58,0,0,0,0,0,0
3,201392388,2170660915,0,0,2024-10-04 19:24:58,0,0,0,0,0,0
3,201392388,2170660915,58003,36895,2024-10-04 19:24:58,0,0,0,0,0,0
3,201392388,1145490689,23738,47873,2024-10-04 19:24:59,3156,59639,62795,31,43,74
3,201392388,2170660915,0,0,2024-10-04 19:24:59,128,0,128,1,0,1
3,201392388,2170660915,58003,36895,2024-10-04 19:24:59,0,0,0,0,0,0
3,201392388,1145490689,23738,47873,2024-10-04 19:25:00,0,0,0,0,0,0
3,201392388,2170660915,0,0,2024-10-04 19:25:00,128,84,212,1,1,2
3,201392388,2170660915,58003,36895,2024-10-04 19:25:00,0,0,0,0,0,0
3,201392388,1145490689,23738,47873,2024-10-04 19:25:01,0,0,0,0,0,0
3,201392388,2170660915,0,0,2024-10-04 19:25:01,128,84,212,1,1,2
3,201392388,2170660915,58003,36895,2024-10-04 19:25:01,0,0,0,0,0,0
3,201392388,1145490689,23738,47873,2024-10-04 19:25:02,0,0,0,0,0,0
3,201392388,2170660915,0,0,2024-10-04 19:25:02,128,84,212,1,1,2
3,201392388,2170660915,58003,36895,2024-10-04 19:25:02,0,0,0,0,0,0
3,201392388,1145490689,23738,47873,2024-10-04 19:25:03,0,0,0,0,0,0
3,201392388,2170660915,0,0,2024-10-04 19:25:03,128,84,212,1,1,2
3,201392388,2170660915,58003,36895,2024-10-04 19:25:03,0,0,0,0,0,0
3,201392388,1145490689,23738,47873,2024-10-04 19:25:04,0,0,0,0,0,0
3,201392388,2170660915,0,0,2024-10-04 19:25:04,128,84,212,1,1,2
3,201392388,2170660915,58003,36895,2024-10-04 19:25:04,0,0,0,0,0,0
3,201392388,1145490689,23738,47873,2024-10-04 19:25:05,0,0,0,0,0,0
3,201392388,2170660915,0,0,2024-10-04 19:25:05,128,84,212,1,1,2
3,201392388,2170660915,58003,36895,2024-10-04 19:25:05,0,0,0,0,0,0
3,201392388,1145490689,23738,47873,2024-10-04 19:25:06,0,0,0,0,0,0
3,201392388,2170660915,0,0,2024-10-04 19:25:06,128,84,212,1,1,2
3,201392388,2170660915,58003,36895,2024-10-04 19:25:06,0,0,0,0,0,0
3,201392388,1145490689,23738,47873,2024-10-04 19:25:07,0,0,0,0,0,0
3,201392388,2170660915,0,0,2024-10-04 19:25:07,128,84,212,1,1,2
3,201392388,2170660915,58003,36895,2024-10-04 19:25:07,0,0,0,0,0,0
3,201392388,1145490689,23738,47873,2024-10-04 19:25:08,0,0,0,0,0,0
3,201392388,2170660915,0,0,2024-10-04 19:25:08,128,84,212,1,1,2
3,201392388,2170660915,58003,36895,2024-10-04 19:25:08,0,0,0,0,0,0
3,201392388,2170660915,59568,36895,2024-10-04 19:25:09,666,507,1173,6,6,12
3,201392388,2170660915,0,0,2024-10-04 19:25:09,0,84,84,0,1,1
3,201392388,2170660915,58003,36895,2024-10-04 19:25:09,0,0,0,0,0,0
3,201392388,2170660915,59568,36895,2024-10-04 19:25:10,0,0,0,0,0,0
3,201392388,2170660915,0,0,2024-10-04 19:25:10,0,0,0,0,0,0
3,201392388,2170660915,58003,36895,2024-10-04 19:25:10,0,0,0,0,0,0
3,201392388,2170660915,59568,36895,2024-10-04 19:25:11,0,0,0,0,0,0
3,201392388,2170660915,0,0,2024-10-04 19:25:11,128,84,212,1,1,2
3,201392388,2170660915,58003,36895,2024-10-04 19:25:11,0,0,0,0,0,0
3,201392388,2170660915,59568,36895,2024-10-04 19:25:12,0,0,0,0,0,0
3,201392388,2170660915,0,0,2024-10-04 19:25:12,128,84,212,1,1,2
3,201392388,2170660915,58003,36895,2024-10-04 19:25:12,0,0,0,0,0,0
3,201392388,2170660915,59568,36895,2024-10-04 19:25:13,0,0,0,0,0,0
3,201392388,2170660915,0,0,2024-10-04 19:25:13,128,84,212,1,1,2
3,201392388,2170660915,58003,36895,2024-10-04 19:25:13,0,0,0,0,0,0
3,201392388,2170660915,59568,36895,2024-10-04 19:25:14,0,0,0,0,0,0
3,201392388,2170660915,0,0,2024-10-04 19:25:14,0,0,0,0,0,0
3,201392388,2170660915,58003,36895,2024-10-04 19:25:14,0,0,0,0,0,0
3,201392388,2170660915,59568,36895,2024-10-04 19:25:15,0,0,0,0,0,0
3,201392388,2170660915,0,0,2024-10-04 19:25:15,0,0,0,0,0,0
3,201392388,2170660915,58003,36895,2024-10-04 19:25:15,0,0,0,0,0,0
3,201392388,2170660915,59568,36895,2024-10-04 19:25:16,0,0,0,0,0,0
3,201392388,2170660915,0,0,2024-10-04 19:25:16,128,84,212,1,1,2
3,201392388,2170660915,58003,36895,2024-10-04 19:25:16,0,0,0,0,0,0
3,201392388,2170660915,59568,36895,2024-10-04 19:25:17,0,0,0,0,0,0
3,201392388,2170660915,0,0,2024-10-04 19:25:17,128,84,212,1,1,2
3,201392388,2170660915,58003,36895,2024-10-04 19:25:17,0,0,0,0,0,0
3,201392388,1145490692,6877,47873,2024-10-04 19:25:18,3176,42311,45487,23,36,59
3,201392388,2170660915,59568,36895,2024-10-04 19:25:18,0,0,0,0,0,0
3,201392388,2170660915,0,0,2024-10-04 19:25:18,128,84,212,1,1,2
3,201392388,2170660915,58003,36895,2024-10-04 19:25:18,0,0,0,0,0,0
3,201392388,1145490692,6877,47873,2024-10-04 19:25:19,1728,46284,48012,17,30,47
3,201392388,2170660915,59568,36895,2024-10-04 19:25:19,0,0,0,0,0,0
3,201392388,2170660915,0,0,2024-10-04 19:25:19,0,0,0,0,0,0
3,201392388,2170660915,58003,36895,2024-10-04 19:25:19,0,0,0,0,0,0
3,201392388,1145490692,6877,47873,2024-10-04 19:25:20,0,0,0,0,0,0
3,201392388,2170660915,59568,36895,2024-10-04 19:25:20,0,0,0,0,0,0
3,201392388,2170660915,0,0,2024-10-04 19:25:20,0,0,0,0,0,0
3,201392388,2170660915,58003,36895,2024-10-04 19:25:20,0,0,0,0,0,0
3,201392388,1145490692,6877,47873,2024-10-04 19:25:21,0,0,0,0,0,0
3,201392388,2170660915,59568,36895,2024-10-04 19:25:21,0,0,0,0,0,0
3,201392388,2170660915,0,0,2024-10-04 19:25:21,0,0,0,0,0,0
3,201392388,2170660915,58003,36895,2024-10-04 19:25:21,0,0,0,0,0,0
3,201392388,1145490692,6877,47873,2024-10-04 19:25:22,0,0,0,0,0,0
3,201392388,2170660915,59568,36895,2024-10-04 19:25:22,0,0,0,0,0,0
3,201392388,2170660915,0,0,2024-10-04 19:25:22,0,0,0,0,0,0
3,201392388,2170660915,58003,36895,2024-10-04 19:25:22,0,0,0,0,0,0
3,201392388,1145490692,6877,47873,2024-10-04 19:25:23,0,0,0,0,0,0
3,201392388,2170660915,59568,36895,2024-10-04 19:25:23,0,0,0,0,0,0
3,201392388,2170660915,0,0,2024-10-04 19:25:23,0,0,0,0,0,0
3,201392388,2170660915,58003,36895,2024-10-04 19:25:23,0,0,0,0,0,0
3,201392388,1145490692,6877,47873,2024-10-04 19:25:24,0,0,0,0,0,0
3,201392388,2170660915,59568,36895,2024-10-04 19:25:24,0,0,0,0,0,0
3,201392388,2170660915,0,0,2024-10-04 19:25:24,0,0,0,0,0,0
3,201392388,2170660915,58003,36895,2024-10-04 19:25:24,0,0,0,0,0,0
3,201392388,1145490692,6877,47873,2024-10-04 19:25:25,0,0,0,0,0,0
3,201392388,2170660915,59568,36895,2024-10-04 19:25:25,0,0,0,0,0,0
3,201392388,2170660915,0,0,2024-10-04 19:25:25,0,0,0,0,0,0
3,201392388,2170660915,58003,36895,2024-10-04 19:25:25,0,0,0,0,0,0
3,201392388,1145490692,6877,47873,2024-10-04 19:25:26,0,0,0,0,0,0
3,201392388,2170660915,59568,36895,2024-10-04 19:25:26,0,0,0,0,0,0
3,201392388,2170660915,0,0,2024-10-04 19:25:26,0,0,0,0,0,0
3,201392388,2170660915,58003,36895,2024-10-04 19:25:26,0,0,0,0,0,0
3,201392388,1145490692,6877,47873,2024-10-04 19:25:27,0,0,0,0,0,0
3,201392388,2170660915,59568,36895,2024-10-04 19:25:27,0,0,0,0,0,0
3,201392388,2170660915,0,0,2024-10-04 19:25:27,0,0,0,0,0,0
3,201392388,2170660915,58003,36895,2024-10-04 19:25:27,0,0,0,0,0,0
3,201392388,1145490692,6877,47873,2024-10-04 19:25:28,0,0,0,0,0,0
3,201392388,2170660915,59568,36895,2024-10-04 19:25:28,0,0,0,0,0,0
3,201392388,2170660915,0,0,2024-10-04 19:25:28,0,0,0,0,0,0
3,201392388,2170660915,58003,36895,2024-10-04 19:25:28,0,0,0,0,0,0
3,201392388,1145490692,6877,47873,2024-10-04 19:25:29,1224,20773,21997,12,15,27
3,201392388,2170660915,59568,36895,2024-10-04 19:25:29,0,0,0,0,0,0
3,201392388,2170660915,0,0,2024-10-04 19:25:29,0,0,0,0,0,0
3,201392388,2170660915,58003,36895,2024-10-04 19:25:29,0,0,0,0,0,0
3,201392388,1145490692,6877,47873,2024-10-04 19:25:30,0,0,0,0,0,0
3,201392388,2170660915,59568,36895,2024-10-04 19:25:30,0,0,0,0,0,0
3,201392388,2170660915,0,0,2024-10-04 19:25:30,128,84,212,1,1,2
3,201392388,2170660915,58003,36895,2024-10-04 19:25:30,0,0,0,0,0,0
3,201392388,1145490692,6877,47873,2024-10-04 19:25:31,0,0,0,0,0,0
3,201392388,2170660915,59568,36895,2024-10-04 19:25:31,0,0,0,0,0,0
3,201392388,2170660915,0,0,2024-10-04 19:25:31,128,84,212,1,1,2
3,201392388,2170660915,58003,36895,2024-10-04 19:25:31,0,0,0,0,0,0
3,201392388,1145490692,6877,47873,2024-10-04 19:25:32,0,0,0,0,0,0
3,201392388,2170660915,59568,36895,2024-10-04 19:25:32,0,0,0,0,0,0
3,201392388,2170660915,0,0,2024-10-04 19:25:32,128,84,212,1,1,2
3,201392388,2170660915,58003,36895,2024-10-04 19:25:32,0,0,0,0,0,0
3,201392388,1145490692,6877,47873,2024-10-04 19:25:33,0,0,0,0,0,0
3,201392388,2170660915,59568,36895,2024-10-04 19:25:33,0,0,0,0,0,0
3,201392388,2170660915,0,0,2024-10-04 19:25:33,128,84,212,1,1,2
3,201392388,2170660915,58003,36895,2024-10-04 19:25:33,0,0,0,0,0,0
3,201392388,1145490692,6877,47873,2024-10-04 19:25:34,0,0,0,0,0,0
3,201392388,2170660915,59568,36895,2024-10-04 19:25:34,0,0,0,0,0,0
3,201392388,2170660915,0,0,2024-10-04 19:25:34,128,84,212,1,1,2
3,201392388,2170660915,58003,36895,2024-10-04 19:25:34,0,0,0,0,0,0
3,201392388,1145490692,6877,47873,2024-10-04 19:25:35,0,0,0,0,0,0
3,201392388,2170660915,59568,36895,2024-10-04 19:25:35,0,0,0,0,0,0
3,201392388,2170660915,0,0,2024-10-04 19:25:35,128,84,212,1,1,2
3,201392388,2170660915,58003,36895,2024-10-04 19:25:35,0,0,0,0,0,0
3,201392388,1145490692,6877,47873,2024-10-04 19:25:36,0,0,0,0,0,0
3,201392388,2170660915,59568,36895,2024-10-04 19:25:36,0,0,0,0,0,0
3,201392388,2170660915,0,0,2024-10-04 19:25:36,128,84,212,1,1,2
3,201392388,2170660915,58003,36895,2024-10-04 19:25:36,0,0,0,0,0,0
3,201392388,1145490692,6877,47873,2024-10-04 19:25:37,0,0,0,0,0,0
3,201392388,2170660915,59568,36895,2024-10-04 19:25:37,0,0,0,0,0,0
3,201392388,2170660915,0,0,2024-10-04 19:25:37,128,84,212,1,1,2
3,201392388,2170660915,58003,36895,2024-10-04 19:25:37,0,0,0,0,0,0
3,201392388,1145490692,6877,47873,2024-10-04 19:25:38,0,0,0,0,0,0
3,201392388,2170660915,59568,36895,2024-10-04 19:25:38,0,0,0,0,0,0
3,201392388,2170660915,0,0,2024-10-04 19:25:38,128,84,212,1,1,2
3,201392388,2170660915,58003,36895,2024-10-04 19:25:38,0,0,0,0,0,0
3,201392388,1145490692,6877,47873,2024-10-04 19:25:39,0,0,0,0,0,0
3,201392388,2170660915,59568,36895,2024-10-04 19:25:39,0,0,0,0,0,0
3,201392388,2170660915,0,0,2024-10-04 19:25:39,128,84,212,1,1,2
3,201392388,2170660915,58003,36895,2024-10-04 19:25:39,0,0,0,0,0,0
3,201392388,2170660915,59568,36895,2024-10-04 19:25:40,0,0,0,0,0,0
3,201392388,2170660915,0,0,2024-10-04 19:25:40,0,0,0,0,0,0
3,201392388,2170660915,21726,36895,2024-10-04 19:25:40,666,507,1173,6,6,12
3,201392388,2170660915,58003,36895,2024-10-04 19:25:40,0,0,0,0,0,0
3,201392388,2170660915,59568,36895,2024-10-04 19:25:41,0,0,0,0,0,0
3,201392388,2170660915,0,0,2024-10-04 19:25:41,0,0,0,0,0,0
3,201392388,2170660915,21726,36895,2024-10-04 19:25:41,0,0,0,0,0,0
3,201392388,2170660915,58003,36895,2024-10-04 19:25:41,0,0,0,0,0,0
3,201392388,2170660915,0,0,2024-10-04 19:25:42,128,84,212,1,1,2
3,201392388,2170660915,21726,36895,2024-10-04 19:25:42,0,0,0,0,0,0
3,201392388,2170660915,58003,36895,2024-10-04 19:25:42,0,0,0,0,0,0
3,201392388,2170660915,0,0,2024-10-04 19:25:43,128,84,212,1,1,2
3,201392388,2170660915,21726,36895,2024-10-04 19:25:43,0,0,0,0,0,0
3,201392388,2170660915,58003,36895,2024-10-04 19:25:43,0,0,0,0,0,0
3,201392388,2170660915,0,0,2024-10-04 19:25:44,128,84,212,1,1,2
3,201392388,2170660915,21726,36895,2024-10-04 19:25:44,0,0,0,0,0,0
3,201392388,2170660915,58003,36895,2024-10-04 19:25:44,0,0,0,0,0,0
3,201392388,2170660915,0,0,2024-10-04 19:25:45,0,0,0,0,0,0
3,201392388,2170660915,21726,36895,2024-10-04 19:25:45,0,0,0,0,0,0
3,201392388,2170660915,58003,36895,2024-10-04 19:25:45,0,0,0,0,0,0
3,201392388,2170660915,0,0,2024-10-04 19:25:46,128,0,128,1,0,1
3,201392388,2170660915,21726,36895,2024-10-04 19:25:46,0,0,0,0,0,0
3,201392388,2170660915,58003,36895,2024-10-04 19:25:46,0,0,0,0,0,0
3,201392388,2170660915,0,0,2024-10-04 19:25:47,0,84,84,0,1,1
3,201392388,2170660915,21726,36895,2024-10-04 19:25:47,0,0,0,0,0,0
3,201392388,2170660915,58003,36895,2024-10-04 19:25:47,0,0,0,0,0,0
3,201392388,2170660915,0,0,2024-10-04 19:25:48,128,84,212,1,1,2
3,201392388,2170660915,21726,36895,2024-10-04 19:25:48,0,0,0,0,0,0
3,201392388,2170660915,58003,36895,2024-10-04 19:25:48,0,0,0,0,0,0
3,201392388,1145490690,15536,47873,2024-10-04 19:25:49,6060,87046,93106,52,71,123
3,201392388,2170660915,0,0,2024-10-04 19:25:49,128,84,212,1,1,2
3,201392388,2170660915,21726,36895,2024-10-04 19:25:49,0,0,0,0,0,0
3,201392388,2170660915,58003,36895,2024-10-04 19:25:49,0,0,0,0,0,0
3,201392388,1145490690,15536,47873,2024-10-04 19:25:50,0,0,0,0,0,0
3,201392388,2170660915,0,0,2024-10-04 19:25:50,0,0,0,0,0,0
3,201392388,2170660915,21726,36895,2024-10-04 19:25:50,0,0,0,0,0,0
3,201392388,2170660915,58003,36895,2024-10-04 19:25:50,0,0,0,0,0,0
3,201392388,1145490690,15536,47873,2024-10-04 19:25:51,0,0,0,0,0,0
3,201392388,2170660915,0,0,2024-10-04 19:25:51,0,0,0,0,0,0
3,201392388,2170660915,21726,36895,2024-10-04 19:25:51,0,0,0,0,0,0
3,201392388,2170660915,58003,36895,2024-10-04 19:25:51,0,0,0,0,0,0
3,201392388,1145490690,15536,47873,2024-10-04 19:25:52,0,0,0,0,0,0
3,201392388,2170660915,0,0,2024-10-04 19:25:52,0,0,0,0,0,0
3,201392388,2170660915,21726,36895,2024-10-04 19:25:52,0,0,0,0,0,0
3,201392388,2170660915,58003,36895,2024-10-04 19:25:52,0,0,0,0,0,0
3,201392388,1145490690,15536,47873,2024-10-04 19:25:53,0,0,0,0,0,0
3,201392388,2170660915,0,0,2024-10-04 19:25:53,0,0,0,0,0,0
3,201392388,2170660915,21726,36895,2024-10-04 19:25:53,0,0,0,0,0,0
3,201392388,2170660915,58003,36895,2024-10-04 19:25:53,0,0,0,0,0,0
3,201392388,1145490690,15536,47873,2024-10-04 19:25:54,0,0,0,0,0,0
3,201392388,2170660915,0,0,2024-10-04 19:25:54,0,0,0,0,0,0
3,201392388,2170660915,21726,36895,2024-10-04 19:25:54,0,0,0,0,0,0
3,201392388,2170660915,58003,36895,2024-10-04 19:25:54,0,0,0,0,0,0
3,201392388,1145490690,15536,47873,2024-10-04 19:25:55,0,0,0,0,0,0
3,201392388,2170660915,0,0,2024-10-04 19:25:55,0,0,0,0,0,0
3,201392388,2170660915,21726,36895,2024-10-04 19:25:55,0,0,0,0,0,0
3,201392388,2170660915,58003,36895,2024-10-04 19:25:55,0,0,0,0,0,0
3,201392388,1145490690,15536,47873,2024-10-04 19:25:56,0,0,0,0,0,0
3,201392388,2170660915,0,0,2024-10-04 19:25:56,0,0,0,0,0,0
3,201392388,2170660915,21726,36895,2024-10-04 19:25:56,0,0,0,0,0,0
3,201392388,2170660915,58003,36895,2024-10-04 19:25:56,0,0,0,0,0,0
3,201392388,1145490690,15536,47873,2024-10-04 19:25:57,0,0,0,0,0,0
3,201392388,2170660915,0,0,2024-10-04 19:25:57,0,0,0,0,0,0
3,201392388,2170660915,21726,36895,2024-10-04 19:25:57,0,0,0,0,0,0
3,201392388,2170660915,58003,36895,2024-10-04 19:25:57,0,0,0,0,0,0
3,201392388,1145490690,15536,47873,2024-10-04 19:25:58,0,0,0,0,0,0
3,201392388,2170660915,0,0,2024-10-04 19:25:58,0,0,0,0,0,0
3,201392388,2170660915,21726,36895,2024-10-04 19:25:58,0,0,0,0,0,0
3,201392388,2170660915,58003,36895,2024-10-04 19:25:58,0,0,0,0,0,0
3,201392388,1145490690,15536,47873,2024-10-04 19:25:59,0,0,0,0,0,0
3,201392388,2170660915,0,0,2024-10-04 19:25:59,0,0,0,0,0,0
3,201392388,2170660915,21726,36895,2024-10-04 19:25:59,0,0,0,0,0,0
3,201392388,2170660915,58003,36895,2024-10-04 19:25:59,0,0,0,0,0,0
3,201392388,1145490690,15536,47873,2024-10-04 19:26:00,0,0,0,0,0,0
3,201392388,2170660915,0,0,2024-10-04 19:26:00,128,84,212,1,1,2
3,201392388,2170660915,21726,36895,2024-10-04 19:26:00,0,0,0,0,0,0
3,201392388,2170660915,58003,36895,2024-10-04 19:26:00,0,0,0,0,0,0
3,201392388,1145490690,15536,47873,2024-10-04 19:26:01,0,0,0,0,0,0
3,201392388,2170660915,0,0,2024-10-04 19:26:01,256,84,340,2,1,3
3,201392388,2170660915,21726,36895,2024-10-04 19:26:01,0,0,0,0,0,0
3,201392388,2170660915,58003,36895,2024-10-04 19:26:01,0,0,0,0,0,0
3,201392388,1145490690,15536,47873,2024-10-04 19:26:02,0,0,0,0,0,0
3,201392388,2170660915,0,0,2024-10-04 19:26:02,128,84,212,1,1,2
3,201392388,2170660915,21726,36895,2024-10-04 19:26:02,0,0,0,0,0,0
3,201392388,2170660915,58003,36895,2024-10-04 19:26:02,0,0,0,0,0,0
3,201392388,1145490690,15536,47873,2024-10-04 19:26:03,0,0,0,0,0,0
3,201392388,2170660915,0,0,2024-10-04 19:26:03,128,84,212,1,1,2
3,201392388,2170660915,21726,36895,2024-10-04 19:26:03,0,0,0,0,0,0
3,201392388,2170660915,58003,36895,2024-10-04 19:26:03,0,0,0,0,0,0
3,201392388,1145490690,15536,47873,2024-10-04 19:26:04,0,0,0,0,0,0
3,201392388,2170660915,0,0,2024-10-04 19:26:04,128,84,212,1,1,2
3,201392388,2170660915,21726,36895,2024-10-04 19:26:04,0,0,0,0,0,0
3,201392388,2170660915,58003,36895,2024-10-04 19:26:04,0,0,0,0,0,0
3,201392388,1145490690,15536,47873,2024-10-04 19:26:05,0,0,0,0,0,0
3,201392388,2170660915,0,0,2024-10-04 19:26:05,128,84,212,1,1,2
3,201392388,2170660915,21726,36895,2024-10-04 19:26:05,0,0,0,0,0,0
3,201392388,2170660915,58003,36895,2024-10-04 19:26:05,0,0,0,0,0,0
3,201392388,1145490690,15536,47873,2024-10-04 19:26:06,0,0,0,0,0,0
3,201392388,2170660915,0,0,2024-10-04 19:26:06,128,84,212,1,1,2
3,201392388,2170660915,21726,36895,2024-10-04 19:26:06,0,0,0,0,0,0
3,201392388,2170660915,58003,36895,2024-10-04 19:26:06,0,0,0,0,0,0
3,201392388,1145490690,15536,47873,2024-10-04 19:26:07,0,0,0,0,0,0
3,201392388,2170660915,0,0,2024-10-04 19:26:07,128,84,212,1,1,2
3,201392388,2170660915,21726,36895,2024-10-04 19:26:07,0,0,0,0,0,0
3,201392388,2170660915,58003,36895,2024-10-04 19:26:07,0,0,0,0,0,0
3,201392388,1145490690,15536,47873,2024-10-04 19:26:08,0,0,0,0,0,0
3,201392388,2170660915,0,0,2024-10-04 19:26:08,128,84,212,1,1,2
3,201392388,2170660915,21726,36895,2024-10-04 19:26:08,0,0,0,0,0,0
3,201392388,2170660915,58003,36895,2024-10-04 19:26:08,0,0,0,0,0,0
3,201392388,2170660915,0,0,2024-10-04 19:26:09,0,84,84,0,1,1
3,201392388,2170660915,21726,36895,2024-10-04 19:26:09,0,0,0,0,0,0
3,201392388,2170660915,58003,36895,2024-10-04 19:26:09,0,0,0,0,0,0
3,201392388,2170660915,55530,36895,2024-10-04 19:26:10,570,455,1025,5,5,10
3,201392388,2170660915,0,0,2024-10-04 19:26:10,0,0,0,0,0,0
3,201392388,2170660915,21726,36895,2024-10-04 19:26:10,0,0,0,0,0,0
3,201392388,2170660915,58003,36895,2024-10-04 19:26:10,0,0,0,0,0,0
3,201392388,2170660915,55530,36895,2024-10-04 19:26:11,0,0,0,0,0,0
3,201392388,2170660915,0,0,2024-10-04 19:26:11,128,84,212,1,1,2
3,201392388,2170660915,21726,36895,2024-10-04 19:26:11,0,0,0,0,0,0
3,201392388,2170660915,58003,36895,2024-10-04 19:26:11,0,0,0,0,0,0
3,201392388,2170660915,55530,36895,2024-10-04 19:26:12,0,0,0,0,0,0
3,201392388,2170660915,0,0,2024-10-04 19:26:12,128,84,212,1,1,2
3,201392388,2170660915,58003,36895,2024-10-04 19:26:12,0,0,0,0,0,0
3,201392388,2170660915,55530,36895,2024-10-04 19:26:13,0,0,0,0,0,0
3,201392388,2170660915,0,0,2024-10-04 19:26:13,0,0,0,0,0,0
3,201392388,2170660915,58003,36895,2024-10-04 19:26:13,0,0,0,0,0,0
3,201392388,2170660915,55530,36895,2024-10-04 19:26:14,0,0,0,0,0,0
3,201392388,2170660915,0,0,2024-10-04 19:26:14,128,84,212,1,1,2
3,201392388,2170660915,58003,36895,2024-10-04 19:26:14,0,0,0,0,0,0
3,201392388,2170660915,55530,36895,2024-10-04 19:26:15,0,0,0,0,0,0
3,201392388,2170660915,0,0,2024-10-04 19:26:15,0,0,0,0,0,0
3,201392388,2170660915,58003,36895,2024-10-04 19:26:15,0,0,0,0,0,0
3,201392388,2170660915,55530,36895,2024-10-04 19:26:16,0,0,0,0,0,0
3,201392388,2170660915,0,0,2024-10-04 19:26:16,0,0,0,0,0,0
3,201392388,2170660915,58003,36895,2024-10-04 19:26:16,0,0,0,0,0,0
3,201392388,2170660915,55530,36895,2024-10-04 19:26:17,0,0,0,0,0,0
3,201392388,2170660915,0,0,2024-10-04 19:26:17,128,0,128,1,0,1
3,201392388,2170660915,58003,36895,2024-10-04 19:26:17,0,0,0,0,0,0
3,201392388,2170660915,55530,36895,2024-10-04 19:26:18,0,0,0,0,0,0
3,201392388,2170660915,0,0,2024-10-04 19:26:18,128,168,296,1,2,3
3,201392388,2170660915,58003,36895,2024-10-04 19:26:18,0,0,0,0,0,0
3,201392388,1145490690,58001,47873,2024-10-04 19:26:19,3360,37629,40989,25,34,59
3,201392388,2170660915,55530,36895,2024-10-04 19:26:19,0,0,0,0,0,0
3,201392388,2170660915,0,0,2024-10-04 19:26:19,128,84,212,1,1,2
3,201392388,2170660915,58003,36895,2024-10-04 19:26:19,0,0,0,0,0,0
3,201392388,1145490690,58001,47873,2024-10-04 19:26:20,3396,55571,58967,34,41,75
3,201392388,2170660915,55530,36895,2024-10-04 19:26:20,0,0,0,0,0,0
3,201392388,2170660915,0,0,2024-10-04 19:26:20,0,0,0,0,0,0
3,201392388,2170660915,58003,36895,2024-10-04 19:26:20,0,0,0,0,0,0
3,201392388,1145490690,58001,47873,2024-10-04 19:26:21,0,0,0,0,0,0
3,201392388,2170660915,55530,36895,2024-10-04 19:26:21,0,0,0,0,0,0
3,201392388,2170660915,0,0,2024-10-04 19:26:21,0,0,0,0,0,0
3,201392388,2170660915,58003,36895,2024-10-04 19:26:21,0,0,0,0,0,0
3,201392388,1145490690,58001,47873,2024-10-04 19:26:22,0,0,0,0,0,0
3,201392388,2170660915,55530,36895,2024-10-04 19:26:22,0,0,0,0,0,0
3,201392388,2170660915,0,0,2024-10-04 19:26:22,0,0,0,0,0,0
3,201392388,2170660915,58003,36895,2024-10-04 19:26:22,0,0,0,0,0,0
3,201392388,1145490690,58001,47873,2024-10-04 19:26:23,0,0,0,0,0,0
3,201392388,2170660915,55530,36895,2024-10-04 19:26:23,0,0,0,0,0,0
3,201392388,2170660915,0,0,2024-10-04 19:26:23,0,0,0,0,0,0
3,201392388,2170660915,58003,36895,2024-10-04 19:26:23,0,0,0,0,0,0
3,201392388,1145490690,58001,47873,2024-10-04 19:26:24,0,0,0,0,0,0
3,201392388,2170660915,55530,36895,2024-10-04 19:26:24,0,0,0,0,0,0
3,201392388,2170660915,0,0,2024-10-04 19:26:24,0,0,0,0,0,0
3,201392388,2170660915,58003,36895,2024-10-04 19:26:24,0,0,0,0,0,0
3,201392388,1145490690,58001,47873,2024-10-04 19:26:25,0,0,0,0,0,0
3,201392388,2170660915,55530,36895,2024-10-04 19:26:25,0,0,0,0,0,0
3,201392388,2170660915,0,0,2024-10-04 19:26:25,0,0,0,0,0,0
3,201392388,2170660915,58003,36895,2024-10-04 19:26:25,0,0,0,0,0,0
3,201392388,1145490690,58001,47873,2024-10-04 19:26:26,0,0,0,0,0,0
3,201392388,2170660915,55530,36895,2024-10-04 19:26:26,0,0,0,0,0,0
3,201392388,2170660915,0,0,2024-10-04 19:26:26,0,0,0,0,0,0
3,201392388,2170660915,58003,36895,2024-10-04 19:26:26,0,0,0,0,0,0
3,201392388,1145490690,58001,47873,2024-10-04 19:26:27,0,0,0,0,0,0
3,201392388,2170660915,55530,36895,2024-10-04 19:26:27,0,0,0,0,0,0
3,201392388,2170660915,0,0,2024-10-04 19:26:27,0,0,0,0,0,0
3,201392388,2170660915,58003,36895,2024-10-04 19:26:27,0,0,0,0,0,0
3,201392388,1145490690,58001,47873,2024-10-04 19:26:28,0,0,0,0,0,0
3,201392388,2170660915,55530,36895,2024-10-04 19:26:28,0,0,0,0,0,0
3,201392388,2170660915,0,0,2024-10-04 19:26:28,0,0,0,0,0,0
3,201392388,2170660915,58003,36895,2024-10-04 19:26:28,0,0,0,0,0,0
3,201392388,1145490690,58001,47873,2024-10-04 19:26:29,0,0,0,0,0,0
3,201392388,2170660915,55530,36895,2024-10-04 19:26:29,0,0,0,0,0,0
3,201392388,2170660915,0,0,2024-10-04 19:26:29,0,0,0,0,0,0
3,201392388,2170660915,58003,36895,2024-10-04 19:26:29,0,0,0,0,0,0
3,201392388,1145490690,58001,47873,2024-10-04 19:26:30,0,0,0,0,0,0
3,201392388,2170660915,55530,36895,2024-10-04 19:26:30,0,0,0,0,0,0
3,201392388,2170660915,0,0,2024-10-04 19:26:30,128,0,128,1,0,1
3,201392388,2170660915,58003,36895,2024-10-04 19:26:30,0,0,0,0,0,0
3,201392388,1145490690,58001,47873,2024-10-04 19:26:31,0,0,0,0,0,0
3,201392388,2170660915,55530,36895,2024-10-04 19:26:31,0,0,0,0,0,0
3,201392388,2170660915,0,0,2024-10-04 19:26:31,0,84,84,0,1,1
3,201392388,2170660915,58003,36895,2024-10-04 19:26:31,0,0,0,0,0,0
3,201392388,1145490690,58001,47873,2024-10-04 19:26:32,0,0,0,0,0,0
3,201392388,2170660915,55530,36895,2024-10-04 19:26:32,0,0,0,0,0,0
3,201392388,2170660915,0,0,2024-10-04 19:26:32,128,84,212,1,1,2
3,201392388,2170660915,58003,36895,2024-10-04 19:26:32,0,0,0,0,0,0
3,201392388,1145490690,58001,47873,2024-10-04 19:26:33,0,0,0,0,0,0
3,201392388,2170660915,55530,36895,2024-10-04 19:26:33,0,0,0,0,0,0
3,201392388,2170660915,0,0,2024-10-04 19:26:33,128,84,212,1,1,2
3,201392388,2170660915,58003,36895,2024-10-04 19:26:33,0,0,0,0,0,0
3,201392388,1145490690,58001,47873,2024-10-04 19:26:34,0,0,0,0,0,0
3,201392388,2170660915,55530,36895,2024-10-04 19:26:34,0,0,0,0,0,0
3,201392388,2170660915,0,0,2024-10-04 19:26:34,128,84,212,1,1,2
3,201392388,2170660915,58003,36895,2024-10-04 19:26:34,0,0,0,0,0,0
3,201392388,1145490690,58001,47873,2024-10-04 19:26:35,0,0,0,0,0,0
3,201392388,2170660915,55530,36895,2024-10-04 19:26:35,0,0,0,0,0,0
3,201392388,2170660915,0,0,2024-10-04 19:26:35,128,84,212,1,1,2
3,201392388,2170660915,58003,36895,2024-10-04 19:26:35,0,0,0,0,0,0
3,201392388,1145490690,58001,47873,2024-10-04 19:26:36,0,0,0,0,0,0
3,201392388,2170660915,55530,36895,2024-10-04 19:26:36,0,0,0,0,0,0
3,201392388,2170660915,0,0,2024-10-04 19:26:36,128,84,212,1,1,2
3,201392388,2170660915,58003,36895,2024-10-04 19:26:36,0,0,0,0,0,0
3,201392388,1145490690,58001,47873,2024-10-04 19:26:37,0,0,0,0,0,0
3,201392388,2170660915,55530,36895,2024-10-04 19:26:37,0,0,0,0,0,0
3,201392388,2170660915,0,0,2024-10-04 19:26:37,128,84,212,1,1,2
3,201392388,2170660915,58003,36895,2024-10-04 19:26:37,0,0,0,0,0,0
3,201392388,1145490690,58001,47873,2024-10-04 19:26:38,0,0,0,0,0,0
3,201392388,2170660915,55530,36895,2024-10-04 19:26:38,0,0,0,0,0,0
3,201392388,2170660915,0,0,2024-10-04 19:26:38,128,84,212,1,1,2
3,201392388,2170660915,58003,36895,2024-10-04 19:26:38,0,0,0,0,0,0
3,201392388,1145490690,58001,47873,2024-10-04 19:26:39,0,0,0,0,0,0
3,201392388,2170660915,55530,36895,2024-10-04 19:26:39,0,0,0,0,0,0
3,201392388,2170660915,0,0,2024-10-04 19:26:39,128,84,212,1,1,2
3,201392388,2170660915,58003,36895,2024-10-04 19:26:39,0,0,0,0,0,0
3,201392388,1145490690,58001,47873,2024-10-04 19:26:40,0,0,0,0,0,0
3,201392388,2170660915,55530,36895,2024-10-04 19:26:40,0,0,0,0,0,0
3,201392388,2170660915,0,0,2024-10-04 19:26:40,128,84,212,1,1,2
3,201392388,2170660915,58003,36895,2024-10-04 19:26:40,0,0,0,0,0,0
3,201392388,2170660915,55530,36895,2024-10-04 19:26:41,0,0,0,0,0,0
3,201392388,2170660915,0,0,2024-10-04 19:26:41,0,0,0,0,0,0
3,201392388,2170660915,20667,36895,2024-10-04 19:26:41,666,507,1173,6,6,12
3,201392388,2170660915,58003,36895,2024-10-04 19:26:41,0,0,0,0,0,0
3,201392388,2170660915,0,0,2024-10-04 19:26:42,256,84,340,2,1,3
3,201392388,2170660915,20667,36895,2024-10-04 19:26:42,0,0,0,0,0,0
3,201392388,2170660915,58003,36895,2024-10-04 19:26:42,0,0,0,0,0,0
3,201392388,2170660915,0,0,2024-10-04 19:26:43,128,84,212,1,1,2
3,201392388,2170660915,58003,36895,2024-10-04 19:26:43,0,0,0,0,0,0
3,201392388,2170660915,0,0,2024-10-04 19:26:44,0,0,0,0,0,0
3,201392388,2170660915,58003,36895,2024-10-04 19:26:44,0,0,0,0,0,0
3,201392388,2170660915,0,0,2024-10-04 19:26:45,0,84,84,0,1,1
3,201392388,2170660915,58003,36895,2024-10-04 19:26:45,0,0,0,0,0,0
3,201392388,2170660915,0,0,2024-10-04 19:26:46,0,0,0,0,0,0
3,201392388,2170660915,58003,36895,2024-10-04 19:26:46,0,0,0,0,0,0
3,201392388,2170660915,0,0,2024-10-04 19:26:47,128,0,128,1,0,1
3,201392388,2170660915,58003,36895,2024-10-04 19:26:47,0,0,0,0,0,0
3,201392388,2170660915,0,0,2024-10-04 19:26:48,128,168,296,1,2,3
3,201392388,2170660915,58003,36895,2024-10-04 19:26:48,0,0,0,0,0,0
3,201392388,2170660915,0,0,2024-10-04 19:26:49,128,84,212,1,1,2
3,201392388,1145490690,61147,47873,2024-10-04 19:26:49,2412,20115,22527,16,22,38
3,201392388,2170660915,58003,36895,2024-10-04 19:26:49,0,0,0,0,0,0
3,201392388,2170660915,0,0,2024-10-04 19:26:50,0,0,0,0,0,0
3,201392388,1145490690,61147,47873,2024-10-04 19:26:50,1548,35538,37086,15,22,37
3,201392388,2170660915,58003,36895,2024-10-04 19:26:50,0,0,0,0,0,0
3,201392388,2170660915,0,0,2024-10-04 19:26:51,0,0,0,0,0,0
3,201392388,1145490690,61147,47873,2024-10-04 19:26:51,2832,45631,48463,28,34,62
3,201392388,2170660915,58003,36895,2024-10-04 19:26:51,0,0,0,0,0,0
3,201392388,2170660915,0,0,2024-10-04 19:26:52,0,0,0,0,0,0
3,201392388,1145490690,61147,47873,2024-10-04 19:26:52,0,0,0,0,0,0
3,201392388,2170660915,58003,36895,2024-10-04 19:26:52,0,0,0,0,0,0
3,201392388,2170660915,0,0,2024-10-04 19:26:53,0,0,0,0,0,0
3,201392388,1145490690,61147,47873,2024-10-04 19:26:53,0,0,0,0,0,0
3,201392388,2170660915,58003,36895,2024-10-04 19:26:53,0,0,0,0,0,0
3,201392388,2170660915,0,0,2024-10-04 19:26:54,0,0,0,0,0,0
3,201392388,1145490690,61147,47873,2024-10-04 19:26:54,0,0,0,0,0,0
3,201392388,2170660915,58003,36895,2024-10-04 19:26:54,0,0,0,0,0,0
3,201392388,2170660915,0,0,2024-10-04 19:26:55,0,0,0,0,0,0
3,201392388,1145490690,61147,47873,2024-10-04 19:26:55,0,0,0,0,0,0
3,201392388,2170660915,58003,36895,2024-10-04 19:26:55,0,0,0,0,0,0
3,201392388,2170660915,0,0,2024-10-04 19:26:56,0,0,0,0,0,0
3,201392388,1145490690,61147,47873,2024-10-04 19:26:56,0,0,0,0,0,0
3,201392388,2170660915,58003,36895,2024-10-04 19:26:56,0,0,0,0,0,0
3,201392388,2170660915,0,0,2024-10-04 19:26:57,0,0,0,0,0,0
3,201392388,1145490690,61147,47873,2024-10-04 19:26:57,0,0,0,0,0,0
3,201392388,2170660915,58003,36895,2024-10-04 19:26:57,0,0,0,0,0,0
3,201392388,2170660915,0,0,2024-10-04 19:26:58,0,0,0,0,0,0
3,201392388,1145490690,61147,47873,2024-10-04 19:26:58,0,0,0,0,0,0
3,201392388,2170660915,58003,36895,2024-10-04 19:26:58,0,0,0,0,0,0
3,201392388,2170660915,0,0,2024-10-04 19:26:59,0,0,0,0,0,0
3,201392388,1145490690,61147,47873,2024-10-04 19:26:59,0,0,0,0,0,0
3,201392388,2170660915,58003,36895,2024-10-04 19:26:59,0,0,0,0,0,0
3,201392388,2170660915,0,0,2024-10-04 19:27:00,0,0,0,0,0,0
3,201392388,1145490690,61147,47873,2024-10-04 19:27:00,0,0,0,0,0,0
3,201392388,2170660915,58003,36895,2024-10-04 19:27:00,0,0,0,0,0,0
3,201392388,2170660915,0,0,2024-10-04 19:27:01,128,0,128,1,0,1
3,201392388,1145490690,61147,47873,2024-10-04 19:27:01,0,0,0,0,0,0
3,201392388,2170660915,58003,36895,2024-10-04 19:27:01,0,0,0,0,0,0
3,201392388,2170660915,0,0,2024-10-04 19:27:02,128,84,212,1,1,2
3,201392388,1145490690,61147,47873,2024-10-04 19:27:02,0,0,0,0,0,0
3,201392388,2170660915,58003,36895,2024-10-04 19:27:02,0,0,0,0,0,0
3,201392388,2170660915,0,0,2024-10-04 19:27:03,128,84,212,1,1,2
3,201392388,1145490690,61147,47873,2024-10-04 19:27:03,0,0,0,0,0,0
3,201392388,2170660915,58003,36895,2024-10-04 19:27:03,0,0,0,0,0,0
3,201392388,2170660915,0,0,2024-10-04 19:27:04,128,84,212,1,1,2
3,201392388,1145490690,61147,47873,2024-10-04 19:27:04,0,0,0,0,0,0
3,201392388,2170660915,58003,36895,2024-10-04 19:27:04,0,0,0,0,0,0
3,201392388,2170660915,0,0,2024-10-04 19:27:05,128,84,212,1,1,2
3,201392388,1145490690,61147,47873,2024-10-04 19:27:05,0,0,0,0,0,0
3,201392388,2170660915,58003,36895,2024-10-04 19:27:05,0,0,0,0,0,0
3,201392388,2170660915,0,0,2024-10-04 19:27:06,128,84,212,1,1,2
3,201392388,1145490690,61147,47873,2024-10-04 19:27:06,0,0,0,0,0,0
3,201392388,2170660915,58003,36895,2024-10-04 19:27:06,0,0,0,0,0,0
3,201392388,2170660915,0,0,2024-10-04 19:27:07,128,84,212,1,1,2
3,201392388,1145490690,61147,47873,2024-10-04 19:27:07,0,0,0,0,0,0
3,201392388,2170660915,58003,36895,2024-10-04 19:27:07,0,0,0,0,0,0
3,201392388,2170660915,0,0,2024-10-04 19:27:08,128,84,212,1,1,2
3,201392388,1145490690,61147,47873,2024-10-04 19:27:08,0,0,0,0,0,0
3,201392388,2170660915,58003,36895,2024-10-04 19:27:08,0,0,0,0,0,0
3,201392388,2170660915,0,0,2024-10-04 19:27:09,128,84,212,1,1,2
3,201392388,1145490690,61147,47873,2024-10-04 19:27:09,0,0,0,0,0,0
3,201392388,2170660915,58003,36895,2024-10-04 19:27:09,0,0,0,0,0,0
3,201392388,2170660915,0,0,2024-10-04 19:27:10,128,84,212,1,1,2
3,201392388,1145490690,61147,47873,2024-10-04 19:27:10,0,0,0,0,0,0
3,201392388,2170660915,58003,36895,2024-10-04 19:27:10,0,0,0,0,0,0
3,201392388,2170660915,0,0,2024-10-04 19:27:11,0,84,84,0,1,1
3,201392388,1145490690,61147,47873,2024-10-04 19:27:11,0,0,0,0,0,0
3,201392388,2170660915,58003,36895,2024-10-04 19:27:11,0,0,0,0,0,0
3,201392388,2170660915,50849,36895,2024-10-04 19:27:12,666,507,1173,6,6,12
3,201392388,2170660915,0,0,2024-10-04 19:27:12,0,0,0,0,0,0
3,201392388,2170660915,58003,36895,2024-10-04 19:27:12,0,0,0,0,0,0
3,201392388,2170660915,50849,36895,2024-10-04 19:27:13,0,0,0,0,0,0
3,201392388,2170660915,0,0,2024-10-04 19:27:13,128,84,212,1,1,2
3,201392388,2170660915,58003,36895,2024-10-04 19:27:13,0,0,0,0,0,0
3,201392388,2170660915,50849,36895,2024-10-04 19:27:14,0,0,0,0,0,0
3,201392388,2170660915,0,0,2024-10-04 19:27:14,0,0,0,0,0,0
3,201392388,2170660915,58003,36895,2024-10-04 19:27:14,0,0,0,0,0,0
3,201392388,2170660915,50849,36895,2024-10-04 19:27:15,0,0,0,0,0,0
3,201392388,2170660915,0,0,2024-10-04 19:27:15,128,84,212,1,1,2
3,201392388,2170660915,58003,36895,2024-10-04 19:27:15,0,0,0,0,0,0
3,201392388,2170660915,50849,36895,2024-10-04 19:27:16,0,0,0,0,0,0
3,201392388,2170660915,0,0,2024-10-04 19:27:16,128,84,212,1,1,2
3,201392388,2170660915,58003,36895,2024-10-04 19:27:16,0,0,0,0,0,0
3,201392388,2170660915,50849,36895,2024-10-04 19:27:17,0,0,0,0,0,0
3,201392388,2170660915,0,0,2024-10-04 19:27:17,0,0,0,0,0,0
3,201392388,2170660915,58003,36895,2024-10-04 19:27:17,0,0,0,0,0,0
3,201392388,2170660915,50849,36895,2024-10-04 19:27:18,0,0,0,0,0,0
3,201392388,2170660915,0,0,2024-10-04 19:27:18,128,0,128,1,0,1
3,201392388,2170660915,58003,36895,2024-10-04 19:27:18,0,0,0,0,0,0
3,201392388,2170660915,50849,36895,2024-10-04 19:27:19,0,0,0,0,0,0
3,201392388,2170660915,0,0,2024-10-04 19:27:19,128,84,212,1,1,2
3,201392388,2170660915,58003,36895,2024-10-04 19:27:19,0,0,0,0,0,0
3,201392388,2170660915,50849,36895,2024-10-04 19:27:20,0,0,0,0,0,0
3,201392388,2170660915,0,0,2024-10-04 19:27:20,0,84,84,0,1,1
3,201392388,2170660915,58003,36895,2024-10-04 19:27:20,0,0,0,0,0,0
3,201392388,2170660915,50849,36895,2024-10-04 19:27:21,0,0,0,0,0,0
3,201392388,1145490689,37574,47873,2024-10-04 19:27:21,6132,95182,101314,51,75,126
3,201392388,2170660915,0,0,2024-10-04 19:27:21,128,84,212,1,1,2
3,201392388,2170660915,58003,36895,2024-10-04 19:27:21,0,0,0,0,0,0
3,201392388,2170660915,50849,36895,2024-10-04 19:27:22,0,0,0,0,0,0
3,201392388,1145490689,37574,47873,2024-10-04 19:27:22,0,0,0,0,0,0
3,201392388,2170660915,0,0,2024-10-04 19:27:22,0,0,0,0,0,0
3,201392388,2170660915,58003,36895,2024-10-04 19:27:22,0,0,0,0,0,0
3,201392388,2170660915,50849,36895,2024-10-04 19:27:23,0,0,0,0,0,0
3,201392388,1145490689,37574,47873,2024-10-04 19:27:23,0,0,0,0,0,0
3,201392388,2170660915,0,0,2024-10-04 19:27:23,0,0,0,0,0,0
3,201392388,2170660915,58003,36895,2024-10-04 19:27:23,0,0,0,0,0,0
3,201392388,2170660915,50849,36895,2024-10-04 19:27:24,0,0,0,0,0,0
3,201392388,1145490689,37574,47873,2024-10-04 19:27:24,0,0,0,0,0,0
3,201392388,2170660915,0,0,2024-10-04 19:27:24,0,0,0,0,0,0
3,201392388,2170660915,58003,36895,2024-10-04 19:27:24,0,0,0,0,0,0
3,201392388,2170660915,50849,36895,2024-10-04 19:27:25,0,0,0,0,0,0
3,201392388,1145490689,37574,47873,2024-10-04 19:27:25,0,0,0,0,0,0
3,201392388,2170660915,0,0,2024-10-04 19:27:25,0,0,0,0,0,0
3,201392388,2170660915,58003,36895,2024-10-04 19:27:25,0,0,0,0,0,0
3,201392388,2170660915,50849,36895,2024-10-04 19:27:26,0,0,0,0,0,0
3,201392388,1145490689,37574,47873,2024-10-04 19:27:26,0,0,0,0,0,0
3,201392388,2170660915,0,0,2024-10-04 19:27:26,0,0,0,0,0,0
3,201392388,2170660915,58003,36895,2024-10-04 19:27:26,0,0,0,0,0,0
3,201392388,2170660915,50849,36895,2024-10-04 19:27:27,0,0,0,0,0,0
3,201392388,1145490689,37574,47873,2024-10-04 19:27:27,0,0,0,0,0,0
3,201392388,2170660915,0,0,2024-10-04 19:27:27,0,0,0,0,0,0
3,201392388,2170660915,58003,36895,2024-10-04 19:27:27,0,0,0,0,0,0
3,201392388,2170660915,50849,36895,2024-10-04 19:27:28,0,0,0,0,0,0
3,201392388,1145490689,37574,47873,2024-10-04 19:27:28,0,0,0,0,0,0
3,201392388,2170660915,0,0,2024-10-04 19:27:28,0,0,0,0,0,0
3,201392388,2170660915,58003,36895,2024-10-04 19:27:28,0,0,0,0,0,0
3,201392388,2170660915,50849,36895,2024-10-04 19:27:29,0,0,0,0,0,0
3,201392388,1145490689,37574,47873,2024-10-04 19:27:29,0,0,0,0,0,0
3,201392388,2170660915,0,0,2024-10-04 19:27:29,0,0,0,0,0,0
3,201392388,2170660915,58003,36895,2024-10-04 19:27:29,0,0,0,0,0,0
3,201392388,2170660915,50849,36895,2024-10-04 19:27:30,0,0,0,0,0,0
3,201392388,1145490689,37574,47873,2024-10-04 19:27:30,0,0,0,0,0,0
3,201392388,2170660915,0,0,2024-10-04 19:27:30,0,0,0,0,0,0
3,201392388,2170660915,58003,36895,2024-10-04 19:27:30,0,0,0,0,0,0
3,201392388,2170660915,50849,36895,2024-10-04 19:27:31,0,0,0,0,0,0
3,201392388,1145490689,37574,47873,2024-10-04 19:27:31,0,0,0,0,0,0
3,201392388,2170660915,0,0,2024-10-04 19:27:31,128,0,128,1,0,1
3,201392388,2170660915,58003,36895,2024-10-04 19:27:31,0,0,0,0,0,0
3,201392388,2170660915,50849,36895,2024-10-04 19:27:32,0,0,0,0,0,0
3,201392388,1145490689,37574,47873,2024-10-04 19:27:32,0,0,0,0,0,0
3,201392388,2170660915,0,0,2024-10-04 19:27:32,128,84,212,1,1,2
3,201392388,2170660915,58003,36895,2024-10-04 19:27:32,0,0,0,0,0,0
3,201392388,2170660915,50849,36895,2024-10-04 19:27:33,0,0,0,0,0,0
3,201392388,1145490689,37574,47873,2024-10-04 19:27:33,0,0,0,0,0,0
3,201392388,2170660915,0,0,2024-10-04 19:27:33,128,168,296,1,2,3
3,201392388,2170660915,58003,36895,2024-10-04 19:27:33,0,0,0,0,0,0
3,201392388,2170660915,50849,36895,2024-10-04 19:27:34,0,0,0,0,0,0
3,201392388,1145490689,37574,47873,2024-10-04 19:27:34,0,0,0,0,0,0
3,201392388,2170660915,0,0,2024-10-04 19:27:34,128,84,212,1,1,2
3,201392388,2170660915,58003,36895,2024-10-04 19:27:34,0,0,0,0,0,0
3,201392388,2170660915,50849,36895,2024-10-04 19:27:35,0,0,0,0,0,0
3,201392388,1145490689,37574,47873,2024-10-04 19:27:35,0,0,0,0,0,0
3,201392388,2170660915,0,0,2024-10-04 19:27:35,128,84,212,1,1,2
3,201392388,2170660915,58003,36895,2024-10-04 19:27:35,0,0,0,0,0,0
3,201392388,2170660915,50849,36895,2024-10-04 19:27:36,0,0,0,0,0,0
3,201392388,1145490689,37574,47873,2024-10-04 19:27:36,0,0,0,0,0,0
3,201392388,2170660915,0,0,2024-10-04 19:27:36,128,84,212,1,1,2
3,201392388,2170660915,58003,36895,2024-10-04 19:27:36,0,0,0,0,0,0
3,201392388,2170660915,50849,36895,2024-10-04 19:27:37,0,0,0,0,0,0
3,201392388,1145490689,37574,47873,2024-10-04 19:27:37,0,0,0,0,0,0
3,201392388,2170660915,0,0,2024-10-04 19:27:37,128,84,212,1,1,2
3,201392388,2170660915,58003,36895,2024-10-04 19:27:37,0,0,0,0,0,0
3,201392388,2170660915,50849,36895,2024-10-04 19:27:38,0,0,0,0,0,0
3,201392388,1145490689,37574,47873,2024-10-04 19:27:38,0,0,0,0,0,0
3,201392388,2170660915,0,0,2024-10-04 19:27:38,128,84,212,1,1,2
3,201392388,2170660915,58003,36895,2024-10-04 19:27:38,0,0,0,0,0,0
3,201392388,2170660915,50849,36895,2024-10-04 19:27:39,0,0,0,0,0,0
3,201392388,1145490689,37574,47873,2024-10-04 19:27:39,0,0,0,0,0,0
3,201392388,2170660915,0,0,2024-10-04 19:27:39,128,84,212,1,1,2
3,201392388,2170660915,58003,36895,2024-10-04 19:27:39,0,0,0,0,0,0
3,201392388,2170660915,50849,36895,2024-10-04 19:27:40,0,0,0,0,0,0
3,201392388,1145490689,37574,47873,2024-10-04 19:27:40,0,0,0,0,0,0
3,201392388,2170660915,0,0,2024-10-04 19:27:40,128,84,212,1,1,2
3,201392388,2170660915,58003,36895,2024-10-04 19:27:40,0,0,0,0,0,0
3,201392388,2170660915,50849,36895,2024-10-04 19:27:41,0,0,0,0,0,0
3,201392388,1145490689,37574,47873,2024-10-04 19:27:41,0,0,0,0,0,0
3,201392388,2170660915,0,0,2024-10-04 19:27:41,0,0,0,0,0,0
3,201392388,2170660915,58003,36895,2024-10-04 19:27:41,0,0,0,0,0,0
3,201392388,2170660915,50849,36895,2024-10-04 19:27:42,0,0,0,0,0,0
3,201392388,1145490689,37574,47873,2024-10-04 19:27:42,0,0,0,0,0,0
3,201392388,2170660915,21158,36895,2024-10-04 19:27:42,666,507,1173,6,6,12
3,201392388,2170660915,0,0,2024-10-04 19:27:42,128,0,128,1,0,1
3,201392388,2170660915,58003,36895,2024-10-04 19:27:42,0,0,0,0,0,0
3,201392388,2170660915,50849,36895,2024-10-04 19:27:43,0,0,0,0,0,0
3,201392388,1145490689,37574,47873,2024-10-04 19:27:43,0,0,0,0,0,0
3,201392388,2170660915,21158,36895,2024-10-04 19:27:43,0,0,0,0,0,0
3,201392388,2170660915,0,0,2024-10-04 19:27:43,128,84,212,1,1,2
3,201392388,2170660915,58003,36895,2024-10-04 19:27:43,0,0,0,0,0,0
3,201392388,2170660915,50849,36895,2024-10-04 19:27:44,0,0,0,0,0,0
3,201392388,2170660915,0,0,2024-10-04 19:27:44,0,84,84,0,1,1
3,201392388,2170660915,58003,36895,2024-10-04 19:27:44,0,0,0,0,0,0
3,201392388,2170660915,50849,36895,2024-10-04 19:27:45,0,0,0,0,0,0
3,201392388,2170660915,0,0,2024-10-04 19:27:45,0,0,0,0,0,0
3,201392388,2170660915,58003,36895,2024-10-04 19:27:45,0,0,0,0,0,0
3,201392388,2170660915,0,0,2024-10-04 19:27:46,128,84,212,1,1,2
3,201392388,2170660915,58003,36895,2024-10-04 19:27:46,0,0,0,0,0,0
3,201392388,2170660915,0,0,2024-10-04 19:27:47,0,0,0,0,0,0
3,201392388,2170660915,58003,36895,2024-10-04 19:27:47,0,0,0,0,0,0
3,201392388,2170660915,0,0,2024-10-04 19:27:48,128,0,128,1,0,1
3,201392388,2170660915,58003,36895,2024-10-04 19:27:48,0,0,0,0,0,0
3,201392388,2170660915,0,0,2024-10-04 19:27:49,128,84,212,1,1,2
3,201392388,2170660915,58003,36895,2024-10-04 19:27:49,0,0,0,0,0,0
3,201392388,1145490689,48347,47873,2024-10-04 19:27:50,3840,47360,51200,30,42,72
3,201392388,2170660915,0,0,2024-10-04 19:27:50,128,168,296,1,2,3
3,201392388,2170660915,58003,36895,2024-10-04 19:27:50,0,0,0,0,0,0
3,201392388,1145490689,48347,47873,2024-10-04 19:27:51,2448,43880,46328,24,33,57
3,201392388,2170660915,0,0,2024-10-04 19:27:51,0,0,0,0,0,0
3,201392388,2170660915,58003,36895,2024-10-04 19:27:51,0,0,0,0,0,0
3,201392388,1145490689,48347,47873,2024-10-04 19:27:52,0,0,0,0,0,0
3,201392388,2170660915,0,0,2024-10-04 19:27:52,0,0,0,0,0,0
3,201392388,2170660915,58003,36895,2024-10-04 19:27:52,0,0,0,0,0,0
3,201392388,1145490689,48347,47873,2024-10-04 19:27:53,0,0,0,0,0,0
3,201392388,2170660915,0,0,2024-10-04 19:27:53,0,0,0,0,0,0
3,201392388,2170660915,58003,36895,2024-10-04 19:27:53,0,0,0,0,0,0
3,201392388,2170660915,0,0,2024-10-04 19:27:54,0,0,0,0,0,0
3,201392388,2170660915,58003,36895,2024-10-04 19:27:54,0,0,0,0,0,0
3,201392388,2170660915,0,0,2024-10-04 19:27:55,0,0,0,0,0,0
3,201392388,2170660915,58003,36895,2024-10-04 19:27:55,0,0,0,0,0,0
3,201392388,2170660915,0,0,2024-10-04 19:27:56,0,0,0,0,0,0
3,201392388,2170660915,58003,36895,2024-10-04 19:27:56,0,0,0,0,0,0
3,201392388,2170660915,0,0,2024-10-04 19:27:57,0,0,0,0,0,0
3,201392388,2170660915,58003,36895,2024-10-04 19:27:57,0,0,0,0,0,0
3,201392388,2170660915,0,0,2024-10-04 19:27:58,0,0,0,0,0,0
3,201392388,2170660915,58003,36895,2024-10-04 19:27:58,0,0,0,0,0,0
3,201392388,2170660915,0,0,2024-10-04 19:27:59,0,0,0,0,0,0
3,201392388,2170660915,58003,36895,2024-10-04 19:27:59,0,0,0,0,0,0
3,201392388,2170660915,0,0,2024-10-04 19:28:00,0,0,0,0,0,0
3,201392388,2170660915,58003,36895,2024-10-04 19:28:00,0,0,0,0,0,0
3,201392388,2170660915,0,0,2024-10-04 19:28:01,128,0,128,1,0,1
3,201392388,2170660915,58003,36895,2024-10-04 19:28:01,0,0,0,0,0,0
3,201392388,2170660915,0,0,2024-10-04 19:28:02,128,84,212,1,1,2
3,201392388,2170660915,58003,36895,2024-10-04 19:28:02,0,0,0,0,0,0
3,201392388,2170660915,0,0,2024-10-04 19:28:03,128,84,212,1,1,2
3,201392388,2170660915,58003,36895,2024-10-04 19:28:03,0,0,0,0,0,0
3,201392388,2170660915,0,0,2024-10-04 19:28:04,128,84,212,1,1,2
3,201392388,2170660915,58003,36895,2024-10-04 19:28:04,0,0,0,0,0,0
3,201392388,2170660915,0,0,2024-10-04 19:28:05,128,84,212,1,1,2
3,201392388,2170660915,58003,36895,2024-10-04 19:28:05,0,0,0,0,0,0
3,201392388,2170660915,0,0,2024-10-04 19:28:06,128,84,212,1,1,2
3,201392388,2170660915,58003,36895,2024-10-04 19:28:06,0,0,0,0,0,0
3,201392388,2170660915,0,0,2024-10-04 19:28:07,128,84,212,1,1,2
3,201392388,2170660915,58003,36895,2024-10-04 19:28:07,0,0,0,0,0,0
3,201392388,2170660915,0,0,2024-10-04 19:28:08,128,84,212,1,1,2
3,201392388,2170660915,58003,36895,2024-10-04 19:28:08,0,0,0,0,0,0
3,201392388,2170660915,0,0,2024-10-04 19:28:09,128,84,212,1,1,2
3,201392388,2170660915,58003,36895,2024-10-04 19:28:09,0,0,0,0,0,0
3,201392388,2170660915,0,0,2024-10-04 19:28:10,128,84,212,1,1,2
3,201392388,2170660915,58003,36895,2024-10-04 19:28:10,0,0,0,0,0,0
3,201392388,2170660915,0,0,2024-10-04 19:28:11,0,84,84,0,1,1
3,201392388,2170660915,58003,36895,2024-10-04 19:28:11,0,0,0,0,0,0
3,201392388,2170660915,0,0,2024-10-04 19:28:12,0,0,0,0,0,0
3,201392388,2170660915,58003,36895,2024-10-04 19:28:12,0,0,0,0,0,0
3,201392388,2170660915,19646,36895,2024-10-04 19:28:13,666,507,1173,6,6,12
3,201392388,2170660915,0,0,2024-10-04 19:28:13,128,84,212,1,1,2
3,201392388,2170660915,58003,36895,2024-10-04 19:28:13,0,0,0,0,0,0
3,201392388,2170660915,19646,36895,2024-10-04 19:28:14,0,0,0,0,0,0
3,201392388,2170660915,0,0,2024-10-04 19:28:14,128,84,212,1,1,2
3,201392388,2170660915,58003,36895,2024-10-04 19:28:14,0,0,0,0,0,0
3,201392388,2170660915,0,0,2024-10-04 19:28:15,128,84,212,1,1,2
3,201392388,2170660915,58003,36895,2024-10-04 19:28:15,0,0,0,0,0,0
3,201392388,2170660915,0,0,2024-10-04 19:28:16,0,0,0,0,0,0
3,201392388,2170660915,58003,36895,2024-10-04 19:28:16,0,0,0,0,0,0
3,201392388,2170660915,0,0,2024-10-04 19:28:17,0,0,0,0,0,0
3,201392388,2170660915,58003,36895,2024-10-04 19:28:17,0,0,0,0,0,0
3,201392388,2170660915,0,0,2024-10-04 19:28:18,128,0,128,1,0,1
3,201392388,2170660915,58003,36895,2024-10-04 19:28:18,0,0,0,0,0,0
3,201392388,2170660915,0,0,2024-10-04 19:28:19,128,84,212,1,1,2
3,201392388,2170660915,58003,36895,2024-10-04 19:28:19,0,0,0,0,0,0
3,201392388,2170660915,0,0,2024-10-04 19:28:20,128,84,212,1,1,2
3,201392388,2170660915,58003,36895,2024-10-04 19:28:20,0,0,0,0,0,0
3,201392388,2170660915,0,0,2024-10-04 19:28:21,0,84,84,0,1,1
3,201392388,1145490690,55484,47873,2024-10-04 19:28:21,7008,111454,118462,59,83,142
3,201392388,2170660915,58003,36895,2024-10-04 19:28:21,0,0,0,0,0,0
3,201392388,2170660915,0,0,2024-10-04 19:28:22,0,0,0,0,0,0
3,201392388,1145490690,55484,47873,2024-10-04 19:28:22,0,0,0,0,0,0
3,201392388,2170660915,58003,36895,2024-10-04 19:28:22,0,0,0,0,0,0
3,201392388,2170660915,0,0,2024-10-04 19:28:23,0,0,0,0,0,0
3,201392388,1145490690,55484,47873,2024-10-04 19:28:23,0,0,0,0,0,0
3,201392388,2170660915,58003,36895,2024-10-04 19:28:23,0,0,0,0,0,0
3,201392388,2170660915,0,0,2024-10-04 19:28:24,0,0,0,0,0,0
3,201392388,2170660915,58003,36895,2024-10-04 19:28:24,0,0,0,0,0,0
3,201392388,2170660915,0,0,2024-10-04 19:28:25,0,0,0,0,0,0
3,201392388,2170660915,58003,36895,2024-10-04 19:28:25,0,0,0,0,0,0
3,201392388,2170660915,0,0,2024-10-04 19:28:26,0,0,0,0,0,0
3,201392388,2170660915,58003,36895,2024-10-04 19:28:26,0,0,0,0,0,0
3,201392388,2170660915,0,0,2024-10-04 19:28:27,0,0,0,0,0,0
3,201392388,2170660915,58003,36895,2024-10-04 19:28:27,0,0,0,0,0,0
3,201392388,2170660915,0,0,2024-10-04 19:28:28,0,0,0,0,0,0
3,201392388,2170660915,58003,36895,2024-10-04 19:28:28,0,0,0,0,0,0
3,201392388,2170660915,0,0,2024-10-04 19:28:29,0,0,0,0,0,0
3,201392388,2170660915,58003,36895,2024-10-04 19:28:29,0,0,0,0,0,0
3,201392388,2170660915,0,0,2024-10-04 19:28:30,0,0,0,0,0,0
3,201392388,2170660915,58003,36895,2024-10-04 19:28:30,0,0,0,0,0,0
3,201392388,2170660915,0,0,2024-10-04 19:28:31,128,0,128,1,0,1
3,201392388,2170660915,58003,36895,2024-10-04 19:28:31,0,0,0,0,0,0
3,201392388,2170660915,0,0,2024-10-04 19:28:32,128,84,212,1,1,2
3,201392388,2170660915,58003,36895,2024-10-04 19:28:32,0,0,0,0,0,0
3,201392388,2170660915,0,0,2024-10-04 19:28:33,128,84,212,1,1,2
3,201392388,2170660915,58003,36895,2024-10-04 19:28:33,0,0,0,0,0,0
3,201392388,2170660915,0,0,2024-10-04 19:28:34,128,84,212,1,1,2
3,201392388,2170660915,58003,36895,2024-10-04 19:28:34,0,0,0,0,0,0
3,201392388,2170660915,0,0,2024-10-04 19:28:35,0,84,84,0,1,1
3,201392388,2170660915,58003,36895,2024-10-04 19:28:35,0,0,0,0,0,0
3,201392388,2170660915,0,0,2024-10-04 19:28:36,128,84,212,1,1,2
3,201392388,2170660915,58003,36895,2024-10-04 19:28:36,0,0,0,0,0,0
3,201392388,2170660915,0,0,2024-10-04 19:28:37,128,84,212,1,1,2
3,201392388,2170660915,58003,36895,2024-10-04 19:28:37,0,0,0,0,0,0
3,201392388,2170660915,0,0,2024-10-04 19:28:38,128,84,212,1,1,2
3,201392388,2170660915,58003,36895,2024-10-04 19:28:38,0,0,0,0,0,0
3,201392388,2170660915,0,0,2024-10-04 19:28:39,128,84,212,1,1,2
3,201392388,2170660915,58003,36895,2024-10-04 19:28:39,0,0,0,0,0,0
3,201392388,2170660915,0,0,2024-10-04 19:28:40,256,84,340,2,1,3
3,201392388,2170660915,58003,36895,2024-10-04 19:28:40,0,0,0,0,0,0
3,201392388,2170660915,0,0,2024-10-04 19:28:41,0,84,84,0,1,1
3,201392388,2170660915,58003,36895,2024-10-04 19:28:41,0,0,0,0,0,0
3,201392388,2170660915,0,0,2024-10-04 19:28:42,0,0,0,0,0,0
3,201392388,2170660915,58003,36895,2024-10-04 19:28:42,0,0,0,0,0,0
3,201392388,2170660915,45231,36895,2024-10-04 19:28:43,666,507,1173,6,6,12
3,201392388,2170660915,0,0,2024-10-04 19:28:43,128,0,128,1,0,1
3,201392388,2170660915,58003,36895,2024-10-04 19:28:43,0,0,0,0,0,0
3,201392388,2170660915,45231,36895,2024-10-04 19:28:44,0,0,0,0,0,0
3,201392388,2170660915,0,0,2024-10-04 19:28:44,128,84,212,1,1,2
3,201392388,2170660915,58003,36895,2024-10-04 19:28:44,0,0,0,0,0,0
3,201392388,2170660915,0,0,2024-10-04 19:28:45,0,84,84,0,1,1
3,201392388,2170660915,58003,36895,2024-10-04 19:28:45,0,0,0,0,0,0
3,201392388,2170660915,0,0,2024-10-04 19:28:46,0,0,0,0,0,0
3,201392388,2170660915,58003,36895,2024-10-04 19:28:46,0,0,0,0,0,0
3,201392388,2170660915,0,0,2024-10-04 19:28:47,128,84,212,1,1,2
3,201392388,2170660915,58003,36895,2024-10-04 19:28:47,0,0,0,0,0,0
3,201392388,2170660915,0,0,2024-10-04 19:28:48,0,0,0,0,0,0
3,201392388,2170660915,58003,36895,2024-10-04 19:28:48,0,0,0,0,0,0
3,201392388,2170660915,0,0,2024-10-04 19:28:49,128,0,128,1,0,1
3,201392388,2170660915,58003,36895,2024-10-04 19:28:49,0,0,0,0,0,0
3,201392388,2170660915,0,0,2024-10-04 19:28:50,128,84,212,1,1,2
3,201392388,2170660915,58003,36895,2024-10-04 19:28:50,0,0,0,0,0,0
3,201392388,1145490692,41697,47873,2024-10-04 19:28:51,4980,82441,87421,40,62,102
3,201392388,2170660915,0,0,2024-10-04 19:28:51,128,168,296,1,2,3
3,201392388,2170660915,58003,36895,2024-10-04 19:28:51,0,0,0,0,0,0
3,201392388,1145490692,41697,47873,2024-10-04 19:28:52,1428,22859,24287,14,17,31
3,201392388,2170660915,0,0,2024-10-04 19:28:52,0,0,0,0,0,0
3,201392388,2170660915,58003,36895,2024-10-04 19:28:52,0,0,0,0,0,0
3,201392388,1145490692,41697,47873,2024-10-04 19:28:53,0,0,0,0,0,0
3,201392388,2170660915,0,0,2024-10-04 19:28:53,0,0,0,0,0,0
3,201392388,2170660915,58003,36895,2024-10-04 19:28:53,0,0,0,0,0,0
3,201392388,1145490692,41697,47873,2024-10-04 19:28:54,0,0,0,0,0,0
3,201392388,2170660915,0,0,2024-10-04 19:28:54,0,0,0,0,0,0
3,201392388,2170660915,58003,36895,2024-10-04 19:28:54,0,0,0,0,0,0
3,201392388,2170660915,0,0,2024-10-04 19:28:55,0,0,0,0,0,0
3,201392388,2170660915,58003,36895,2024-10-04 19:28:55,0,0,0,0,0,0
3,201392388,2170660915,0,0,2024-10-04 19:28:56,0,0,0,0,0,0
3,201392388,2170660915,58003,36895,2024-10-04 19:28:56,0,0,0,0,0,0
3,201392388,2170660915,0,0,2024-10-04 19:28:57,0,0,0,0,0,0
3,201392388,2170660915,58003,36895,2024-10-04 19:28:57,0,0,0,0,0,0
3,201392388,2170660915,0,0,2024-10-04 19:28:58,0,0,0,0,0,0
3,201392388,2170660915,58003,36895,2024-10-04 19:28:58,0,0,0,0,0,0
3,201392388,2170660915,0,0,2024-10-04 19:28:59,0,0,0,0,0,0
3,201392388,2170660915,58003,36895,2024-10-04 19:28:59,0,0,0,0,0,0
3,201392388,2170660915,0,0,2024-10-04 19:29:00,0,0,0,0,0,0
3,201392388,2170660915,58003,36895,2024-10-04 19:29:00,0,0,0,0,0,0
3,201392388,2170660915,0,0,2024-10-04 19:29:01,0,0,0,0,0,0
3,201392388,2170660915,58003,36895,2024-10-04 19:29:01,0,0,0,0,0,0
3,201392388,2170660915,0,0,2024-10-04 19:29:02,128,0,128,1,0,1
3,201392388,2170660915,58003,36895,2024-10-04 19:29:02,0,0,0,0,0,0
3,201392388,2170660915,0,0,2024-10-04 19:29:03,128,84,212,1,1,2
3,201392388,2170660915,58003,36895,2024-10-04 19:29:03,0,0,0,0,0,0
3,201392388,2170660915,0,0,2024-10-04 19:29:04,128,84,212,1,1,2
3,201392388,2170660915,58003,36895,2024-10-04 19:29:04,0,0,0,0,0,0
3,201392388,2170660915,0,0,2024-10-04 19:29:05,128,84,212,1,1,2
3,201392388,2170660915,58003,36895,2024-10-04 19:29:05,0,0,0,0,0,0
3,201392388,2170660915,0,0,2024-10-04 19:29:06,0,84,84,0,1,1
3,201392388,2170660915,58003,36895,2024-10-04 19:29:06,0,0,0,0,0,0
3,201392388,2170660915,0,0,2024-10-04 19:29:07,128,84,212,1,1,2
3,201392388,2170660915,58003,36895,2024-10-04 19:29:07,0,0,0,0,0,0
3,201392388,2170660915,0,0,2024-10-04 19:29:08,128,84,212,1,1,2
3,201392388,2170660915,58003,36895,2024-10-04 19:29:08,0,0,0,0,0,0
3,201392388,2170660915,0,0,2024-10-04 19:29:09,128,84,212,1,1,2
3,201392388,2170660915,58003,36895,2024-10-04 19:29:09,0,0,0,0,0,0
3,201392388,2170660915,0,0,2024-10-04 19:29:10,256,168,424,2,2,4
3,201392388,2170660915,58003,36895,2024-10-04 19:29:10,0,0,0,0,0,0
3,201392388,2170660915,0,0,2024-10-04 19:29:11,128,84,212,1,1,2
3,201392388,2170660915,58003,36895,2024-10-04 19:29:11,0,0,0,0,0,0
3,201392388,2170660915,0,0,2024-10-04 19:29:12,0,0,0,0,0,0
3,201392388,2170660915,58003,36895,2024-10-04 19:29:12,0,0,0,0,0,0
3,201392388,2170660915,14465,36895,2024-10-04 19:29:13,666,507,1173,6,6,12
3,201392388,2170660915,0,0,2024-10-04 19:29:13,0,0,0,0,0,0
3,201392388,2170660915,58003,36895,2024-10-04 19:29:13,0,0,0,0,0,0
3,201392388,2170660915,14465,36895,2024-10-04 19:29:14,0,0,0,0,0,0
3,201392388,2170660915,0,0,2024-10-04 19:29:14,128,84,212,1,1,2
3,201392388,2170660915,58003,36895,2024-10-04 19:29:14,0,0,0,0,0,0
3,201392388,2170660915,14465,36895,2024-10-04 19:29:15,0,0,0,0,0,0
3,201392388,2170660915,0,0,2024-10-04 19:29:15,128,84,212,1,1,2
3,201392388,2170660915,58003,36895,2024-10-04 19:29:15,0,0,0,0,0,0
3,201392388,2170660915,0,0,2024-10-04 19:29:16,128,84,212,1,1,2
3,201392388,2170660915,58003,36895,2024-10-04 19:29:16,0,0,0,0,0,0
3,201392388,2170660915,0,0,2024-10-04 19:29:17,0,0,0,0,0,0
3,201392388,2170660915,58003,36895,2024-10-04 19:29:17,0,0,0,0,0,0
3,201392388,2170660915,0,0,2024-10-04 19:29:18,0,0,0,0,0,0
3,201392388,2170660915,58003,36895,2024-10-04 19:29:18,0,0,0,0,0,0
3,201392388,2170660915,0,0,2024-10-04 19:29:19,0,0,0,0,0,0
3,201392388,2170660915,58003,36895,2024-10-04 19:29:19,0,0,0,0,0,0
3,201392388,2170660915,0,0,2024-10-04 19:29:20,128,84,212,1,1,2
3,201392388,2170660915,58003,36895,2024-10-04 19:29:20,0,0,0,0,0,0
3,201392388,1145490689,57532,47873,2024-10-04 19:29:21,813,60,873,3,1,4
3,201392388,2170660915,0,0,2024-10-04 19:29:21,256,168,424,2,2,4
3,201392388,2170660915,58003,36895,2024-10-04 19:29:21,0,0,0,0,0,0
3,201392388,1145490689,57532,47873,2024-10-04 19:29:22,5475,103102,108577,51,75,126
3,201392388,2170660915,0,0,2024-10-04 19:29:22,0,0,0,0,0,0
3,201392388,2170660915,58003,36895,2024-10-04 19:29:22,0,0,0,0,0,0
3,201392388,1145490689,57532,47873,2024-10-04 19:29:23,408,104,512,4,2,6
3,201392388,2170660915,0,0,2024-10-04 19:29:23,0,0,0,0,0,0
3,201392388,2170660915,58003,36895,2024-10-04 19:29:23,0,0,0,0,0,0
3,201392388,1145490689,57532,47873,2024-10-04 19:29:24,0,0,0,0,0,0
3,201392388,2170660915,0,0,2024-10-04 19:29:24,0,0,0,0,0,0
3,201392388,2170660915,58003,36895,2024-10-04 19:29:24,0,0,0,0,0,0
3,201392388,1145490689,57532,47873,2024-10-04 19:29:25,0,0,0,0,0,0
3,201392388,2170660915,0,0,2024-10-04 19:29:25,0,0,0,0,0,0
3,201392388,2170660915,58003,36895,2024-10-04 19:29:25,0,0,0,0,0,0
3,201392388,2170660915,0,0,2024-10-04 19:29:26,0,0,0,0,0,0
3,201392388,2170660915,58003,36895,2024-10-04 19:29:26,0,0,0,0,0,0
3,201392388,2170660915,0,0,2024-10-04 19:29:27,0,0,0,0,0,0
3,201392388,2170660915,58003,36895,2024-10-04 19:29:27,0,0,0,0,0,0
3,201392388,2170660915,0,0,2024-10-04 19:29:28,0,0,0,0,0,0
3,201392388,2170660915,58003,36895,2024-10-04 19:29:28,0,0,0,0,0,0
3,201392388,2170660915,0,0,2024-10-04 19:29:29,0,0,0,0,0,0
3,201392388,2170660915,58003,36895,2024-10-04 19:29:29,0,0,0,0,0,0
3,201392388,2170660915,0,0,2024-10-04 19:29:30,0,0,0,0,0,0
3,201392388,2170660915,58003,36895,2024-10-04 19:29:30,0,0,0,0,0,0
3,201392388,2170660915,0,0,2024-10-04 19:29:31,0,0,0,0,0,0
3,201392388,2170660915,58003,36895,2024-10-04 19:29:31,0,0,0,0,0,0
3,201392388,2170660915,0,0,2024-10-04 19:29:32,128,0,128,1,0,1
3,201392388,2170660915,58003,36895,2024-10-04 19:29:32,0,0,0,0,0,0
3,201392388,2170660915,0,0,2024-10-04 19:29:33,128,84,212,1,1,2
3,201392388,2170660915,58003,36895,2024-10-04 19:29:33,0,0,0,0,0,0
3,201392388,2170660915,0,0,2024-10-04 19:29:34,128,84,212,1,1,2
3,201392388,2170660915,58003,36895,2024-10-04 19:29:34,0,0,0,0,0,0
3,201392388,2170660915,0,0,2024-10-04 19:29:35,128,84,212,1,1,2
3,201392388,2170660915,58003,36895,2024-10-04 19:29:35,0,0,0,0,0,0
3,201392388,2170660915,0,0,2024-10-04 19:29:36,128,84,212,1,1,2
3,201392388,2170660915,58003,36895,2024-10-04 19:29:36,0,0,0,0,0,0
3,201392388,2170660915,0,0,2024-10-04 19:29:37,128,84,212,1,1,2
3,201392388,2170660915,58003,36895,2024-10-04 19:29:37,0,0,0,0,0,0
3,201392388,2170660915,0,0,2024-10-04 19:29:38,128,84,212,1,1,2
3,201392388,2170660915,58003,36895,2024-10-04 19:29:38,0,0,0,0,0,0
3,201392388,2170660915,0,0,2024-10-04 19:29:39,128,84,212,1,1,2
3,201392388,2170660915,58003,36895,2024-10-04 19:29:39,0,0,0,0,0,0
3,201392388,2170660915,0,0,2024-10-04 19:29:40,128,84,212,1,1,2
3,201392388,2170660915,58003,36895,2024-10-04 19:29:40,0,0,0,0,0,0
3,201392388,2170660915,0,0,2024-10-04 19:29:41,128,84,212,1,1,2
3,201392388,2170660915,58003,36895,2024-10-04 19:29:41,0,0,0,0,0,0
3,201392388,2170660915,0,0,2024-10-04 19:29:42,0,84,84,0,1,1
3,201392388,2170660915,58003,36895,2024-10-04 19:29:42,0,0,0,0,0,0
3,201392388,2170660915,15529,36895,2024-10-04 19:29:43,666,507,1173,6,6,12
3,201392388,2170660915,0,0,2024-10-04 19:29:43,0,0,0,0,0,0
3,201392388,2170660915,58003,36895,2024-10-04 19:29:43,0,0,0,0,0,0
3,201392388,2170660915,15529,36895,2024-10-04 19:29:44,0,0,0,0,0,0
3,201392388,2170660915,0,0,2024-10-04 19:29:44,128,84,212,1,1,2
3,201392388,2170660915,58003,36895,2024-10-04 19:29:44,0,0,0,0,0,0
3,201392388,2170660915,15529,36895,2024-10-04 19:29:45,0,0,0,0,0,0
3,201392388,2170660915,0,0,2024-10-04 19:29:45,128,84,212,1,1,2
3,201392388,2170660915,58003,36895,2024-10-04 19:29:45,0,0,0,0,0,0
3,201392388,2170660915,15529,36895,2024-10-04 19:29:46,0,0,0,0,0,0
3,201392388,2170660915,0,0,2024-10-04 19:29:46,128,84,212,1,1,2
3,201392388,2170660915,58003,36895,2024-10-04 19:29:46,0,0,0,0,0,0
3,201392388,2170660915,0,0,2024-10-04 19:29:47,0,0,0,0,0,0
3,201392388,2170660915,58003,36895,2024-10-04 19:29:47,0,0,0,0,0,0
3,201392388,2170660915,0,0,2024-10-04 19:29:48,0,0,0,0,0,0
3,201392388,2170660915,58003,36895,2024-10-04 19:29:48,0,0,0,0,0,0
3,201392388,2170660915,0,0,2024-10-04 19:29:49,128,0,128,1,0,1
3,201392388,2170660915,58003,36895,2024-10-04 19:29:49,0,0,0,0,0,0
3,201392388,2170660915,0,0,2024-10-04 19:29:50,128,84,212,1,1,2
3,201392388,2170660915,58003,36895,2024-10-04 19:29:50,0,0,0,0,0,0
3,201392388,2170660915,0,0,2024-10-04 19:29:51,128,84,212,1,1,2
3,201392388,2170660915,58003,36895,2024-10-04 19:29:51,0,0,0,0,0,0
3,201392388,1145490689,46811,47873,2024-10-04 19:29:52,4512,63611,68123,36,51,87
3,201392388,2170660915,0,0,2024-10-04 19:29:52,0,84,84,0,1,1
3,201392388,2170660915,58003,36895,2024-10-04 19:29:52,0,0,0,0,0,0
3,201392388,1145490689,46811,47873,2024-10-04 19:29:53,0,0,0,0,0,0
3,201392388,2170660915,0,0,2024-10-04 19:29:53,0,0,0,0,0,0
3,201392388,2170660915,58003,36895,2024-10-04 19:29:53,0,0,0,0,0,0
3,201392388,1145490689,46811,47873,2024-10-04 19:29:54,2040,35691,37731,20,27,47
3,201392388,2170660915,0,0,2024-10-04 19:29:54,0,0,0,0,0,0
3,201392388,2170660915,58003,36895,2024-10-04 19:29:54,0,0,0,0,0,0
3,201392388,1145490689,46811,47873,2024-10-04 19:29:55,0,0,0,0,0,0
3,201392388,2170660915,0,0,2024-10-04 19:29:55,0,0,0,0,0,0
3,201392388,2170660915,58003,36895,2024-10-04 19:29:55,0,0,0,0,0,0
3,201392388,2170660915,0,0,2024-10-04 19:29:56,0,0,0,0,0,0
3,201392388,2170660915,58003,36895,2024-10-04 19:29:56,0,0,0,0,0,0
3,201392388,2170660915,0,0,2024-10-04 19:29:57,0,0,0,0,0,0
3,201392388,2170660915,58003,36895,2024-10-04 19:29:57,0,0,0,0,0,0
3,201392388,2170660915,0,0,2024-10-04 19:29:58,0,0,0,0,0,0
3,201392388,2170660915,58003,36895,2024-10-04 19:29:58,0,0,0,0,0,0
3,201392388,2170660915,0,0,2024-10-04 19:29:59,0,0,0,0,0,0
3,201392388,2170660915,58003,36895,2024-10-04 19:29:59,0,0,0,0,0,0
3,201392388,2170660915,0,0,2024-10-04 19:30:00,0,0,0,0,0,0
3,201392388,2170660915,58003,36895,2024-10-04 19:30:00,0,0,0,0,0,0
3,201392388,2170660915,0,0,2024-10-04 19:30:01,0,0,0,0,0,0
3,201392388,2170660915,58003,36895,2024-10-04 19:30:01,0,0,0,0,0,0
3,201392388,2170660915,0,0,2024-10-04 19:30:02,0,0,0,0,0,0
3,201392388,2170660915,58003,36895,2024-10-04 19:30:02,0,0,0,0,0,0
3,201392388,2170660915,0,0,2024-10-04 19:30:03,128,0,128,1,0,1
3,201392388,2170660915,58003,36895,2024-10-04 19:30:03,0,0,0,0,0,0
3,201392388,2170660915,0,0,2024-10-04 19:30:04,128,84,212,1,1,2
3,201392388,2170660915,58003,36895,2024-10-04 19:30:04,0,0,0,0,0,0
3,201392388,2170660915,0,0,2024-10-04 19:30:05,128,84,212,1,1,2
3,201392388,2170660915,58003,36895,2024-10-04 19:30:05,0,0,0,0,0,0
3,201392388,2170660915,0,0,2024-10-04 19:30:06,128,84,212,1,1,2
3,201392388,2170660915,58003,36895,2024-10-04 19:30:06,0,0,0,0,0,0
3,201392388,2170660915,0,0,2024-10-04 19:30:07,128,168,296,1,2,3
3,201392388,2170660915,58003,36895,2024-10-04 19:30:07,0,0,0,0,0,0
3,201392388,2170660915,0,0,2024-10-04 19:30:08,128,84,212,1,1,2
3,201392388,2170660915,58003,36895,2024-10-04 19:30:08,0,0,0,0,0,0
3,201392388,2170660915,0,0,2024-10-04 19:30:09,128,84,212,1,1,2
3,201392388,2170660915,58003,36895,2024-10-04 19:30:09,0,0,0,0,0,0
3,201392388,2170660915,0,0,2024-10-04 19:30:10,128,84,212,1,1,2
3,201392388,2170660915,58003,36895,2024-10-04 19:30:10,0,0,0,0,0,0
3,201392388,2170660915,0,0,2024-10-04 19:30:11,128,84,212,1,1,2
3,201392388,2170660915,58003,36895,2024-10-04 19:30:11,0,0,0,0,0,0
3,201392388,2170660915,0,0,2024-10-04 19:30:12,128,84,212,1,1,2
3,201392388,2170660915,58003,36895,2024-10-04 19:30:12,0,0,0,0,0,0
3,201392388,2170660915,0,0,2024-10-04 19:30:13,0,0,0,0,0,0
3,201392388,2170660915,58003,36895,2024-10-04 19:30:13,0,0,0,0,0,0
3,201392388,2170660915,52870,36895,2024-10-04 19:30:14,666,507,1173,6,6,12
3,201392388,2170660915,0,0,2024-10-04 19:30:14,0,0,0,0,0,0
3,201392388,2170660915,58003,36895,2024-10-04 19:30:14,0,0,0,0,0,0
3,201392388,2170660915,52870,36895,2024-10-04 19:30:15,0,0,0,0,0,0
3,201392388,2170660915,0,0,2024-10-04 19:30:15,128,84,212,1,1,2
3,201392388,2170660915,58003,36895,2024-10-04 19:30:15,0,0,0,0,0,0
3,201392388,2170660915,52870,36895,2024-10-04 19:30:16,0,0,0,0,0,0
3,201392388,2170660915,0,0,2024-10-04 19:30:16,128,84,212,1,1,2
3,201392388,2170660915,58003,36895,2024-10-04 19:30:16,0,0,0,0,0,0
3,201392388,2170660915,52870,36895,2024-10-04 19:30:17,0,0,0,0,0,0
3,201392388,2170660915,0,0,2024-10-04 19:30:17,128,84,212,1,1,2
3,201392388,2170660915,58003,36895,2024-10-04 19:30:17,0,0,0,0,0,0
3,201392388,2170660915,0,0,2024-10-04 19:30:18,0,0,0,0,0,0
3,201392388,2170660915,58003,36895,2024-10-04 19:30:18,0,0,0,0,0,0
3,201392388,2170660915,0,0,2024-10-04 19:30:19,0,0,0,0,0,0
3,201392388,2170660915,58003,36895,2024-10-04 19:30:19,0,0,0,0,0,0
3,201392388,2170660915,0,0,2024-10-04 19:30:20,128,84,212,1,1,2
3,201392388,2170660915,58003,36895,2024-10-04 19:30:20,0,0,0,0,0,0
3,201392388,2170660915,0,0,2024-10-04 19:30:21,128,84,212,1,1,2
3,201392388,2170660915,58003,36895,2024-10-04 19:30:21,0,0,0,0,0,0
3,201392388,1145490691,16576,47873,2024-10-04 19:30:22,3048,29249,32297,22,28,50
3,201392388,2170660915,0,0,2024-10-04 19:30:22,128,84,212,1,1,2
3,201392388,2170660915,58003,36895,2024-10-04 19:30:22,0,0,0,0,0,0
3,201392388,1145490691,16576,47873,2024-10-04 19:30:23,0,0,0,0,0,0
3,201392388,2170660915,0,0,2024-10-04 19:30:23,0,0,0,0,0,0
3,201392388,2170660915,58003,36895,2024-10-04 19:30:23,0,0,0,0,0,0
3,201392388,1145490691,16576,47873,2024-10-04 19:30:24,0,0,0,0,0,0
3,201392388,2170660915,0,0,2024-10-04 19:30:24,0,0,0,0,0,0
3,201392388,2170660915,58003,36895,2024-10-04 19:30:24,0,0,0,0,0,0
3,201392388,1145490691,16576,47873,2024-10-04 19:30:25,3480,67915,71395,34,47,81
3,201392388,2170660915,0,0,2024-10-04 19:30:25,0,0,0,0,0,0
3,201392388,2170660915,58003,36895,2024-10-04 19:30:25,0,0,0,0,0,0
3,201392388,1145490691,16576,47873,2024-10-04 19:30:26,0,0,0,0,0,0
3,201392388,2170660915,0,0,2024-10-04 19:30:26,0,0,0,0,0,0
3,201392388,2170660915,58003,36895,2024-10-04 19:30:26,0,0,0,0,0,0
3,201392388,2170660915,0,0,2024-10-04 19:30:27,0,0,0,0,0,0
3,201392388,2170660915,58003,36895,2024-10-04 19:30:27,0,0,0,0,0,0
3,201392388,2170660915,0,0,2024-10-04 19:30:28,0,0,0,0,0,0
3,201392388,2170660915,58003,36895,2024-10-04 19:30:28,0,0,0,0,0,0
3,201392388,2170660915,0,0,2024-10-04 19:30:29,0,0,0,0,0,0
3,201392388,2170660915,58003,36895,2024-10-04 19:30:29,0,0,0,0,0,0
3,201392388,2170660915,0,0,2024-10-04 19:30:30,0,0,0,0,0,0
3,201392388,2170660915,58003,36895,2024-10-04 19:30:30,0,0,0,0,0,0
3,201392388,2170660915,0,0,2024-10-04 19:30:31,0,0,0,0,0,0
3,201392388,2170660915,58003,36895,2024-10-04 19:30:31,0,0,0,0,0,0
3,201392388,2170660915,0,0,2024-10-04 19:30:32,0,0,0,0,0,0
3,201392388,2170660915,58003,36895,2024-10-04 19:30:32,0,0,0,0,0,0
3,201392388,2170660915,0,0,2024-10-04 19:30:33,128,0,128,1,0,1
3,201392388,2170660915,58003,36895,2024-10-04 19:30:33,0,0,0,0,0,0
3,201392388,2170660915,0,0,2024-10-04 19:30:34,128,84,212,1,1,2
3,201392388,2170660915,58003,36895,2024-10-04 19:30:34,0,0,0,0,0,0
3,201392388,2170660915,0,0,2024-10-04 19:30:35,128,84,212,1,1,2
3,201392388,2170660915,58003,36895,2024-10-04 19:30:35,0,0,0,0,0,0
3,201392388,2170660915,0,0,2024-10-04 19:30:36,128,84,212,1,1,2
3,201392388,2170660915,58003,36895,2024-10-04 19:30:36,0,0,0,0,0,0
3,201392388,2170660915,0,0,2024-10-04 19:30:37,128,84,212,1,1,2
3,201392388,2170660915,58003,36895,2024-10-04 19:30:37,0,0,0,0,0,0
3,201392388,2170660915,0,0,2024-10-04 19:30:38,128,84,212,1,1,2
3,201392388,2170660915,58003,36895,2024-10-04 19:30:38,0,0,0,0,0,0
3,201392388,2170660915,0,0,2024-10-04 19:30:39,0,84,84,0,1,1
3,201392388,2170660915,58003,36895,2024-10-04 19:30:39,0,0,0,0,0,0
3,201392388,2170660915,0,0,2024-10-04 19:30:40,128,84,212,1,1,2
3,201392388,2170660915,58003,36895,2024-10-04 19:30:40,0,0,0,0,0,0
3,201392388,2170660915,0,0,2024-10-04 19:30:41,256,84,340,2,1,3
3,201392388,2170660915,58003,36895,2024-10-04 19:30:41,0,0,0,0,0,0
3,201392388,2170660915,0,0,2024-10-04 19:30:42,0,84,84,0,1,1
3,201392388,2170660915,58003,36895,2024-10-04 19:30:42,0,0,0,0,0,0
3,201392388,2170660915,0,0,2024-10-04 19:30:43,128,84,212,1,1,2
3,201392388,2170660915,58003,36895,2024-10-04 19:30:43,0,0,0,0,0,0
3,201392388,2170660915,3819,36895,2024-10-04 19:30:44,666,507,1173,6,6,12
3,201392388,2170660915,0,0,2024-10-04 19:30:44,0,0,0,0,0,0
3,201392388,2170660915,58003,36895,2024-10-04 19:30:44,0,0,0,0,0,0
3,201392388,2170660915,3819,36895,2024-10-04 19:30:45,0,0,0,0,0,0
3,201392388,2170660915,0,0,2024-10-04 19:30:45,128,84,212,1,1,2
3,201392388,2170660915,58003,36895,2024-10-04 19:30:45,0,0,0,0,0,0
3,201392388,2170660915,3819,36895,2024-10-04 19:30:46,0,0,0,0,0,0
3,201392388,2170660915,0,0,2024-10-04 19:30:46,128,84,212,1,1,2
3,201392388,2170660915,58003,36895,2024-10-04 19:30:46,0,0,0,0,0,0
3,201392388,2170660915,3819,36895,2024-10-04 19:30:47,0,0,0,0,0,0
3,201392388,2170660915,0,0,2024-10-04 19:30:47,128,84,212,1,1,2
3,201392388,2170660915,58003,36895,2024-10-04 19:30:47,0,0,0,0,0,0
3,201392388,2170660915,3819,36895,2024-10-04 19:30:48,0,0,0,0,0,0
3,201392388,2170660915,0,0,2024-10-04 19:30:48,0,0,0,0,0,0
3,201392388,2170660915,58003,36895,2024-10-04 19:30:48,0,0,0,0,0,0
3,201392388,2170660915,0,0,2024-10-04 19:30:49,0,0,0,0,0,0
3,201392388,2170660915,58003,36895,2024-10-04 19:30:49,0,0,0,0,0,0
3,201392388,2170660915,0,0,2024-10-04 19:30:50,128,0,128,1,0,1
3,201392388,2170660915,58003,36895,2024-10-04 19:30:50,0,0,0,0,0,0
3,201392388,2170660915,0,0,2024-10-04 19:30:51,128,84,212,1,1,2
3,201392388,2170660915,58003,36895,2024-10-04 19:30:51,0,0,0,0,0,0
3,201392388,2170660915,0,0,2024-10-04 19:30:52,128,84,212,1,1,2
3,201392388,2170660915,58003,36895,2024-10-04 19:30:52,0,0,0,0,0,0
3,201392388,1145490689,54498,47873,2024-10-04 19:30:53,5104,69239,74343,42,54,96
3,201392388,2170660915,0,0,2024-10-04 19:30:53,0,84,84,0,1,1
3,201392388,2170660915,58003,36895,2024-10-04 19:30:53,0,0,0,0,0,0
3,201392388,1145490689,54498,47873,2024-10-04 19:30:54,0,0,0,0,0,0
3,201392388,2170660915,0,0,2024-10-04 19:30:54,0,0,0,0,0,0
3,201392388,2170660915,58003,36895,2024-10-04 19:30:54,0,0,0,0,0,0
3,201392388,1145490689,54498,47873,2024-10-04 19:30:55,0,0,0,0,0,0
3,201392388,2170660915,0,0,2024-10-04 19:30:55,0,0,0,0,0,0
3,201392388,2170660915,58003,36895,2024-10-04 19:30:55,0,0,0,0,0,0
3,201392388,1145490689,54498,47873,2024-10-04 19:30:56,1728,27925,29653,17,21,38
3,201392388,2170660915,0,0,2024-10-04 19:30:56,0,0,0,0,0,0
3,201392388,2170660915,58003,36895,2024-10-04 19:30:56,0,0,0,0,0,0
3,201392388,1145490689,54498,47873,2024-10-04 19:30:57,0,0,0,0,0,0
3,201392388,2170660915,0,0,2024-10-04 19:30:57,0,0,0,0,0,0
3,201392388,2170660915,58003,36895,2024-10-04 19:30:57,0,0,0,0,0,0
3,201392388,1145490689,54498,47873,2024-10-04 19:30:58,0,0,0,0,0,0
3,201392388,2170660915,0,0,2024-10-04 19:30:58,0,0,0,0,0,0
3,201392388,2170660915,58003,36895,2024-10-04 19:30:58,0,0,0,0,0,0
3,201392388,2170660915,0,0,2024-10-04 19:30:59,0,0,0,0,0,0
3,201392388,2170660915,58003,36895,2024-10-04 19:30:59,0,0,0,0,0,0
3,201392388,2170660915,0,0,2024-10-04 19:31:00,0,0,0,0,0,0
3,201392388,2170660915,58003,36895,2024-10-04 19:31:00,0,0,0,0,0,0
3,201392388,2170660915,0,0,2024-10-04 19:31:01,0,0,0,0,0,0
3,201392388,2170660915,58003,36895,2024-10-04 19:31:01,0,0,0,0,0,0
3,201392388,2170660915,0,0,2024-10-04 19:31:02,0,0,0,0,0,0
3,201392388,2170660915,58003,36895,2024-10-04 19:31:02,0,0,0,0,0,0
3,201392388,2170660915,0,0,2024-10-04 19:31:03,128,0,128,1,0,1
3,201392388,2170660915,58003,36895,2024-10-04 19:31:03,0,0,0,0,0,0
3,201392388,2170660915,0,0,2024-10-04 19:31:04,128,84,212,1,1,2
3,201392388,2170660915,58003,36895,2024-10-04 19:31:04,0,0,0,0,0,0
3,201392388,2170660915,0,0,2024-10-04 19:31:05,128,84,212,1,1,2
3,201392388,2170660915,58003,36895,2024-10-04 19:31:05,0,0,0,0,0,0
3,201392388,2170660915,0,0,2024-10-04 19:31:06,128,84,212,1,1,2
3,201392388,2170660915,58003,36895,2024-10-04 19:31:06,0,0,0,0,0,0
3,201392388,2170660915,0,0,2024-10-04 19:31:07,128,84,212,1,1,2
3,201392388,2170660915,58003,36895,2024-10-04 19:31:07,0,0,0,0,0,0
3,201392388,2170660915,0,0,2024-10-04 19:31:08,128,84,212,1,1,2
3,201392388,2170660915,58003,36895,2024-10-04 19:31:08,0,0,0,0,0,0
3,201392388,2170660915,0,0,2024-10-04 19:31:09,0,84,84,0,1,1
3,201392388,2170660915,58003,36895,2024-10-04 19:31:09,0,0,0,0,0,0
3,201392388,2170660915,0,0,2024-10-04 19:31:10,128,84,212,1,1,2
3,201392388,2170660915,58003,36895,2024-10-04 19:31:10,0,0,0,0,0,0
3,201392388,2170660915,0,0,2024-10-04 19:31:11,128,84,212,1,1,2
3,201392388,2170660915,58003,36895,2024-10-04 19:31:11,0,0,0,0,0,0
3,201392388,2170660915,0,0,2024-10-04 19:31:12,128,84,212,1,1,2
3,201392388,2170660915,58003,36895,2024-10-04 19:31:12,0,0,0,0,0,0
3,201392388,2170660915,0,0,2024-10-04 19:31:13,128,84,212,1,1,2
3,201392388,2170660915,58003,36895,2024-10-04 19:31:13,0,0,0,0,0,0
3,201392388,2170660915,0,0,2024-10-04 19:31:14,0,0,0,0,0,0
3,201392388,2170660915,58003,36895,2024-10-04 19:31:14,0,0,0,0,0,0
3,201392388,2170660915,38084,36895,2024-10-04 19:31:15,666,507,1173,6,6,12
3,201392388,2170660915,0,0,2024-10-04 19:31:15,0,0,0,0,0,0
3,201392388,2170660915,58003,36895,2024-10-04 19:31:15,0,0,0,0,0,0
3,201392388,2170660915,38084,36895,2024-10-04 19:31:16,0,0,0,0,0,0
3,201392388,2170660915,0,0,2024-10-04 19:31:16,128,84,212,1,1,2
3,201392388,2170660915,58003,36895,2024-10-04 19:31:16,0,0,0,0,0,0
3,201392388,2170660915,38084,36895,2024-10-04 19:31:17,0,0,0,0,0,0
3,201392388,2170660915,0,0,2024-10-04 19:31:17,128,84,212,1,1,2
3,201392388,2170660915,58003,36895,2024-10-04 19:31:17,0,0,0,0,0,0
3,201392388,2170660915,38084,36895,2024-10-04 19:31:18,0,0,0,0,0,0
3,201392388,2170660915,0,0,2024-10-04 19:31:18,128,84,212,1,1,2
3,201392388,2170660915,58003,36895,2024-10-04 19:31:18,0,0,0,0,0,0
3,201392388,2170660915,0,0,2024-10-04 19:31:19,0,0,0,0,0,0
3,201392388,2170660915,58003,36895,2024-10-04 19:31:19,0,0,0,0,0,0
3,201392388,2170660915,0,0,2024-10-04 19:31:20,0,0,0,0,0,0
3,201392388,2170660915,58003,36895,2024-10-04 19:31:20,0,0,0,0,0,0
3,201392388,2170660915,0,0,2024-10-04 19:31:21,0,0,0,0,0,0
3,201392388,2170660915,58003,36895,2024-10-04 19:31:21,0,0,0,0,0,0
3,201392388,2170660915,0,0,2024-10-04 19:31:22,256,168,424,2,2,4
3,201392388,2170660915,58003,36895,2024-10-04 19:31:22,0,0,0,0,0,0
3,201392388,2170660915,0,0,2024-10-04 19:31:23,128,84,212,1,1,2
3,201392388,2170660915,58003,36895,2024-10-04 19:31:23,0,0,0,0,0,0
3,201392388,1145490691,35029,47873,2024-10-04 19:31:24,5160,83565,88725,43,66,109
3,201392388,2170660915,0,0,2024-10-04 19:31:24,0,0,0,0,0,0
3,201392388,2170660915,58003,36895,2024-10-04 19:31:24,0,0,0,0,0,0
3,201392388,1145490691,35029,47873,2024-10-04 19:31:25,0,0,0,0,0,0
3,201392388,2170660915,0,0,2024-10-04 19:31:25,0,0,0,0,0,0
3,201392388,2170660915,58003,36895,2024-10-04 19:31:25,0,0,0,0,0,0
3,201392388,1145490691,35029,47873,2024-10-04 19:31:26,0,0,0,0,0,0
3,201392388,2170660915,0,0,2024-10-04 19:31:26,0,0,0,0,0,0
3,201392388,2170660915,58003,36895,2024-10-04 19:31:26,0,0,0,0,0,0
3,201392388,1145490691,35029,47873,2024-10-04 19:31:27,1104,11743,12847,11,11,22
3,201392388,2170660915,0,0,2024-10-04 19:31:27,0,0,0,0,0,0
3,201392388,2170660915,58003,36895,2024-10-04 19:31:27,0,0,0,0,0,0
3,201392388,1145490691,35029,47873,2024-10-04 19:31:28,0,0,0,0,0,0
3,201392388,2170660915,0,0,2024-10-04 19:31:28,0,0,0,0,0,0
3,201392388,2170660915,58003,36895,2024-10-04 19:31:28,0,0,0,0,0,0
3,201392388,2170660915,0,0,2024-10-04 19:31:29,0,0,0,0,0,0
3,201392388,2170660915,58003,36895,2024-10-04 19:31:29,0,0,0,0,0,0
3,201392388,2170660915,0,0,2024-10-04 19:31:30,0,0,0,0,0,0
3,201392388,2170660915,58003,36895,2024-10-04 19:31:30,0,0,0,0,0,0
3,201392388,2170660915,0,0,2024-10-04 19:31:31,0,0,0,0,0,0
3,201392388,2170660915,58003,36895,2024-10-04 19:31:31,0,0,0,0,0,0
3,201392388,2170660915,0,0,2024-10-04 19:31:32,0,0,0,0,0,0
3,201392388,2170660915,58003,36895,2024-10-04 19:31:32,0,0,0,0,0,0
3,201392388,2170660915,0,0,2024-10-04 19:31:33,0,0,0,0,0,0
3,201392388,2170660915,58003,36895,2024-10-04 19:31:33,0,0,0,0,0,0
3,201392388,2170660915,0,0,2024-10-04 19:31:34,0,0,0,0,0,0
3,201392388,2170660915,58003,36895,2024-10-04 19:31:34,0,0,0,0,0,0
3,201392388,2170660915,0,0,2024-10-04 19:31:35,128,0,128,1,0,1
3,201392388,2170660915,58003,36895,2024-10-04 19:31:35,0,0,0,0,0,0
3,201392388,2170660915,0,0,2024-10-04 19:31:36,128,84,212,1,1,2
3,201392388,2170660915,58003,36895,2024-10-04 19:31:36,0,0,0,0,0,0
3,201392388,2170660915,0,0,2024-10-04 19:31:37,128,84,212,1,1,2
3,201392388,2170660915,58003,36895,2024-10-04 19:31:37,0,0,0,0,0,0
3,201392388,2170660915,0,0,2024-10-04 19:31:38,128,84,212,1,1,2
3,201392388,2170660915,58003,36895,2024-10-04 19:31:38,0,0,0,0,0,0
3,201392388,2170660915,0,0,2024-10-04 19:31:39,128,168,296,1,2,3
3,201392388,2170660915,58003,36895,2024-10-04 19:31:39,0,0,0,0,0,0
3,201392388,2170660915,0,0,2024-10-04 19:31:40,128,84,212,1,1,2
3,201392388,2170660915,58003,36895,2024-10-04 19:31:40,0,0,0,0,0,0
3,201392388,2170660915,0,0,2024-10-04 19:31:41,128,84,212,1,1,2
3,201392388,2170660915,58003,36895,2024-10-04 19:31:41,0,0,0,0,0,0
3,201392388,2170660915,0,0,2024-10-04 19:31:42,128,84,212,1,1,2
3,201392388,2170660915,58003,36895,2024-10-04 19:31:42,0,0,0,0,0,0
3,201392388,2170660915,0,0,2024-10-04 19:31:43,128,84,212,1,1,2
3,201392388,2170660915,58003,36895,2024-10-04 19:31:43,0,0,0,0,0,0
3,201392388,2170660915,0,0,2024-10-04 19:31:44,0,0,0,0,0,0
3,201392388,2170660915,58003,36895,2024-10-04 19:31:44,0,0,0,0,0,0
3,201392388,2170660915,0,0,2024-10-04 19:31:45,128,84,212,1,1,2
3,201392388,2170660915,58003,36895,2024-10-04 19:31:45,0,0,0,0,0,0
3,201392388,2170660915,35989,36895,2024-10-04 19:31:46,666,507,1173,6,6,12
3,201392388,2170660915,0,0,2024-10-04 19:31:46,0,0,0,0,0,0
3,201392388,2170660915,58003,36895,2024-10-04 19:31:46,0,0,0,0,0,0
3,201392388,2170660915,35989,36895,2024-10-04 19:31:47,0,0,0,0,0,0
3,201392388,2170660915,0,0,2024-10-04 19:31:47,128,84,212,1,1,2
3,201392388,2170660915,58003,36895,2024-10-04 19:31:47,0,0,0,0,0,0
3,201392388,2170660915,35989,36895,2024-10-04 19:31:48,0,0,0,0,0,0
3,201392388,2170660915,0,0,2024-10-04 19:31:48,128,84,212,1,1,2
3,201392388,2170660915,58003,36895,2024-10-04 19:31:48,0,0,0,0,0,0
3,201392388,2170660915,35989,36895,2024-10-04 19:31:49,0,0,0,0,0,0
3,201392388,2170660915,0,0,2024-10-04 19:31:49,128,84,212,1,1,2
3,201392388,2170660915,58003,36895,2024-10-04 19:31:49,0,0,0,0,0,0
3,201392388,2170660915,0,0,2024-10-04 19:31:50,0,0,0,0,0,0
3,201392388,2170660915,58003,36895,2024-10-04 19:31:50,0,0,0,0,0,0
3,201392388,2170660915,0,0,2024-10-04 19:31:51,0,0,0,0,0,0
3,201392388,2170660915,58003,36895,2024-10-04 19:31:51,0,0,0,0,0,0
3,201392388,2170660915,0,0,2024-10-04 19:31:52,0,0,0,0,0,0
3,201392388,2170660915,58003,36895,2024-10-04 19:31:52,0,0,0,0,0,0
3,201392388,2170660915,0,0,2024-10-04 19:31:53,256,84,340,2,1,3
3,201392388,2170660915,58003,36895,2024-10-04 19:31:53,0,0,0,0,0,0
3,201392388,1145490692,54929,47873,2024-10-04 19:31:54,3132,39049,42181,23,35,58
3,201392388,2170660915,0,0,2024-10-04 19:31:54,128,168,296,1,2,3
3,201392388,2170660915,58003,36895,2024-10-04 19:31:54,0,0,0,0,0,0
3,201392388,1145490692,54929,47873,2024-10-04 19:31:55,2040,51158,53198,20,33,53
3,201392388,2170660915,0,0,2024-10-04 19:31:55,0,0,0,0,0,0
3,201392388,2170660915,58003,36895,2024-10-04 19:31:55,0,0,0,0,0,0
3,201392388,1145490692,54929,47873,2024-10-04 19:31:56,0,0,0,0,0,0
3,201392388,2170660915,0,0,2024-10-04 19:31:56,0,0,0,0,0,0
3,201392388,2170660915,58003,36895,2024-10-04 19:31:56,0,0,0,0,0,0
3,201392388,1145490692,54929,47873,2024-10-04 19:31:57,1140,15197,16337,11,13,24
3,201392388,2170660915,0,0,2024-10-04 19:31:57,0,0,0,0,0,0
3,201392388,2170660915,58003,36895,2024-10-04 19:31:57,0,0,0,0,0,0
3,201392388,1145490692,54929,47873,2024-10-04 19:31:58,0,0,0,0,0,0
3,201392388,2170660915,0,0,2024-10-04 19:31:58,0,0,0,0,0,0
3,201392388,2170660915,58003,36895,2024-10-04 19:31:58,0,0,0,0,0,0
3,201392388,2170660915,0,0,2024-10-04 19:31:59,0,0,0,0,0,0
3,201392388,2170660915,58003,36895,2024-10-04 19:31:59,0,0,0,0,0,0
3,201392388,2170660915,0,0,2024-10-04 19:32:00,0,0,0,0,0,0
3,201392388,2170660915,58003,36895,2024-10-04 19:32:00,0,0,0,0,0,0
3,201392388,2170660915,0,0,2024-10-04 19:32:01,0,0,0,0,0,0
3,201392388,2170660915,58003,36895,2024-10-04 19:32:01,0,0,0,0,0,0
3,201392388,2170660915,0,0,2024-10-04 19:32:02,0,0,0,0,0,0
3,201392388,2170660915,58003,36895,2024-10-04 19:32:02,0,0,0,0,0,0
3,201392388,2170660915,0,0,2024-10-04 19:32:03,0,0,0,0,0,0
3,201392388,2170660915,58003,36895,2024-10-04 19:32:03,0,0,0,0,0,0
3,201392388,2170660915,0,0,2024-10-04 19:32:04,0,0,0,0,0,0
3,201392388,2170660915,58003,36895,2024-10-04 19:32:04,0,0,0,0,0,0
3,201392388,2170660915,0,0,2024-10-04 19:32:05,0,0,0,0,0,0
3,201392388,2170660915,58003,36895,2024-10-04 19:32:05,0,0,0,0,0,0
3,201392388,2170660915,0,0,2024-10-04 19:32:06,128,0,128,1,0,1
3,201392388,2170660915,58003,36895,2024-10-04 19:32:06,0,0,0,0,0,0
3,201392388,2170660915,0,0,2024-10-04 19:32:07,128,84,212,1,1,2
3,201392388,2170660915,58003,36895,2024-10-04 19:32:07,0,0,0,0,0,0
3,201392388,2170660915,0,0,2024-10-04 19:32:08,128,84,212,1,1,2
3,201392388,2170660915,58003,36895,2024-10-04 19:32:08,0,0,0,0,0,0
3,201392388,2170660915,0,0,2024-10-04 19:32:09,128,84,212,1,1,2
3,201392388,2170660915,58003,36895,2024-10-04 19:32:09,0,0,0,0,0,0
3,201392388,2170660915,0,0,2024-10-04 19:32:10,128,84,212,1,1,2
3,201392388,2170660915,58003,36895,2024-10-04 19:32:10,0,0,0,0,0,0
3,201392388,2170660915,0,0,2024-10-04 19:32:11,128,84,212,1,1,2
3,201392388,2170660915,58003,36895,2024-10-04 19:32:11,0,0,0,0,0,0
3,201392388,2170660915,0,0,2024-10-04 19:32:12,128,84,212,1,1,2
3,201392388,2170660915,58003,36895,2024-10-04 19:32:12,0,0,0,0,0,0
3,201392388,2170660915,0,0,2024-10-04 19:32:13,128,84,212,1,1,2
3,201392388,2170660915,58003,36895,2024-10-04 19:32:13,0,0,0,0,0,0
3,201392388,2170660915,0,0,2024-10-04 19:32:14,128,84,212,1,1,2
3,201392388,2170660915,58003,36895,2024-10-04 19:32:14,0,0,0,0,0,0
3,201392388,2170660915,0,0,2024-10-04 19:32:15,128,84,212,1,1,2
3,201392388,2170660915,58003,36895,2024-10-04 19:32:15,0,0,0,0,0,0
3,201392388,2170660915,0,0,2024-10-04 19:32:16,0,84,84,0,1,1
3,201392388,2170660915,58003,36895,2024-10-04 19:32:16,0,0,0,0,0,0
3,201392388,2170660915,52971,36895,2024-10-04 19:32:17,666,507,1173,6,6,12
3,201392388,2170660915,0,0,2024-10-04 19:32:17,128,0,128,1,0,1
3,201392388,2170660915,58003,36895,2024-10-04 19:32:17,0,0,0,0,0,0
3,201392388,2170660915,52971,36895,2024-10-04 19:32:18,0,0,0,0,0,0
3,201392388,2170660915,0,0,2024-10-04 19:32:18,128,84,212,1,1,2
3,201392388,2170660915,58003,36895,2024-10-04 19:32:18,0,0,0,0,0,0
3,201392388,2170660915,52971,36895,2024-10-04 19:32:19,0,0,0,0,0,0
3,201392388,2170660915,0,0,2024-10-04 19:32:19,128,84,212,1,1,2
3,201392388,2170660915,58003,36895,2024-10-04 19:32:19,0,0,0,0,0,0
3,201392388,2170660915,0,0,2024-10-04 19:32:20,0,84,84,0,1,1
3,201392388,2170660915,58003,36895,2024-10-04 19:32:20,0,0,0,0,0,0
3,201392388,2170660915,0,0,2024-10-04 19:32:21,0,0,0,0,0,0
3,201392388,2170660915,58003,36895,2024-10-04 19:32:21,0,0,0,0,0,0
3,201392388,2170660915,0,0,2024-10-04 19:32:22,0,0,0,0,0,0
3,201392388,2170660915,58003,36895,2024-10-04 19:32:22,0,0,0,0,0,0
3,201392388,2170660915,0,0,2024-10-04 19:32:23,128,84,212,1,1,2
3,201392388,2170660915,58003,36895,2024-10-04 19:32:23,0,0,0,0,0,0
3,201392388,2170660915,0,0,2024-10-04 19:32:24,128,84,212,1,1,2
3,201392388,2170660915,58003,36895,2024-10-04 19:32:24,0,0,0,0,0,0
3,201392388,1145490689,182,47873,2024-10-04 19:32:25,5036,80599,85635,40,62,102
3,201392388,2170660915,0,0,2024-10-04 19:32:25,128,84,212,1,1,2
3,201392388,2170660915,58003,36895,2024-10-04 19:32:25,0,0,0,0,0,0
3,201392388,1145490689,182,47873,2024-10-04 19:32:26,1020,14583,15603,10,13,23
3,201392388,2170660915,0,0,2024-10-04 19:32:26,0,0,0,0,0,0
3,201392388,2170660915,58003,36895,2024-10-04 19:32:26,0,0,0,0,0,0
3,201392388,1145490689,182,47873,2024-10-04 19:32:27,0,0,0,0,0,0
3,201392388,2170660915,0,0,2024-10-04 19:32:27,0,0,0,0,0,0
3,201392388,2170660915,58003,36895,2024-10-04 19:32:27,0,0,0,0,0,0
3,201392388,1145490689,182,47873,2024-10-04 19:32:28,0,0,0,0,0,0
3,201392388,2170660915,0,0,2024-10-04 19:32:28,0,0,0,0,0,0
3,201392388,2170660915,58003,36895,2024-10-04 19:32:28,0,0,0,0,0,0
3,201392388,1145490689,182,47873,2024-10-04 19:32:29,0,0,0,0,0,0
3,201392388,2170660915,0,0,2024-10-04 19:32:29,0,0,0,0,0,0
3,201392388,2170660915,58003,36895,2024-10-04 19:32:29,0,0,0,0,0,0
3,201392388,1145490689,182,47873,2024-10-04 19:32:30,0,0,0,0,0,0
3,201392388,2170660915,0,0,2024-10-04 19:32:30,0,0,0,0,0,0
3,201392388,2170660915,58003,36895,2024-10-04 19:32:30,0,0,0,0,0,0
3,201392388,1145490689,182,47873,2024-10-04 19:32:31,0,0,0,0,0,0
3,201392388,2170660915,0,0,2024-10-04 19:32:31,0,0,0,0,0,0
3,201392388,2170660915,58003,36895,2024-10-04 19:32:31,0,0,0,0,0,0
3,201392388,2170660915,0,0,2024-10-04 19:32:32,0,0,0,0,0,0
3,201392388,2170660915,58003,36895,2024-10-04 19:32:32,0,0,0,0,0,0
3,201392388,2170660915,0,0,2024-10-04 19:32:33,0,0,0,0,0,0
3,201392388,2170660915,58003,36895,2024-10-04 19:32:33,0,0,0,0,0,0
3,201392388,2170660915,0,0,2024-10-04 19:32:34,0,0,0,0,0,0
3,201392388,2170660915,58003,36895,2024-10-04 19:32:34,0,0,0,0,0,0
3,201392388,2170660915,0,0,2024-10-04 19:32:35,128,0,128,1,0,1
3,201392388,2170660915,58003,36895,2024-10-04 19:32:35,0,0,0,0,0,0
3,201392388,2170660915,0,0,2024-10-04 19:32:36,128,84,212,1,1,2
3,201392388,2170660915,58003,36895,2024-10-04 19:32:36,0,0,0,0,0,0
3,201392388,2170660915,0,0,2024-10-04 19:32:37,128,84,212,1,1,2
3,201392388,2170660915,58003,36895,2024-10-04 19:32:37,0,0,0,0,0,0
3,201392388,2170660915,0,0,2024-10-04 19:32:38,128,84,212,1,1,2
3,201392388,2170660915,58003,36895,2024-10-04 19:32:38,0,0,0,0,0,0
3,201392388,2170660915,0,0,2024-10-04 19:32:39,128,84,212,1,1,2
3,201392388,2170660915,58003,36895,2024-10-04 19:32:39,0,0,0,0,0,0
3,201392388,2170660915,0,0,2024-10-04 19:32:40,128,84,212,1,1,2
3,201392388,2170660915,58003,36895,2024-10-04 19:32:40,0,0,0,0,0,0
3,201392388,2170660915,0,0,2024-10-04 19:32:41,128,84,212,1,1,2
3,201392388,2170660915,58003,36895,2024-10-04 19:32:41,0,0,0,0,0,0
3,201392388,2170660915,0,0,2024-10-04 19:32:42,128,84,212,1,1,2
3,201392388,2170660915,58003,36895,2024-10-04 19:32:42,0,0,0,0,0,0
3,201392388,2170660915,0,0,2024-10-04 19:32:43,128,84,212,1,1,2
3,201392388,2170660915,58003,36895,2024-10-04 19:32:43,0,0,0,0,0,0
3,201392388,2170660915,0,0,2024-10-04 19:32:44,128,84,212,1,1,2
3,201392388,2170660915,58003,36895,2024-10-04 19:32:44,0,0,0,0,0,0
3,201392388,2170660915,0,0,2024-10-04 19:32:45,0,84,84,0,1,1
3,201392388,2170660915,58003,36895,2024-10-04 19:32:45,0,0,0,0,0,0
3,201392388,2170660915,0,0,2024-10-04 19:32:46,0,0,0,0,0,0
3,201392388,2170660915,58003,36895,2024-10-04 19:32:46,0,0,0,0,0,0
3,201392388,2170660915,16556,36895,2024-10-04 19:32:47,666,507,1173,6,6,12
3,201392388,2170660915,0,0,2024-10-04 19:32:47,128,0,128,1,0,1
3,201392388,2170660915,58003,36895,2024-10-04 19:32:47,0,0,0,0,0,0
3,201392388,2170660915,16556,36895,2024-10-04 19:32:48,0,0,0,0,0,0
3,201392388,2170660915,0,0,2024-10-04 19:32:48,128,84,212,1,1,2
3,201392388,2170660915,58003,36895,2024-10-04 19:32:48,0,0,0,0,0,0
3,201392388,2170660915,16556,36895,2024-10-04 19:32:49,0,0,0,0,0,0
3,201392388,2170660915,0,0,2024-10-04 19:32:49,128,84,212,1,1,2
3,201392388,2170660915,58003,36895,2024-10-04 19:32:49,0,0,0,0,0,0
3,201392388,2170660915,0,0,2024-10-04 19:32:50,0,84,84,0,1,1
3,201392388,2170660915,58003,36895,2024-10-04 19:32:50,0,0,0,0,0,0
3,201392388,2170660915,0,0,2024-10-04 19:32:51,0,0,0,0,0,0
3,201392388,2170660915,58003,36895,2024-10-04 19:32:51,0,0,0,0,0,0
3,201392388,2170660915,0,0,2024-10-04 19:32:52,0,0,0,0,0,0
3,201392388,2170660915,58003,36895,2024-10-04 19:32:52,0,0,0,0,0,0
3,201392388,2170660915,0,0,2024-10-04 19:32:53,128,84,212,1,1,2
3,201392388,2170660915,58003,36895,2024-10-04 19:32:53,0,0,0,0,0,0
3,201392388,2170660915,0,0,2024-10-04 19:32:54,0,0,0,0,0,0
3,201392388,2170660915,58003,36895,2024-10-04 19:32:54,0,0,0,0,0,0
3,201392388,1145490692,48846,47873,2024-10-04 19:32:55,3544,48797,52341,26,41,67
3,201392388,2170660915,0,0,2024-10-04 19:32:55,256,168,424,2,2,4
3,201392388,2170660915,58003,36895,2024-10-04 19:32:55,0,0,0,0,0,0
3,201392388,1145490692,48846,47873,2024-10-04 19:32:56,480,15850,16330,5,9,14
3,201392388,2170660915,0,0,2024-10-04 19:32:56,0,0,0,0,0,0
3,201392388,2170660915,58003,36895,2024-10-04 19:32:56,0,0,0,0,0,0
3,201392388,1145490692,48846,47873,2024-10-04 19:32:57,2364,44250,46614,24,29,53
3,201392388,2170660915,0,0,2024-10-04 19:32:57,0,0,0,0,0,0
3,201392388,2170660915,58003,36895,2024-10-04 19:32:57,0,0,0,0,0,0
3,201392388,1145490692,48846,47873,2024-10-04 19:32:58,516,2609,3125,5,5,10
3,201392388,2170660915,0,0,2024-10-04 19:32:58,0,0,0,0,0,0
3,201392388,2170660915,58003,36895,2024-10-04 19:32:58,0,0,0,0,0,0
3,201392388,1145490692,48846,47873,2024-10-04 19:32:59,0,0,0,0,0,0
3,201392388,2170660915,0,0,2024-10-04 19:32:59,0,0,0,0,0,0
3,201392388,2170660915,58003,36895,2024-10-04 19:32:59,0,0,0,0,0,0
3,201392388,1145490692,48846,47873,2024-10-04 19:33:00,0,0,0,0,0,0
3,201392388,2170660915,0,0,2024-10-04 19:33:00,0,0,0,0,0,0
3,201392388,2170660915,58003,36895,2024-10-04 19:33:00,0,0,0,0,0,0
3,201392388,1145490692,48846,47873,2024-10-04 19:33:01,0,0,0,0,0,0
3,201392388,2170660915,0,0,2024-10-04 19:33:01,0,0,0,0,0,0
3,201392388,2170660915,58003,36895,2024-10-04 19:33:01,0,0,0,0,0,0
3,201392388,1145490692,48846,47873,2024-10-04 19:33:02,0,0,0,0,0,0
3,201392388,2170660915,0,0,2024-10-04 19:33:02,0,0,0,0,0,0
3,201392388,2170660915,58003,36895,2024-10-04 19:33:02,0,0,0,0,0,0
3,201392388,1145490692,48846,47873,2024-10-04 19:33:03,0,0,0,0,0,0
3,201392388,2170660915,0,0,2024-10-04 19:33:03,0,0,0,0,0,0
3,201392388,2170660915,58003,36895,2024-10-04 19:33:03,0,0,0,0,0,0
3,201392388,1145490692,48846,47873,2024-10-04 19:33:04,0,0,0,0,0,0
3,201392388,2170660915,0,0,2024-10-04 19:33:04,0,0,0,0,0,0
3,201392388,2170660915,58003,36895,2024-10-04 19:33:04,0,0,0,0,0,0
3,201392388,1145490692,48846,47873,2024-10-04 19:33:05,0,0,0,0,0,0
3,201392388,2170660915,0,0,2024-10-04 19:33:05,0,0,0,0,0,0
3,201392388,2170660915,58003,36895,2024-10-04 19:33:05,0,0,0,0,0,0
3,201392388,1145490692,48846,47873,2024-10-04 19:33:06,0,0,0,0,0,0
3,201392388,2170660915,0,0,2024-10-04 19:33:06,0,0,0,0,0,0
3,201392388,2170660915,58003,36895,2024-10-04 19:33:06,0,0,0,0,0,0
3,201392388,2170660915,0,0,2024-10-04 19:33:07,128,0,128,1,0,1
3,201392388,2170660915,58003,36895,2024-10-04 19:33:07,0,0,0,0,0,0
3,201392388,2170660915,0,0,2024-10-04 19:33:08,128,84,212,1,1,2
3,201392388,2170660915,58003,36895,2024-10-04 19:33:08,0,0,0,0,0,0
3,201392388,2170660915,0,0,2024-10-04 19:33:09,128,84,212,1,1,2
3,201392388,2170660915,58003,36895,2024-10-04 19:33:09,0,0,0,0,0,0
3,201392388,2170660915,0,0,2024-10-04 19:33:10,0,84,84,0,1,1
3,201392388,2170660915,58003,36895,2024-10-04 19:33:10,0,0,0,0,0,0
3,201392388,2170660915,0,0,2024-10-04 19:33:11,128,84,212,1,1,2
3,201392388,2170660915,58003,36895,2024-10-04 19:33:11,0,0,0,0,0,0
3,201392388,2170660915,0,0,2024-10-04 19:33:12,128,84,212,1,1,2
3,201392388,2170660915,58003,36895,2024-10-04 19:33:12,0,0,0,0,0,0
3,201392388,2170660915,0,0,2024-10-04 19:33:13,128,84,212,1,1,2
3,201392388,2170660915,58003,36895,2024-10-04 19:33:13,0,0,0,0,0,0
3,201392388,2170660915,0,0,2024-10-04 19:33:14,128,84,212,1,1,2
3,201392388,2170660915,58003,36895,2024-10-04 19:33:14,0,0,0,0,0,0
3,201392388,2170660915,0,0,2024-10-04 19:33:15,128,84,212,1,1,2
3,201392388,2170660915,58003,36895,2024-10-04 19:33:15,0,0,0,0,0,0
3,201392388,2170660915,0,0,2024-10-04 19:33:16,128,84,212,1,1,2
3,201392388,2170660915,58003,36895,2024-10-04 19:33:16,0,0,0,0,0,0
3,201392388,2170660915,0,0,2024-10-04 19:33:17,128,84,212,1,1,2
3,201392388,2170660915,58003,36895,2024-10-04 19:33:17,0,0,0,0,0,0
3,201392388,2170660915,0,0,2024-10-04 19:33:18,0,0,0,0,0,0
3,201392388,2170660915,58003,36895,2024-10-04 19:33:18,0,0,0,0,0,0
3,201392388,2170660915,13967,36895,2024-10-04 19:33:19,666,507,1173,6,6,12
3,201392388,2170660915,0,0,2024-10-04 19:33:19,0,0,0,0,0,0
3,201392388,2170660915,58003,36895,2024-10-04 19:33:19,0,0,0,0,0,0
3,201392388,2170660915,13967,36895,2024-10-04 19:33:20,0,0,0,0,0,0
3,201392388,2170660915,0,0,2024-10-04 19:33:20,128,84,212,1,1,2
3,201392388,2170660915,58003,36895,2024-10-04 19:33:20,0,0,0,0,0,0
3,201392388,2170660915,13967,36895,2024-10-04 19:33:21,0,0,0,0,0,0
3,201392388,2170660915,0,0,2024-10-04 19:33:21,128,84,212,1,1,2
3,201392388,2170660915,58003,36895,2024-10-04 19:33:21,0,0,0,0,0,0
3,201392388,2170660915,13967,36895,2024-10-04 19:33:22,0,0,0,0,0,0
3,201392388,2170660915,0,0,2024-10-04 19:33:22,128,84,212,1,1,2
3,201392388,2170660915,58003,36895,2024-10-04 19:33:22,0,0,0,0,0,0
3,201392388,2170660915,0,0,2024-10-04 19:33:23,0,0,0,0,0,0
3,201392388,2170660915,58003,36895,2024-10-04 19:33:23,0,0,0,0,0,0
3,201392388,2170660915,0,0,2024-10-04 19:33:24,0,0,0,0,0,0
3,201392388,2170660915,58003,36895,2024-10-04 19:33:24,0,0,0,0,0,0
3,201392388,2170660915,0,0,2024-10-04 19:33:25,0,0,0,0,0,0
3,201392388,2170660915,58003,36895,2024-10-04 19:33:25,0,0,0,0,0,0
3,201392388,2170660915,0,0,2024-10-04 19:33:26,128,84,212,1,1,2
3,201392388,2170660915,58003,36895,2024-10-04 19:33:26,0,0,0,0,0,0
3,201392388,1145490690,40598,47873,2024-10-04 19:33:27,813,60,873,3,1,4
3,201392388,2170660915,0,0,2024-10-04 19:33:27,256,168,424,2,2,4
3,201392388,2170660915,58003,36895,2024-10-04 19:33:27,0,0,0,0,0,0
3,201392388,1145490690,40598,47873,2024-10-04 19:33:28,3243,57627,60870,29,44,73
3,201392388,2170660915,0,0,2024-10-04 19:33:28,0,0,0,0,0,0
3,201392388,2170660915,58003,36895,2024-10-04 19:33:28,0,0,0,0,0,0
3,201392388,1145490690,40598,47873,2024-10-04 19:33:29,0,0,0,0,0,0
3,201392388,2170660915,0,0,2024-10-04 19:33:29,0,0,0,0,0,0
3,201392388,2170660915,58003,36895,2024-10-04 19:33:29,0,0,0,0,0,0
3,201392388,1145490690,40598,47873,2024-10-04 19:33:30,2976,43597,46573,30,33,63
3,201392388,2170660915,0,0,2024-10-04 19:33:30,0,0,0,0,0,0
3,201392388,2170660915,58003,36895,2024-10-04 19:33:30,0,0,0,0,0,0
3,201392388,1145490690,40598,47873,2024-10-04 19:33:31,0,0,0,0,0,0
3,201392388,2170660915,0,0,2024-10-04 19:33:31,0,0,0,0,0,0
3,201392388,2170660915,58003,36895,2024-10-04 19:33:31,0,0,0,0,0,0
3,201392388,1145490690,40598,47873,2024-10-04 19:33:32,0,0,0,0,0,0
3,201392388,2170660915,0,0,2024-10-04 19:33:32,0,0,0,0,0,0
3,201392388,2170660915,58003,36895,2024-10-04 19:33:32,0,0,0,0,0,0
3,201392388,2170660915,0,0,2024-10-04 19:33:33,0,0,0,0,0,0
3,201392388,2170660915,58003,36895,2024-10-04 19:33:33,0,0,0,0,0,0
3,201392388,2170660915,0,0,2024-10-04 19:33:34,0,0,0,0,0,0
3,201392388,2170660915,58003,36895,2024-10-04 19:33:34,0,0,0,0,0,0
3,201392388,2170660915,0,0,2024-10-04 19:33:35,0,0,0,0,0,0
3,201392388,2170660915,58003,36895,2024-10-04 19:33:35,0,0,0,0,0,0
3,201392388,2170660915,0,0,2024-10-04 19:33:36,0,0,0,0,0,0
3,201392388,2170660915,58003,36895,2024-10-04 19:33:36,0,0,0,0,0,0
3,201392388,2170660915,0,0,2024-10-04 19:33:37,0,0,0,0,0,0
3,201392388,2170660915,58003,36895,2024-10-04 19:33:37,0,0,0,0,0,0
3,201392388,2170660915,0,0,2024-10-04 19:33:38,0,0,0,0,0,0
3,201392388,2170660915,58003,36895,2024-10-04 19:33:38,0,0,0,0,0,0
3,201392388,2170660915,0,0,2024-10-04 19:33:39,128,0,128,1,0,1
3,201392388,2170660915,58003,36895,2024-10-04 19:33:39,0,0,0,0,0,0
3,201392388,2170660915,0,0,2024-10-04 19:33:40,128,84,212,1,1,2
3,201392388,2170660915,58003,36895,2024-10-04 19:33:40,0,0,0,0,0,0
3,201392388,2170660915,0,0,2024-10-04 19:33:41,128,84,212,1,1,2
3,201392388,2170660915,58003,36895,2024-10-04 19:33:41,0,0,0,0,0,0
3,201392388,2170660915,0,0,2024-10-04 19:33:42,128,84,212,1,1,2
3,201392388,2170660915,58003,36895,2024-10-04 19:33:42,0,0,0,0,0,0
3,201392388,2170660915,0,0,2024-10-04 19:33:43,128,168,296,1,2,3
3,201392388,2170660915,58003,36895,2024-10-04 19:33:43,0,0,0,0,0,0
3,201392388,2170660915,0,0,2024-10-04 19:33:44,128,84,212,1,1,2
3,201392388,2170660915,58003,36895,2024-10-04 19:33:44,0,0,0,0,0,0
3,201392388,2170660915,0,0,2024-10-04 19:33:45,128,84,212,1,1,2
3,201392388,2170660915,58003,36895,2024-10-04 19:33:45,0,0,0,0,0,0
3,201392388,2170660915,0,0,2024-10-04 19:33:46,128,84,212,1,1,2
3,201392388,2170660915,58003,36895,2024-10-04 19:33:46,0,0,0,0,0,0
3,201392388,2170660915,0,0,2024-10-04 19:33:47,128,84,212,1,1,2
3,201392388,2170660915,58003,36895,2024-10-04 19:33:47,0,0,0,0,0,0
3,201392388,2170660915,0,0,2024-10-04 19:33:48,128,84,212,1,1,2
3,201392388,2170660915,58003,36895,2024-10-04 19:33:48,0,0,0,0,0,0
3,201392388,2170660915,0,0,2024-10-04 19:33:49,0,0,0,0,0,0
3,201392388,2170660915,58003,36895,2024-10-04 19:33:49,0,0,0,0,0,0
3,201392388,2170660915,10464,36895,2024-10-04 19:33:50,570,455,1025,5,5,10
3,201392388,2170660915,0,0,2024-10-04 19:33:50,0,0,0,0,0,0
3,201392388,2170660915,58003,36895,2024-10-04 19:33:50,0,0,0,0,0,0
3,201392388,2170660915,10464,36895,2024-10-04 19:33:51,0,0,0,0,0,0
3,201392388,2170660915,0,0,2024-10-04 19:33:51,128,84,212,1,1,2
3,201392388,2170660915,58003,36895,2024-10-04 19:33:51,0,0,0,0,0,0
3,201392388,2170660915,10464,36895,2024-10-04 19:33:52,0,0,0,0,0,0
3,201392388,2170660915,0,0,2024-10-04 19:33:52,128,84,212,1,1,2
3,201392388,2170660915,58003,36895,2024-10-04 19:33:52,0,0,0,0,0,0
3,201392388,2170660915,0,0,2024-10-04 19:33:53,128,84,212,1,1,2
3,201392388,2170660915,58003,36895,2024-10-04 19:33:53,0,0,0,0,0,0
3,201392388,2170660915,0,0,2024-10-04 19:33:54,0,0,0,0,0,0
3,201392388,2170660915,58003,36895,2024-10-04 19:33:54,0,0,0,0,0,0
3,201392388,2170660915,0,0,2024-10-04 19:33:55,0,0,0,0,0,0
3,201392388,2170660915,58003,36895,2024-10-04 19:33:55,0,0,0,0,0,0
3,201392388,2170660915,0,0,2024-10-04 19:33:56,0,0,0,0,0,0
3,201392388,2170660915,58003,36895,2024-10-04 19:33:56,0,0,0,0,0,0
3,201392388,2170660915,0,0,2024-10-04 19:33:57,128,84,212,1,1,2
3,201392388,2170660915,58003,36895,2024-10-04 19:33:57,0,0,0,0,0,0
3,201392388,2170660915,0,0,2024-10-04 19:33:58,128,84,212,1,1,2
3,201392388,2170660915,58003,36895,2024-10-04 19:33:58,0,0,0,0,0,0
3,201392388,1145490691,41638,47873,2024-10-04 19:33:59,2628,27637,30265,18,26,44
3,201392388,2170660915,0,0,2024-10-04 19:33:59,128,84,212,1,1,2
3,201392388,2170660915,58003,36895,2024-10-04 19:33:59,0,0,0,0,0,0
3,201392388,1145490691,41638,47873,2024-10-04 19:34:00,2544,61098,63642,25,40,65
3,201392388,2170660915,0,0,2024-10-04 19:34:00,0,0,0,0,0,0
3,201392388,2170660915,58003,36895,2024-10-04 19:34:00,0,0,0,0,0,0
3,201392388,1145490691,41638,47873,2024-10-04 19:34:01,912,12549,13461,9,12,21
3,201392388,2170660915,0,0,2024-10-04 19:34:01,0,0,0,0,0,0
3,201392388,2170660915,58003,36895,2024-10-04 19:34:01,0,0,0,0,0,0
3,201392388,1145490691,41638,47873,2024-10-04 19:34:02,0,0,0,0,0,0
3,201392388,2170660915,0,0,2024-10-04 19:34:02,0,0,0,0,0,0
3,201392388,2170660915,58003,36895,2024-10-04 19:34:02,0,0,0,0,0,0
3,201392388,2170660915,0,0,2024-10-04 19:34:03,0,0,0,0,0,0
3,201392388,2170660915,58003,36895,2024-10-04 19:34:03,0,0,0,0,0,0
3,201392388,2170660915,0,0,2024-10-04 19:34:04,0,0,0,0,0,0
3,201392388,2170660915,58003,36895,2024-10-04 19:34:04,0,0,0,0,0,0
3,201392388,2170660915,0,0,2024-10-04 19:34:05,0,0,0,0,0,0
3,201392388,2170660915,58003,36895,2024-10-04 19:34:05,0,0,0,0,0,0
3,201392388,2170660915,0,0,2024-10-04 19:34:06,0,0,0,0,0,0
3,201392388,2170660915,58003,36895,2024-10-04 19:34:06,0,0,0,0,0,0
3,201392388,2170660915,0,0,2024-10-04 19:34:07,0,0,0,0,0,0
3,201392388,2170660915,58003,36895,2024-10-04 19:34:07,0,0,0,0,0,0
3,201392388,2170660915,0,0,2024-10-04 19:34:08,0,0,0,0,0,0
3,201392388,2170660915,58003,36895,2024-10-04 19:34:08,0,0,0,0,0,0
3,201392388,2170660915,0,0,2024-10-04 19:34:09,0,0,0,0,0,0
3,201392388,2170660915,58003,36895,2024-10-04 19:34:09,0,0,0,0,0,0
3,201392388,2170660915,0,0,2024-10-04 19:34:10,128,0,128,1,0,1
3,201392388,2170660915,58003,36895,2024-10-04 19:34:10,0,0,0,0,0,0
3,201392388,2170660915,0,0,2024-10-04 19:34:11,128,84,212,1,1,2
3,201392388,2170660915,58003,36895,2024-10-04 19:34:11,0,0,0,0,0,0
3,201392388,2170660915,0,0,2024-10-04 19:34:12,128,84,212,1,1,2
3,201392388,2170660915,58003,36895,2024-10-04 19:34:12,0,0,0,0,0,0
3,201392388,2170660915,0,0,2024-10-04 19:34:13,128,84,212,1,1,2
3,201392388,2170660915,58003,36895,2024-10-04 19:34:13,0,0,0,0,0,0
3,201392388,2170660915,0,0,2024-10-04 19:34:14,128,84,212,1,1,2
3,201392388,2170660915,58003,36895,2024-10-04 19:34:14,0,0,0,0,0,0
3,201392388,2170660915,0,0,2024-10-04 19:34:15,128,84,212,1,1,2
3,201392388,2170660915,58003,36895,2024-10-04 19:34:15,0,0,0,0,0,0
3,201392388,2170660915,0,0,2024-10-04 19:34:16,128,84,212,1,1,2
3,201392388,2170660915,58003,36895,2024-10-04 19:34:16,0,0,0,0,0,0
3,201392388,2170660915,0,0,2024-10-04 19:34:17,128,84,212,1,1,2
3,201392388,2170660915,58003,36895,2024-10-04 19:34:17,0,0,0,0,0,0
3,201392388,2170660915,0,0,2024-10-04 19:34:18,128,84,212,1,1,2
3,201392388,2170660915,58003,36895,2024-10-04 19:34:18,0,0,0,0,0,0
3,201392388,2170660915,0,0,2024-10-04 19:34:19,128,84,212,1,1,2
3,201392388,2170660915,58003,36895,2024-10-04 19:34:19,0,0,0,0,0,0
3,201392388,2170660915,0,0,2024-10-04 19:34:20,0,84,84,0,1,1
3,201392388,2170660915,58003,36895,2024-10-04 19:34:20,0,0,0,0,0,0
3,201392388,2170660915,0,0,2024-10-04 19:34:21,0,0,0,0,0,0
3,201392388,2170660915,58003,36895,2024-10-04 19:34:21,0,0,0,0,0,0
3,201392388,2170660915,677,36895,2024-10-04 19:34:22,666,507,1173,6,6,12
3,201392388,2170660915,0,0,2024-10-04 19:34:22,0,0,0,0,0,0
3,201392388,2170660915,58003,36895,2024-10-04 19:34:22,0,0,0,0,0,0
3,201392388,2170660915,677,36895,2024-10-04 19:34:23,0,0,0,0,0,0
3,201392388,2170660915,0,0,2024-10-04 19:34:23,256,84,340,2,1,3
3,201392388,2170660915,58003,36895,2024-10-04 19:34:23,0,0,0,0,0,0
3,201392388,2170660915,0,0,2024-10-04 19:34:24,128,84,212,1,1,2
3,201392388,2170660915,58003,36895,2024-10-04 19:34:24,0,0,0,0,0,0
3,201392388,2170660915,0,0,2024-10-04 19:34:25,0,0,0,0,0,0
3,201392388,2170660915,58003,36895,2024-10-04 19:34:25,0,0,0,0,0,0
3,201392388,2170660915,0,0,2024-10-04 19:34:26,0,84,84,0,1,1
3,201392388,2170660915,58003,36895,2024-10-04 19:34:26,0,0,0,0,0,0
3,201392388,2170660915,0,0,2024-10-04 19:34:27,0,0,0,0,0,0
3,201392388,2170660915,58003,36895,2024-10-04 19:34:27,0,0,0,0,0,0
3,201392388,2170660915,0,0,2024-10-04 19:34:28,128,0,128,1,0,1
3,201392388,2170660915,58003,36895,2024-10-04 19:34:28,0,0,0,0,0,0
3,201392388,2170660915,0,0,2024-10-04 19:34:29,128,168,296,1,2,3
3,201392388,2170660915,58003,36895,2024-10-04 19:34:29,0,0,0,0,0,0
3,201392388,1145490689,18141,47873,2024-10-04 19:34:30,4596,67256,71852,36,53,89
3,201392388,2170660915,0,0,2024-10-04 19:34:30,128,84,212,1,1,2
3,201392388,2170660915,58003,36895,2024-10-04 19:34:30,0,0,0,0,0,0
3,201392388,1145490689,18141,47873,2024-10-04 19:34:31,288,13816,14104,3,8,11
3,201392388,2170660915,0,0,2024-10-04 19:34:31,0,0,0,0,0,0
3,201392388,2170660915,58003,36895,2024-10-04 19:34:31,0,0,0,0,0,0
3,201392388,1145490689,18141,47873,2024-10-04 19:34:32,2316,30486,32802,23,24,47
3,201392388,2170660915,0,0,2024-10-04 19:34:32,0,0,0,0,0,0
3,201392388,2170660915,58003,36895,2024-10-04 19:34:32,0,0,0,0,0,0
3,201392388,1145490689,18141,47873,2024-10-04 19:34:33,0,0,0,0,0,0
3,201392388,2170660915,0,0,2024-10-04 19:34:33,0,0,0,0,0,0
3,201392388,2170660915,58003,36895,2024-10-04 19:34:33,0,0,0,0,0,0
3,201392388,1145490689,18141,47873,2024-10-04 19:34:34,0,0,0,0,0,0
3,201392388,2170660915,0,0,2024-10-04 19:34:34,0,0,0,0,0,0
3,201392388,2170660915,58003,36895,2024-10-04 19:34:34,0,0,0,0,0,0
3,201392388,1145490689,18141,47873,2024-10-04 19:34:35,0,0,0,0,0,0
3,201392388,2170660915,0,0,2024-10-04 19:34:35,0,0,0,0,0,0
3,201392388,2170660915,58003,36895,2024-10-04 19:34:35,0,0,0,0,0,0
3,201392388,1145490689,18141,47873,2024-10-04 19:34:36,0,0,0,0,0,0
3,201392388,2170660915,0,0,2024-10-04 19:34:36,0,0,0,0,0,0
3,201392388,2170660915,58003,36895,2024-10-04 19:34:36,0,0,0,0,0,0
3,201392388,1145490689,18141,47873,2024-10-04 19:34:37,0,0,0,0,0,0
3,201392388,2170660915,0,0,2024-10-04 19:34:37,0,0,0,0,0,0
3,201392388,2170660915,58003,36895,2024-10-04 19:34:37,0,0,0,0,0,0
3,201392388,1145490689,18141,47873,2024-10-04 19:34:38,0,0,0,0,0,0
3,201392388,2170660915,0,0,2024-10-04 19:34:38,0,0,0,0,0,0
3,201392388,2170660915,58003,36895,2024-10-04 19:34:38,0,0,0,0,0,0
3,201392388,1145490689,18141,47873,2024-10-04 19:34:39,0,0,0,0,0,0
3,201392388,2170660915,0,0,2024-10-04 19:34:39,0,0,0,0,0,0
3,201392388,2170660915,58003,36895,2024-10-04 19:34:39,0,0,0,0,0,0
3,201392388,1145490689,18141,47873,2024-10-04 19:34:40,0,0,0,0,0,0
3,201392388,2170660915,0,0,2024-10-04 19:34:40,0,0,0,0,0,0
3,201392388,2170660915,58003,36895,2024-10-04 19:34:40,0,0,0,0,0,0
3,201392388,1145490689,18141,47873,2024-10-04 19:34:41,0,0,0,0,0,0
3,201392388,2170660915,0,0,2024-10-04 19:34:41,128,0,128,1,0,1
3,201392388,2170660915,58003,36895,2024-10-04 19:34:41,0,0,0,0,0,0
3,201392388,1145490689,18141,47873,2024-10-04 19:34:42,0,0,0,0,0,0
3,201392388,2170660915,0,0,2024-10-04 19:34:42,128,84,212,1,1,2
3,201392388,2170660915,58003,36895,2024-10-04 19:34:42,0,0,0,0,0,0
3,201392388,1145490689,18141,47873,2024-10-04 19:34:43,0,0,0,0,0,0
3,201392388,2170660915,0,0,2024-10-04 19:34:43,128,84,212,1,1,2
3,201392388,2170660915,58003,36895,2024-10-04 19:34:43,0,0,0,0,0,0
3,201392388,1145490689,18141,47873,2024-10-04 19:34:44,0,0,0,0,0,0
3,201392388,2170660915,0,0,2024-10-04 19:34:44,128,84,212,1,1,2
3,201392388,2170660915,58003,36895,2024-10-04 19:34:44,0,0,0,0,0,0
3,201392388,1145490689,18141,47873,2024-10-04 19:34:45,0,0,0,0,0,0
3,201392388,2170660915,0,0,2024-10-04 19:34:45,128,84,212,1,1,2
3,201392388,2170660915,58003,36895,2024-10-04 19:34:45,0,0,0,0,0,0
3,201392388,1145490689,18141,47873,2024-10-04 19:34:46,0,0,0,0,0,0
3,201392388,2170660915,0,0,2024-10-04 19:34:46,128,84,212,1,1,2
3,201392388,2170660915,58003,36895,2024-10-04 19:34:46,0,0,0,0,0,0
3,201392388,1145490689,18141,47873,2024-10-04 19:34:47,0,0,0,0,0,0
3,201392388,2170660915,0,0,2024-10-04 19:34:47,128,84,212,1,1,2
3,201392388,2170660915,58003,36895,2024-10-04 19:34:47,0,0,0,0,0,0
3,201392388,1145490689,18141,47873,2024-10-04 19:34:48,0,0,0,0,0,0
3,201392388,2170660915,0,0,2024-10-04 19:34:48,128,84,212,1,1,2
3,201392388,2170660915,58003,36895,2024-10-04 19:34:48,0,0,0,0,0,0
3,201392388,1145490689,18141,47873,2024-10-04 19:34:49,0,0,0,0,0,0
3,201392388,2170660915,0,0,2024-10-04 19:34:49,128,84,212,1,1,2
3,201392388,2170660915,58003,36895,2024-10-04 19:34:49,0,0,0,0,0,0
3,201392388,1145490689,18141,47873,2024-10-04 19:34:50,0,0,0,0,0,0
3,201392388,2170660915,0,0,2024-10-04 19:34:50,128,84,212,1,1,2
3,201392388,2170660915,58003,36895,2024-10-04 19:34:50,0,0,0,0,0,0
3,201392388,1145490689,18141,47873,2024-10-04 19:34:51,0,0,0,0,0,0
3,201392388,2170660915,0,0,2024-10-04 19:34:51,0,0,0,0,0,0
3,201392388,2170660915,58003,36895,2024-10-04 19:34:51,0,0,0,0,0,0
3,201392388,1145490689,18141,47873,2024-10-04 19:34:52,0,0,0,0,0,0
3,201392388,2170660915,0,0,2024-10-04 19:34:52,0,84,84,0,1,1
3,201392388,2170660915,58003,36895,2024-10-04 19:34:52,0,0,0,0,0,0
3,201392388,2170660915,27372,36895,2024-10-04 19:34:53,666,507,1173,6,6,12
3,201392388,2170660915,0,0,2024-10-04 19:34:53,128,0,128,1,0,1
3,201392388,2170660915,58003,36895,2024-10-04 19:34:53,0,0,0,0,0,0
3,201392388,2170660915,27372,36895,2024-10-04 19:34:54,0,0,0,0,0,0
3,201392388,2170660915,0,0,2024-10-04 19:34:54,0,84,84,0,1,1
3,201392388,2170660915,58003,36895,2024-10-04 19:34:54,0,0,0,0,0,0
3,201392388,2170660915,0,0,2024-10-04 19:34:55,256,84,340,2,1,3
3,201392388,2170660915,58003,36895,2024-10-04 19:34:55,0,0,0,0,0,0
3,201392388,2170660915,0,0,2024-10-04 19:34:56,0,0,0,0,0,0
3,201392388,2170660915,58003,36895,2024-10-04 19:34:56,0,0,0,0,0,0
3,201392388,2170660915,0,0,2024-10-04 19:34:57,0,84,84,0,1,1
3,201392388,2170660915,58003,36895,2024-10-04 19:34:57,0,0,0,0,0,0
3,201392388,2170660915,0,0,2024-10-04 19:34:58,0,0,0,0,0,0
3,201392388,2170660915,58003,36895,2024-10-04 19:34:58,0,0,0,0,0,0
3,201392388,2170660915,0,0,2024-10-04 19:34:59,128,0,128,1,0,1
3,201392388,2170660915,58003,36895,2024-10-04 19:34:59,0,0,0,0,0,0
3,201392388,2170660915,0,0,2024-10-04 19:35:00,128,168,296,1,2,3
3,201392388,2170660915,58003,36895,2024-10-04 19:35:00,0,0,0,0,0,0
3,201392388,1145490689,44778,47873,2024-10-04 19:35:01,2532,20781,23313,17,23,40
3,201392388,2170660915,0,0,2024-10-04 19:35:01,128,84,212,1,1,2
3,201392388,2170660915,58003,36895,2024-10-04 19:35:01,0,0,0,0,0,0
3,201392388,1145490689,44778,47873,2024-10-04 19:35:02,4284,76435,80719,42,53,95
3,201392388,2170660915,0,0,2024-10-04 19:35:02,0,0,0,0,0,0
3,201392388,2170660915,58003,36895,2024-10-04 19:35:02,0,0,0,0,0,0
3,201392388,1145490689,44778,47873,2024-10-04 19:35:03,0,0,0,0,0,0
3,201392388,2170660915,0,0,2024-10-04 19:35:03,0,0,0,0,0,0
3,201392388,2170660915,58003,36895,2024-10-04 19:35:03,0,0,0,0,0,0
3,201392388,1145490689,44778,47873,2024-10-04 19:35:04,0,0,0,0,0,0
3,201392388,2170660915,0,0,2024-10-04 19:35:04,0,0,0,0,0,0
3,201392388,2170660915,58003,36895,2024-10-04 19:35:04,0,0,0,0,0,0
3,201392388,1145490689,44778,47873,2024-10-04 19:35:05,0,0,0,0,0,0
3,201392388,2170660915,0,0,2024-10-04 19:35:05,0,0,0,0,0,0
3,201392388,2170660915,58003,36895,2024-10-04 19:35:05,0,0,0,0,0,0
3,201392388,1145490689,44778,47873,2024-10-04 19:35:06,0,0,0,0,0,0
3,201392388,2170660915,0,0,2024-10-04 19:35:06,0,0,0,0,0,0
3,201392388,2170660915,58003,36895,2024-10-04 19:35:06,0,0,0,0,0,0
3,201392388,1145490689,44778,47873,2024-10-04 19:35:07,0,0,0,0,0,0
3,201392388,2170660915,0,0,2024-10-04 19:35:07,0,0,0,0,0,0
3,201392388,2170660915,58003,36895,2024-10-04 19:35:07,0,0,0,0,0,0
3,201392388,1145490689,44778,47873,2024-10-04 19:35:08,0,0,0,0,0,0
3,201392388,2170660915,0,0,2024-10-04 19:35:08,0,0,0,0,0,0
3,201392388,2170660915,58003,36895,2024-10-04 19:35:08,0,0,0,0,0,0
3,201392388,1145490689,44778,47873,2024-10-04 19:35:09,0,0,0,0,0,0
3,201392388,2170660915,0,0,2024-10-04 19:35:09,0,0,0,0,0,0
3,201392388,2170660915,58003,36895,2024-10-04 19:35:09,0,0,0,0,0,0
3,201392388,1145490689,44778,47873,2024-10-04 19:35:10,0,0,0,0,0,0
3,201392388,2170660915,0,0,2024-10-04 19:35:10,0,0,0,0,0,0
3,201392388,2170660915,58003,36895,2024-10-04 19:35:10,0,0,0,0,0,0
3,201392388,1145490689,44778,47873,2024-10-04 19:35:11,0,0,0,0,0,0
3,201392388,2170660915,0,0,2024-10-04 19:35:11,0,0,0,0,0,0
3,201392388,2170660915,58003,36895,2024-10-04 19:35:11,0,0,0,0,0,0
3,201392388,1145490689,44778,47873,2024-10-04 19:35:12,0,0,0,0,0,0
3,201392388,2170660915,0,0,2024-10-04 19:35:12,128,0,128,1,0,1
3,201392388,2170660915,58003,36895,2024-10-04 19:35:12,0,0,0,0,0,0
3,201392388,1145490689,44778,47873,2024-10-04 19:35:13,0,0,0,0,0,0
3,201392388,2170660915,0,0,2024-10-04 19:35:13,128,168,296,1,2,3
3,201392388,2170660915,58003,36895,2024-10-04 19:35:13,0,0,0,0,0,0
3,201392388,1145490689,44778,47873,2024-10-04 19:35:14,0,0,0,0,0,0
3,201392388,2170660915,0,0,2024-10-04 19:35:14,128,84,212,1,1,2
3,201392388,2170660915,58003,36895,2024-10-04 19:35:14,0,0,0,0,0,0
3,201392388,1145490689,44778,47873,2024-10-04 19:35:15,0,0,0,0,0,0
3,201392388,2170660915,0,0,2024-10-04 19:35:15,128,84,212,1,1,2
3,201392388,2170660915,58003,36895,2024-10-04 19:35:15,0,0,0,0,0,0
3,201392388,1145490689,44778,47873,2024-10-04 19:35:16,0,0,0,0,0,0
3,201392388,2170660915,0,0,2024-10-04 19:35:16,128,84,212,1,1,2
3,201392388,2170660915,58003,36895,2024-10-04 19:35:16,0,0,0,0,0,0
3,201392388,1145490689,44778,47873,2024-10-04 19:35:17,0,0,0,0,0,0
3,201392388,2170660915,0,0,2024-10-04 19:35:17,128,84,212,1,1,2
3,201392388,2170660915,58003,36895,2024-10-04 19:35:17,0,0,0,0,0,0
3,201392388,1145490689,44778,47873,2024-10-04 19:35:18,0,0,0,0,0,0
3,201392388,2170660915,0,0,2024-10-04 19:35:18,128,84,212,1,1,2
3,201392388,2170660915,58003,36895,2024-10-04 19:35:18,0,0,0,0,0,0
3,201392388,1145490689,44778,47873,2024-10-04 19:35:19,0,0,0,0,0,0
3,201392388,2170660915,0,0,2024-10-04 19:35:19,128,84,212,1,1,2
3,201392388,2170660915,58003,36895,2024-10-04 19:35:19,0,0,0,0,0,0
3,201392388,1145490689,44778,47873,2024-10-04 19:35:20,0,0,0,0,0,0
3,201392388,2170660915,0,0,2024-10-04 19:35:20,128,0,128,1,0,1
3,201392388,2170660915,58003,36895,2024-10-04 19:35:20,0,0,0,0,0,0
3,201392388,1145490689,44778,47873,2024-10-04 19:35:21,0,0,0,0,0,0
3,201392388,2170660915,0,0,2024-10-04 19:35:21,128,84,212,1,1,2
3,201392388,2170660915,58003,36895,2024-10-04 19:35:21,0,0,0,0,0,0
3,201392388,1145490689,44778,47873,2024-10-04 19:35:22,0,0,0,0,0,0
3,201392388,2170660915,0,0,2024-10-04 19:35:22,0,84,84,0,1,1
3,201392388,2170660915,58003,36895,2024-10-04 19:35:22,0,0,0,0,0,0
3,201392388,2170660915,49324,36895,2024-10-04 19:35:23,666,507,1173,6,6,12
3,201392388,2170660915,0,0,2024-10-04 19:35:23,0,0,0,0,0,0
3,201392388,2170660915,58003,36895,2024-10-04 19:35:23,0,0,0,0,0,0
3,201392388,2170660915,49324,36895,2024-10-04 19:35:24,0,0,0,0,0,0
3,201392388,2170660915,0,0,2024-10-04 19:35:24,128,84,212,1,1,2
3,201392388,2170660915,58003,36895,2024-10-04 19:35:24,0,0,0,0,0,0
3,201392388,2170660915,49324,36895,2024-10-04 19:35:25,0,0,0,0,0,0
3,201392388,2170660915,0,0,2024-10-04 19:35:25,128,84,212,1,1,2
3,201392388,2170660915,58003,36895,2024-10-04 19:35:25,0,0,0,0,0,0
3,201392388,2170660915,0,0,2024-10-04 19:35:26,128,84,212,1,1,2
3,201392388,2170660915,58003,36895,2024-10-04 19:35:26,0,0,0,0,0,0
3,201392388,2170660915,0,0,2024-10-04 19:35:27,0,0,0,0,0,0
3,201392388,2170660915,58003,36895,2024-10-04 19:35:27,0,0,0,0,0,0
3,201392388,2170660915,0,0,2024-10-04 19:35:28,0,0,0,0,0,0
3,201392388,2170660915,58003,36895,2024-10-04 19:35:28,0,0,0,0,0,0
3,201392388,2170660915,0,0,2024-10-04 19:35:29,128,0,128,1,0,1
3,201392388,2170660915,58003,36895,2024-10-04 19:35:29,0,0,0,0,0,0
3,201392388,2170660915,0,0,2024-10-04 19:35:30,128,84,212,1,1,2
3,201392388,2170660915,58003,36895,2024-10-04 19:35:30,0,0,0,0,0,0
3,201392388,2170660915,0,0,2024-10-04 19:35:31,128,84,212,1,1,2
3,201392388,2170660915,58003,36895,2024-10-04 19:35:31,0,0,0,0,0,0
3,201392388,1145490692,37013,47873,2024-10-04 19:35:32,2808,34863,37671,20,33,53
3,201392388,2170660915,0,0,2024-10-04 19:35:32,0,84,84,0,1,1
3,201392388,2170660915,58003,36895,2024-10-04 19:35:32,0,0,0,0,0,0
3,201392388,1145490692,37013,47873,2024-10-04 19:35:33,1152,27210,28362,11,17,28
3,201392388,2170660915,0,0,2024-10-04 19:35:33,0,0,0,0,0,0
3,201392388,2170660915,58003,36895,2024-10-04 19:35:33,0,0,0,0,0,0
3,201392388,1145490692,37013,47873,2024-10-04 19:35:34,1908,43405,45313,19,32,51
3,201392388,2170660915,0,0,2024-10-04 19:35:34,0,0,0,0,0,0
3,201392388,2170660915,58003,36895,2024-10-04 19:35:34,0,0,0,0,0,0
3,201392388,1145490692,37013,47873,2024-10-04 19:35:35,0,0,0,0,0,0
3,201392388,2170660915,0,0,2024-10-04 19:35:35,0,0,0,0,0,0
3,201392388,2170660915,58003,36895,2024-10-04 19:35:35,0,0,0,0,0,0
3,201392388,1145490692,37013,47873,2024-10-04 19:35:36,0,0,0,0,0,0
3,201392388,2170660915,0,0,2024-10-04 19:35:36,0,0,0,0,0,0
3,201392388,2170660915,58003,36895,2024-10-04 19:35:36,0,0,0,0,0,0
3,201392388,1145490692,37013,47873,2024-10-04 19:35:37,0,0,0,0,0,0
3,201392388,2170660915,0,0,2024-10-04 19:35:37,0,0,0,0,0,0
3,201392388,2170660915,58003,36895,2024-10-04 19:35:37,0,0,0,0,0,0
3,201392388,1145490692,37013,47873,2024-10-04 19:35:38,0,0,0,0,0,0
3,201392388,2170660915,0,0,2024-10-04 19:35:38,0,0,0,0,0,0
3,201392388,2170660915,58003,36895,2024-10-04 19:35:38,0,0,0,0,0,0
3,201392388,1145490692,37013,47873,2024-10-04 19:35:39,0,0,0,0,0,0
3,201392388,2170660915,0,0,2024-10-04 19:35:39,0,0,0,0,0,0
3,201392388,2170660915,58003,36895,2024-10-04 19:35:39,0,0,0,0,0,0
3,201392388,1145490692,37013,47873,2024-10-04 19:35:40,0,0,0,0,0,0
3,201392388,2170660915,0,0,2024-10-04 19:35:40,0,0,0,0,0,0
3,201392388,2170660915,58003,36895,2024-10-04 19:35:40,0,0,0,0,0,0
3,201392388,1145490692,37013,47873,2024-10-04 19:35:41,0,0,0,0,0,0
3,201392388,2170660915,0,0,2024-10-04 19:35:41,0,0,0,0,0,0
3,201392388,2170660915,58003,36895,2024-10-04 19:35:41,0,0,0,0,0,0
3,201392388,1145490692,37013,47873,2024-10-04 19:35:42,0,0,0,0,0,0
3,201392388,2170660915,0,0,2024-10-04 19:35:42,0,0,0,0,0,0
3,201392388,2170660915,58003,36895,2024-10-04 19:35:42,0,0,0,0,0,0
3,201392388,1145490692,37013,47873,2024-10-04 19:35:43,0,0,0,0,0,0
3,201392388,2170660915,0,0,2024-10-04 19:35:43,0,0,0,0,0,0
3,201392388,2170660915,58003,36895,2024-10-04 19:35:43,0,0,0,0,0,0
3,201392388,1145490692,37013,47873,2024-10-04 19:35:44,0,0,0,0,0,0
3,201392388,2170660915,0,0,2024-10-04 19:35:44,128,84,212,1,1,2
3,201392388,2170660915,58003,36895,2024-10-04 19:35:44,0,0,0,0,0,0
3,201392388,1145490692,37013,47873,2024-10-04 19:35:45,0,0,0,0,0,0
3,201392388,2170660915,0,0,2024-10-04 19:35:45,128,84,212,1,1,2
3,201392388,2170660915,58003,36895,2024-10-04 19:35:45,0,0,0,0,0,0
3,201392388,1145490692,37013,47873,2024-10-04 19:35:46,0,0,0,0,0,0
3,201392388,2170660915,0,0,2024-10-04 19:35:46,128,84,212,1,1,2
3,201392388,2170660915,58003,36895,2024-10-04 19:35:46,0,0,0,0,0,0
3,201392388,1145490692,37013,47873,2024-10-04 19:35:47,0,0,0,0,0,0
3,201392388,2170660915,0,0,2024-10-04 19:35:47,128,84,212,1,1,2
3,201392388,2170660915,58003,36895,2024-10-04 19:35:47,0,0,0,0,0,0
3,201392388,1145490692,37013,47873,2024-10-04 19:35:48,0,0,0,0,0,0
3,201392388,2170660915,0,0,2024-10-04 19:35:48,128,84,212,1,1,2
3,201392388,2170660915,58003,36895,2024-10-04 19:35:48,0,0,0,0,0,0
3,201392388,1145490692,37013,47873,2024-10-04 19:35:49,0,0,0,0,0,0
3,201392388,2170660915,0,0,2024-10-04 19:35:49,128,84,212,1,1,2
3,201392388,2170660915,58003,36895,2024-10-04 19:35:49,0,0,0,0,0,0
3,201392388,1145490692,37013,47873,2024-10-04 19:35:50,0,0,0,0,0,0
3,201392388,2170660915,0,0,2024-10-04 19:35:50,128,84,212,1,1,2
3,201392388,2170660915,58003,36895,2024-10-04 19:35:50,0,0,0,0,0,0
3,201392388,1145490692,37013,47873,2024-10-04 19:35:51,0,0,0,0,0,0
3,201392388,2170660915,0,0,2024-10-04 19:35:51,128,84,212,1,1,2
3,201392388,2170660915,58003,36895,2024-10-04 19:35:51,0,0,0,0,0,0
3,201392388,1145490692,37013,47873,2024-10-04 19:35:52,0,0,0,0,0,0
3,201392388,2170660915,0,0,2024-10-04 19:35:52,128,84,212,1,1,2
3,201392388,2170660915,58003,36895,2024-10-04 19:35:52,0,0,0,0,0,0
3,201392388,1145490692,37013,47873,2024-10-04 19:35:53,0,0,0,0,0,0
3,201392388,2170660915,0,0,2024-10-04 19:35:53,128,84,212,1,1,2
3,201392388,2170660915,58003,36895,2024-10-04 19:35:53,0,0,0,0,0,0
3,201392388,1145490692,37013,47873,2024-10-04 19:35:54,0,0,0,0,0,0
3,201392388,2170660915,0,0,2024-10-04 19:35:54,0,0,0,0,0,0
3,201392388,2170660915,58003,36895,2024-10-04 19:35:54,0,0,0,0,0,0
3,201392388,1145490692,37013,47873,2024-10-04 19:35:55,0,0,0,0,0,0
3,201392388,2170660915,0,0,2024-10-04 19:35:55,0,0,0,0,0,0
3,201392388,2170660915,58003,36895,2024-10-04 19:35:55,0,0,0,0,0,0
3,201392388,2170660915,39044,36895,2024-10-04 19:35:56,666,507,1173,6,6,12
3,201392388,2170660915,0,0,2024-10-04 19:35:56,128,84,212,1,1,2
3,201392388,2170660915,58003,36895,2024-10-04 19:35:56,0,0,0,0,0,0
3,201392388,2170660915,39044,36895,2024-10-04 19:35:57,0,0,0,0,0,0
3,201392388,2170660915,0,0,2024-10-04 19:35:57,0,0,0,0,0,0
3,201392388,2170660915,58003,36895,2024-10-04 19:35:57,0,0,0,0,0,0
3,201392388,2170660915,39044,36895,2024-10-04 19:35:58,0,0,0,0,0,0
3,201392388,2170660915,0,0,2024-10-04 19:35:58,128,84,212,1,1,2
3,201392388,2170660915,58003,36895,2024-10-04 19:35:58,0,0,0,0,0,0
3,201392388,2170660915,39044,36895,2024-10-04 19:35:59,0,0,0,0,0,0
3,201392388,2170660915,0,0,2024-10-04 19:35:59,128,84,212,1,1,2
3,201392388,2170660915,58003,36895,2024-10-04 19:35:59,0,0,0,0,0,0
3,201392388,2170660915,39044,36895,2024-10-04 19:36:00,0,0,0,0,0,0
3,201392388,2170660915,0,0,2024-10-04 19:36:00,0,0,0,0,0,0
3,201392388,2170660915,58003,36895,2024-10-04 19:36:00,0,0,0,0,0,0
3,201392388,2170660915,39044,36895,2024-10-04 19:36:01,0,0,0,0,0,0
3,201392388,2170660915,0,0,2024-10-04 19:36:01,128,0,128,1,0,1
3,201392388,2170660915,58003,36895,2024-10-04 19:36:01,0,0,0,0,0,0
3,201392388,2170660915,39044,36895,2024-10-04 19:36:02,0,0,0,0,0,0
3,201392388,2170660915,0,0,2024-10-04 19:36:02,128,84,212,1,1,2
3,201392388,2170660915,58003,36895,2024-10-04 19:36:02,0,0,0,0,0,0
3,201392388,2170660915,39044,36895,2024-10-04 19:36:03,0,0,0,0,0,0
3,201392388,2170660915,0,0,2024-10-04 19:36:03,0,84,84,0,1,1
3,201392388,2170660915,58003,36895,2024-10-04 19:36:03,0,0,0,0,0,0
3,201392388,2170660915,39044,36895,2024-10-04 19:36:04,0,0,0,0,0,0
3,201392388,2170660915,0,0,2024-10-04 19:36:04,128,84,212,1,1,2
3,201392388,1145490691,24285,47873,2024-10-04 19:36:04,2520,24183,26703,17,24,41
3,201392388,2170660915,58003,36895,2024-10-04 19:36:04,0,0,0,0,0,0
3,201392388,2170660915,39044,36895,2024-10-04 19:36:05,0,0,0,0,0,0
3,201392388,2170660915,0,0,2024-10-04 19:36:05,0,0,0,0,0,0
3,201392388,1145490691,24285,47873,2024-10-04 19:36:05,3780,75015,78795,37,52,89
3,201392388,2170660915,58003,36895,2024-10-04 19:36:05,0,0,0,0,0,0
3,201392388,2170660915,39044,36895,2024-10-04 19:36:06,0,0,0,0,0,0
3,201392388,2170660915,0,0,2024-10-04 19:36:06,0,0,0,0,0,0
3,201392388,1145490691,24285,47873,2024-10-04 19:36:06,0,0,0,0,0,0
3,201392388,2170660915,58003,36895,2024-10-04 19:36:06,0,0,0,0,0,0
3,201392388,2170660915,39044,36895,2024-10-04 19:36:07,0,0,0,0,0,0
3,201392388,2170660915,0,0,2024-10-04 19:36:07,0,0,0,0,0,0
3,201392388,1145490691,24285,47873,2024-10-04 19:36:07,0,0,0,0,0,0
3,201392388,2170660915,58003,36895,2024-10-04 19:36:07,0,0,0,0,0,0
3,201392388,2170660915,39044,36895,2024-10-04 19:36:08,0,0,0,0,0,0
3,201392388,2170660915,0,0,2024-10-04 19:36:08,0,0,0,0,0,0
3,201392388,1145490691,24285,47873,2024-10-04 19:36:08,0,0,0,0,0,0
3,201392388,2170660915,58003,36895,2024-10-04 19:36:08,0,0,0,0,0,0
3,201392388,2170660915,39044,36895,2024-10-04 19:36:09,0,0,0,0,0,0
3,201392388,2170660915,0,0,2024-10-04 19:36:09,0,0,0,0,0,0
3,201392388,1145490691,24285,47873,2024-10-04 19:36:09,0,0,0,0,0,0
3,201392388,2170660915,58003,36895,2024-10-04 19:36:09,0,0,0,0,0,0
3,201392388,2170660915,39044,36895,2024-10-04 19:36:10,0,0,0,0,0,0
3,201392388,2170660915,0,0,2024-10-04 19:36:10,0,0,0,0,0,0
3,201392388,1145490691,24285,47873,2024-10-04 19:36:10,0,0,0,0,0,0
3,201392388,2170660915,58003,36895,2024-10-04 19:36:10,0,0,0,0,0,0
3,201392388,2170660915,39044,36895,2024-10-04 19:36:11,0,0,0,0,0,0
3,201392388,2170660915,0,0,2024-10-04 19:36:11,0,0,0,0,0,0
3,201392388,1145490691,24285,47873,2024-10-04 19:36:11,0,0,0,0,0,0
3,201392388,2170660915,58003,36895,2024-10-04 19:36:11,0,0,0,0,0,0
3,201392388,2170660915,39044,36895,2024-10-04 19:36:12,0,0,0,0,0,0
3,201392388,2170660915,0,0,2024-10-04 19:36:12,0,0,0,0,0,0
3,201392388,1145490691,24285,47873,2024-10-04 19:36:12,0,0,0,0,0,0
3,201392388,2170660915,58003,36895,2024-10-04 19:36:12,0,0,0,0,0,0
3,201392388,2170660915,39044,36895,2024-10-04 19:36:13,0,0,0,0,0,0
3,201392388,2170660915,0,0,2024-10-04 19:36:13,0,0,0,0,0,0
3,201392388,1145490691,24285,47873,2024-10-04 19:36:13,0,0,0,0,0,0
3,201392388,2170660915,58003,36895,2024-10-04 19:36:13,0,0,0,0,0,0
3,201392388,2170660915,39044,36895,2024-10-04 19:36:14,0,0,0,0,0,0
3,201392388,2170660915,0,0,2024-10-04 19:36:14,0,0,0,0,0,0
3,201392388,1145490691,24285,47873,2024-10-04 19:36:14,0,0,0,0,0,0
3,201392388,2170660915,58003,36895,2024-10-04 19:36:14,0,0,0,0,0,0
3,201392388,2170660915,39044,36895,2024-10-04 19:36:15,0,0,0,0,0,0
3,201392388,2170660915,0,0,2024-10-04 19:36:15,128,0,128,1,0,1
3,201392388,1145490691,24285,47873,2024-10-04 19:36:15,0,0,0,0,0,0
3,201392388,2170660915,58003,36895,2024-10-04 19:36:15,0,0,0,0,0,0
3,201392388,2170660915,39044,36895,2024-10-04 19:36:16,0,0,0,0,0,0
3,201392388,2170660915,0,0,2024-10-04 19:36:16,128,84,212,1,1,2
3,201392388,1145490691,24285,47873,2024-10-04 19:36:16,0,0,0,0,0,0
3,201392388,2170660915,58003,36895,2024-10-04 19:36:16,0,0,0,0,0,0
3,201392388,2170660915,39044,36895,2024-10-04 19:36:17,0,0,0,0,0,0
3,201392388,2170660915,0,0,2024-10-04 19:36:17,128,168,296,1,2,3
3,201392388,1145490691,24285,47873,2024-10-04 19:36:17,0,0,0,0,0,0
3,201392388,2170660915,58003,36895,2024-10-04 19:36:17,0,0,0,0,0,0
3,201392388,2170660915,39044,36895,2024-10-04 19:36:18,0,0,0,0,0,0
3,201392388,2170660915,0,0,2024-10-04 19:36:18,128,84,212,1,1,2
3,201392388,1145490691,24285,47873,2024-10-04 19:36:18,0,0,0,0,0,0
3,201392388,2170660915,58003,36895,2024-10-04 19:36:18,0,0,0,0,0,0
3,201392388,2170660915,39044,36895,2024-10-04 19:36:19,0,0,0,0,0,0
3,201392388,2170660915,0,0,2024-10-04 19:36:19,128,84,212,1,1,2
3,201392388,1145490691,24285,47873,2024-10-04 19:36:19,0,0,0,0,0,0
3,201392388,2170660915,58003,36895,2024-10-04 19:36:19,0,0,0,0,0,0
3,201392388,2170660915,39044,36895,2024-10-04 19:36:20,0,0,0,0,0,0
3,201392388,2170660915,0,0,2024-10-04 19:36:20,128,84,212,1,1,2
3,201392388,1145490691,24285,47873,2024-10-04 19:36:20,0,0,0,0,0,0
3,201392388,2170660915,58003,36895,2024-10-04 19:36:20,0,0,0,0,0,0
3,201392388,2170660915,39044,36895,2024-10-04 19:36:21,0,0,0,0,0,0
3,201392388,2170660915,0,0,2024-10-04 19:36:21,128,84,212,1,1,2
3,201392388,1145490691,24285,47873,2024-10-04 19:36:21,0,0,0,0,0,0
3,201392388,2170660915,58003,36895,2024-10-04 19:36:21,0,0,0,0,0,0
3,201392388,2170660915,39044,36895,2024-10-04 19:36:22,0,0,0,0,0,0
3,201392388,2170660915,0,0,2024-10-04 19:36:22,128,84,212,1,1,2
3,201392388,1145490691,24285,47873,2024-10-04 19:36:22,0,0,0,0,0,0
3,201392388,2170660915,58003,36895,2024-10-04 19:36:22,0,0,0,0,0,0
3,201392388,2170660915,39044,36895,2024-10-04 19:36:23,0,0,0,0,0,0
3,201392388,2170660915,0,0,2024-10-04 19:36:23,128,84,212,1,1,2
3,201392388,1145490691,24285,47873,2024-10-04 19:36:23,0,0,0,0,0,0
3,201392388,2170660915,58003,36895,2024-10-04 19:36:23,0,0,0,0,0,0
3,201392388,2170660915,39044,36895,2024-10-04 19:36:24,0,0,0,0,0,0
3,201392388,2170660915,0,0,2024-10-04 19:36:24,128,84,212,1,1,2
3,201392388,1145490691,24285,47873,2024-10-04 19:36:24,0,0,0,0,0,0
3,201392388,2170660915,58003,36895,2024-10-04 19:36:24,0,0,0,0,0,0
3,201392388,2170660915,39044,36895,2024-10-04 19:36:25,0,0,0,0,0,0
3,201392388,2170660915,0,0,2024-10-04 19:36:25,0,0,0,0,0,0
3,201392388,1145490691,24285,47873,2024-10-04 19:36:25,0,0,0,0,0,0
3,201392388,2170660915,58003,36895,2024-10-04 19:36:25,0,0,0,0,0,0
3,201392388,2170660915,39044,36895,2024-10-04 19:36:26,0,0,0,0,0,0
3,201392388,2170660915,0,0,2024-10-04 19:36:26,0,0,0,0,0,0
3,201392388,1145490691,24285,47873,2024-10-04 19:36:26,0,0,0,0,0,0
3,201392388,2170660915,58003,36895,2024-10-04 19:36:26,0,0,0,0,0,0
3,201392388,2170660915,39044,36895,2024-10-04 19:36:27,0,0,0,0,0,0
3,201392388,2170660915,32955,36895,2024-10-04 19:36:27,570,455,1025,5,5,10
3,201392388,2170660915,0,0,2024-10-04 19:36:27,0,0,0,0,0,0
3,201392388,2170660915,58003,36895,2024-10-04 19:36:27,0,0,0,0,0,0
3,201392388,2170660915,39044,36895,2024-10-04 19:36:28,0,0,0,0,0,0
3,201392388,2170660915,32955,36895,2024-10-04 19:36:28,0,0,0,0,0,0
3,201392388,2170660915,0,0,2024-10-04 19:36:28,128,84,212,1,1,2
3,201392388,2170660915,58003,36895,2024-10-04 19:36:28,0,0,0,0,0,0
3,201392388,2170660915,39044,36895,2024-10-04 19:36:29,0,0,0,0,0,0
3,201392388,2170660915,32955,36895,2024-10-04 19:36:29,0,0,0,0,0,0
3,201392388,2170660915,0,0,2024-10-04 19:36:29,128,84,212,1,1,2
3,201392388,2170660915,58003,36895,2024-10-04 19:36:29,0,0,0,0,0,0
3,201392388,2170660915,39044,36895,2024-10-04 19:36:30,0,0,0,0,0,0
3,201392388,2170660915,0,0,2024-10-04 19:36:30,128,84,212,1,1,2
3,201392388,2170660915,58003,36895,2024-10-04 19:36:30,0,0,0,0,0,0
3,201392388,2170660915,39044,36895,2024-10-04 19:36:31,0,0,0,0,0,0
3,201392388,2170660915,0,0,2024-10-04 19:36:31,0,0,0,0,0,0
3,201392388,2170660915,58003,36895,2024-10-04 19:36:31,0,0,0,0,0,0
3,201392388,2170660915,39044,36895,2024-10-04 19:36:32,0,0,0,0,0,0
3,201392388,2170660915,0,0,2024-10-04 19:36:32,0,0,0,0,0,0
3,201392388,2170660915,58003,36895,2024-10-04 19:36:32,0,0,0,0,0,0
3,201392388,2170660915,39044,36895,2024-10-04 19:36:33,0,0,0,0,0,0
3,201392388,2170660915,0,0,2024-10-04 19:36:33,0,0,0,0,0,0
3,201392388,2170660915,58003,36895,2024-10-04 19:36:33,0,0,0,0,0,0
3,201392388,2170660915,39044,36895,2024-10-04 19:36:34,0,0,0,0,0,0
3,201392388,2170660915,0,0,2024-10-04 19:36:34,128,84,212,1,1,2
3,201392388,2170660915,58003,36895,2024-10-04 19:36:34,0,0,0,0,0,0
3,201392388,2170660915,39044,36895,2024-10-04 19:36:35,0,0,0,0,0,0
3,201392388,2170660915,0,0,2024-10-04 19:36:35,128,84,212,1,1,2
3,201392388,2170660915,58003,36895,2024-10-04 19:36:35,0,0,0,0,0,0
3,201392388,2170660915,39044,36895,2024-10-04 19:36:36,0,0,0,0,0,0
3,201392388,1145490689,3206,47873,2024-10-04 19:36:36,5652,83000,88652,48,69,117
3,201392388,2170660915,0,0,2024-10-04 19:36:36,128,84,212,1,1,2
3,201392388,2170660915,58003,36895,2024-10-04 19:36:36,0,0,0,0,0,0
3,201392388,2170660915,39044,36895,2024-10-04 19:36:37,0,0,0,0,0,0
3,201392388,1145490689,3206,47873,2024-10-04 19:36:37,0,0,0,0,0,0
3,201392388,2170660915,0,0,2024-10-04 19:36:37,0,0,0,0,0,0
3,201392388,2170660915,58003,36895,2024-10-04 19:36:37,0,0,0,0,0,0
3,201392388,2170660915,39044,36895,2024-10-04 19:36:38,0,0,0,0,0,0
3,201392388,2170660915,0,0,2024-10-04 19:36:38,0,0,0,0,0,0
3,201392388,2170660915,58003,36895,2024-10-04 19:36:38,0,0,0,0,0,0
3,201392388,2170660915,39044,36895,2024-10-04 19:36:39,0,0,0,0,0,0
3,201392388,2170660915,0,0,2024-10-04 19:36:39,0,0,0,0,0,0
3,201392388,2170660915,58003,36895,2024-10-04 19:36:39,0,0,0,0,0,0
3,201392388,2170660915,39044,36895,2024-10-04 19:36:40,0,0,0,0,0,0
3,201392388,2170660915,0,0,2024-10-04 19:36:40,0,0,0,0,0,0
3,201392388,2170660915,58003,36895,2024-10-04 19:36:40,0,0,0,0,0,0
3,201392388,2170660915,39044,36895,2024-10-04 19:36:41,0,0,0,0,0,0
3,201392388,2170660915,0,0,2024-10-04 19:36:41,0,0,0,0,0,0
3,201392388,2170660915,58003,36895,2024-10-04 19:36:41,0,0,0,0,0,0
3,201392388,2170660915,39044,36895,2024-10-04 19:36:42,0,0,0,0,0,0
3,201392388,2170660915,0,0,2024-10-04 19:36:42,0,0,0,0,0,0
3,201392388,2170660915,58003,36895,2024-10-04 19:36:42,0,0,0,0,0,0
3,201392388,2170660915,39044,36895,2024-10-04 19:36:43,0,0,0,0,0,0
3,201392388,2170660915,0,0,2024-10-04 19:36:43,0,0,0,0,0,0
3,201392388,2170660915,58003,36895,2024-10-04 19:36:43,0,0,0,0,0,0
3,201392388,2170660915,39044,36895,2024-10-04 19:36:44,0,0,0,0,0,0
3,201392388,2170660915,0,0,2024-10-04 19:36:44,0,0,0,0,0,0
3,201392388,2170660915,58003,36895,2024-10-04 19:36:44,0,0,0,0,0,0
3,201392388,2170660915,39044,36895,2024-10-04 19:36:45,0,0,0,0,0,0
3,201392388,2170660915,0,0,2024-10-04 19:36:45,0,0,0,0,0,0
3,201392388,2170660915,58003,36895,2024-10-04 19:36:45,0,0,0,0,0,0
3,201392388,2170660915,39044,36895,2024-10-04 19:36:46,0,0,0,0,0,0
3,201392388,2170660915,0,0,2024-10-04 19:36:46,128,84,212,1,1,2
3,201392388,2170660915,58003,36895,2024-10-04 19:36:46,0,0,0,0,0,0
3,201392388,2170660915,39044,36895,2024-10-04 19:36:47,0,0,0,0,0,0
3,201392388,2170660915,0,0,2024-10-04 19:36:47,128,84,212,1,1,2
3,201392388,2170660915,58003,36895,2024-10-04 19:36:47,0,0,0,0,0,0
3,201392388,2170660915,39044,36895,2024-10-04 19:36:48,0,0,0,0,0,0
3,201392388,2170660915,0,0,2024-10-04 19:36:48,256,84,340,2,1,3
3,201392388,2170660915,58003,36895,2024-10-04 19:36:48,0,0,0,0,0,0
3,201392388,2170660915,39044,36895,2024-10-04 19:36:49,0,0,0,0,0,0
3,201392388,2170660915,0,0,2024-10-04 19:36:49,128,84,212,1,1,2
3,201392388,2170660915,58003,36895,2024-10-04 19:36:49,0,0,0,0,0,0
3,201392388,2170660915,39044,36895,2024-10-04 19:36:50,0,0,0,0,0,0
3,201392388,2170660915,0,0,2024-10-04 19:36:50,128,84,212,1,1,2
3,201392388,2170660915,58003,36895,2024-10-04 19:36:50,0,0,0,0,0,0
3,201392388,2170660915,39044,36895,2024-10-04 19:36:51,0,0,0,0,0,0
3,201392388,2170660915,0,0,2024-10-04 19:36:51,128,84,212,1,1,2
3,201392388,2170660915,58003,36895,2024-10-04 19:36:51,0,0,0,0,0,0
3,201392388,2170660915,39044,36895,2024-10-04 19:36:52,0,0,0,0,0,0
3,201392388,2170660915,0,0,2024-10-04 19:36:52,128,84,212,1,1,2
3,201392388,2170660915,58003,36895,2024-10-04 19:36:52,0,0,0,0,0,0
3,201392388,2170660915,39044,36895,2024-10-04 19:36:53,0,0,0,0,0,0
3,201392388,2170660915,0,0,2024-10-04 19:36:53,0,84,84,0,1,1
3,201392388,2170660915,58003,36895,2024-10-04 19:36:53,0,0,0,0,0,0
3,201392388,2170660915,39044,36895,2024-10-04 19:36:54,0,0,0,0,0,0
3,201392388,2170660915,0,0,2024-10-04 19:36:54,128,84,212,1,1,2
3,201392388,2170660915,58003,36895,2024-10-04 19:36:54,0,0,0,0,0,0
3,201392388,2170660915,39044,36895,2024-10-04 19:36:55,0,0,0,0,0,0
3,201392388,2170660915,0,0,2024-10-04 19:36:55,128,84,212,1,1,2
3,201392388,2170660915,58003,36895,2024-10-04 19:36:55,0,0,0,0,0,0
3,201392388,2170660915,39044,36895,2024-10-04 19:36:56,0,0,0,0,0,0
3,201392388,2170660915,42146,36895,2024-10-04 19:36:56,666,507,1173,6,6,12
3,201392388,2170660915,0,0,2024-10-04 19:36:56,0,0,0,0,0,0
3,201392388,2170660915,58003,36895,2024-10-04 19:36:56,0,0,0,0,0,0
3,201392388,2170660915,39044,36895,2024-10-04 19:36:57,0,0,0,0,0,0
3,201392388,2170660915,42146,36895,2024-10-04 19:36:57,0,0,0,0,0,0
3,201392388,2170660915,0,0,2024-10-04 19:36:57,128,84,212,1,1,2
3,201392388,2170660915,58003,36895,2024-10-04 19:36:57,0,0,0,0,0,0
3,201392388,2170660915,39044,36895,2024-10-04 19:36:58,0,0,0,0,0,0
3,201392388,2170660915,42146,36895,2024-10-04 19:36:58,0,0,0,0,0,0
3,201392388,2170660915,0,0,2024-10-04 19:36:58,128,84,212,1,1,2
3,201392388,2170660915,58003,36895,2024-10-04 19:36:58,0,0,0,0,0,0
3,201392388,2170660915,39044,36895,2024-10-04 19:36:59,0,0,0,0,0,0
3,201392388,2170660915,42146,36895,2024-10-04 19:36:59,0,0,0,0,0,0
3,201392388,2170660915,0,0,2024-10-04 19:36:59,0,0,0,0,0,0
3,201392388,2170660915,58003,36895,2024-10-04 19:36:59,0,0,0,0,0,0
3,201392388,2170660915,39044,36895,2024-10-04 19:37:00,0,0,0,0,0,0
3,201392388,2170660915,0,0,2024-10-04 19:37:00,128,84,212,1,1,2
3,201392388,2170660915,58003,36895,2024-10-04 19:37:00,0,0,0,0,0,0
3,201392388,2170660915,39044,36895,2024-10-04 19:37:01,0,0,0,0,0,0
3,201392388,2170660915,0,0,2024-10-04 19:37:01,0,0,0,0,0,0
3,201392388,2170660915,58003,36895,2024-10-04 19:37:01,0,0,0,0,0,0
3,201392388,2170660915,39044,36895,2024-10-04 19:37:02,0,0,0,0,0,0
3,201392388,2170660915,0,0,2024-10-04 19:37:02,0,0,0,0,0,0
3,201392388,2170660915,58003,36895,2024-10-04 19:37:02,0,0,0,0,0,0
3,201392388,2170660915,39044,36895,2024-10-04 19:37:03,0,0,0,0,0,0
3,201392388,2170660915,0,0,2024-10-04 19:37:03,128,84,212,1,1,2
3,201392388,2170660915,58003,36895,2024-10-04 19:37:03,0,0,0,0,0,0
3,201392388,2170660915,39044,36895,2024-10-04 19:37:04,0,0,0,0,0,0
3,201392388,2170660915,0,0,2024-10-04 19:37:04,128,84,212,1,1,2
3,201392388,2170660915,58003,36895,2024-10-04 19:37:04,0,0,0,0,0,0
3,201392388,2170660915,39044,36895,2024-10-04 19:37:05,0,0,0,0,0,0
3,201392388,1145490689,60092,47873,2024-10-04 19:37:05,4356,63559,67915,35,50,85
3,201392388,2170660915,0,0,2024-10-04 19:37:05,128,84,212,1,1,2
3,201392388,2170660915,58003,36895,2024-10-04 19:37:05,0,0,0,0,0,0
3,201392388,2170660915,39044,36895,2024-10-04 19:37:06,0,0,0,0,0,0
3,201392388,1145490689,60092,47873,2024-10-04 19:37:06,2232,35691,37923,22,27,49
3,201392388,2170660915,0,0,2024-10-04 19:37:06,0,0,0,0,0,0
3,201392388,2170660915,58003,36895,2024-10-04 19:37:06,0,0,0,0,0,0
3,201392388,2170660915,39044,36895,2024-10-04 19:37:07,0,0,0,0,0,0
3,201392388,1145490689,60092,47873,2024-10-04 19:37:07,0,0,0,0,0,0
3,201392388,2170660915,0,0,2024-10-04 19:37:07,0,0,0,0,0,0
3,201392388,2170660915,58003,36895,2024-10-04 19:37:07,0,0,0,0,0,0
3,201392388,2170660915,39044,36895,2024-10-04 19:37:08,0,0,0,0,0,0
3,201392388,1145490689,60092,47873,2024-10-04 19:37:08,0,0,0,0,0,0
3,201392388,2170660915,0,0,2024-10-04 19:37:08,0,0,0,0,0,0
3,201392388,2170660915,58003,36895,2024-10-04 19:37:08,0,0,0,0,0,0
3,201392388,2170660915,39044,36895,2024-10-04 19:37:09,0,0,0,0,0,0
3,201392388,1145490689,60092,47873,2024-10-04 19:37:09,0,0,0,0,0,0
3,201392388,2170660915,0,0,2024-10-04 19:37:09,0,0,0,0,0,0
3,201392388,2170660915,58003,36895,2024-10-04 19:37:09,0,0,0,0,0,0
3,201392388,2170660915,39044,36895,2024-10-04 19:37:10,0,0,0,0,0,0
3,201392388,1145490689,60092,47873,2024-10-04 19:37:10,0,0,0,0,0,0
3,201392388,2170660915,0,0,2024-10-04 19:37:10,0,0,0,0,0,0
3,201392388,2170660915,58003,36895,2024-10-04 19:37:10,0,0,0,0,0,0
3,201392388,2170660915,39044,36895,2024-10-04 19:37:11,0,0,0,0,0,0
3,201392388,1145490689,60092,47873,2024-10-04 19:37:11,0,0,0,0,0,0
3,201392388,2170660915,0,0,2024-10-04 19:37:11,0,0,0,0,0,0
3,201392388,2170660915,58003,36895,2024-10-04 19:37:11,0,0,0,0,0,0
3,201392388,2170660915,39044,36895,2024-10-04 19:37:12,0,0,0,0,0,0
3,201392388,1145490689,60092,47873,2024-10-04 19:37:12,0,0,0,0,0,0
3,201392388,2170660915,0,0,2024-10-04 19:37:12,0,0,0,0,0,0
3,201392388,2170660915,58003,36895,2024-10-04 19:37:12,0,0,0,0,0,0
3,201392388,2170660915,39044,36895,2024-10-04 19:37:13,0,0,0,0,0,0
3,201392388,1145490689,60092,47873,2024-10-04 19:37:13,0,0,0,0,0,0
3,201392388,2170660915,0,0,2024-10-04 19:37:13,0,0,0,0,0,0
3,201392388,2170660915,58003,36895,2024-10-04 19:37:13,0,0,0,0,0,0
3,201392388,2170660915,39044,36895,2024-10-04 19:37:14,0,0,0,0,0,0
3,201392388,1145490689,60092,47873,2024-10-04 19:37:14,0,0,0,0,0,0
3,201392388,2170660915,0,0,2024-10-04 19:37:14,0,0,0,0,0,0
3,201392388,2170660915,58003,36895,2024-10-04 19:37:14,0,0,0,0,0,0
3,201392388,2170660915,39044,36895,2024-10-04 19:37:15,0,0,0,0,0,0
3,201392388,1145490689,60092,47873,2024-10-04 19:37:15,0,0,0,0,0,0
3,201392388,2170660915,0,0,2024-10-04 19:37:15,128,0,128,1,0,1
3,201392388,2170660915,58003,36895,2024-10-04 19:37:15,0,0,0,0,0,0
3,201392388,2170660915,39044,36895,2024-10-04 19:37:16,0,0,0,0,0,0
3,201392388,1145490689,60092,47873,2024-10-04 19:37:16,0,0,0,0,0,0
3,201392388,2170660915,0,0,2024-10-04 19:37:16,128,84,212,1,1,2
3,201392388,2170660915,58003,36895,2024-10-04 19:37:16,0,0,0,0,0,0
3,201392388,2170660915,39044,36895,2024-10-04 19:37:17,0,0,0,0,0,0
3,201392388,1145490689,60092,47873,2024-10-04 19:37:17,0,0,0,0,0,0
3,201392388,2170660915,0,0,2024-10-04 19:37:17,128,84,212,1,1,2
3,201392388,2170660915,58003,36895,2024-10-04 19:37:17,0,0,0,0,0,0
3,201392388,2170660915,39044,36895,2024-10-04 19:37:18,0,0,0,0,0,0
3,201392388,1145490689,60092,47873,2024-10-04 19:37:18,0,0,0,0,0,0
3,201392388,2170660915,0,0,2024-10-04 19:37:18,128,84,212,1,1,2
3,201392388,2170660915,58003,36895,2024-10-04 19:37:18,0,0,0,0,0,0
3,201392388,2170660915,39044,36895,2024-10-04 19:37:19,0,0,0,0,0,0
3,201392388,1145490689,60092,47873,2024-10-04 19:37:19,0,0,0,0,0,0
3,201392388,2170660915,0,0,2024-10-04 19:37:19,128,84,212,1,1,2
3,201392388,2170660915,58003,36895,2024-10-04 19:37:19,0,0,0,0,0,0
3,201392388,2170660915,39044,36895,2024-10-04 19:37:20,0,0,0,0,0,0
3,201392388,1145490689,60092,47873,2024-10-04 19:37:20,0,0,0,0,0,0
3,201392388,2170660915,0,0,2024-10-04 19:37:20,128,84,212,1,1,2
3,201392388,2170660915,58003,36895,2024-10-04 19:37:20,0,0,0,0,0,0
3,201392388,2170660915,39044,36895,2024-10-04 19:37:21,0,0,0,0,0,0
3,201392388,1145490689,60092,47873,2024-10-04 19:37:21,0,0,0,0,0,0
3,201392388,2170660915,0,0,2024-10-04 19:37:21,128,84,212,1,1,2
3,201392388,2170660915,58003,36895,2024-10-04 19:37:21,0,0,0,0,0,0
3,201392388,2170660915,39044,36895,2024-10-04 19:37:22,0,0,0,0,0,0
3,201392388,1145490689,60092,47873,2024-10-04 19:37:22,0,0,0,0,0,0
3,201392388,2170660915,0,0,2024-10-04 19:37:22,128,84,212,1,1,2
3,201392388,2170660915,58003,36895,2024-10-04 19:37:22,0,0,0,0,0,0
3,201392388,2170660915,39044,36895,2024-10-04 19:37:23,0,0,0,0,0,0
3,201392388,1145490689,60092,47873,2024-10-04 19:37:23,0,0,0,0,0,0
3,201392388,2170660915,0,0,2024-10-04 19:37:23,128,84,212,1,1,2
3,201392388,2170660915,58003,36895,2024-10-04 19:37:23,0,0,0,0,0,0
3,201392388,2170660915,39044,36895,2024-10-04 19:37:24,0,0,0,0,0,0
3,201392388,1145490689,60092,47873,2024-10-04 19:37:24,0,0,0,0,0,0
3,201392388,2170660915,0,0,2024-10-04 19:37:24,128,84,212,1,1,2
3,201392388,2170660915,58003,36895,2024-10-04 19:37:24,0,0,0,0,0,0
3,201392388,2170660915,39044,36895,2024-10-04 19:37:25,0,0,0,0,0,0
3,201392388,1145490689,60092,47873,2024-10-04 19:37:25,0,0,0,0,0,0
3,201392388,2170660915,0,0,2024-10-04 19:37:25,0,84,84,0,1,1
3,201392388,2170660915,58003,36895,2024-10-04 19:37:25,0,0,0,0,0,0
3,201392388,2170660915,39044,36895,2024-10-04 19:37:26,0,0,0,0,0,0
3,201392388,1145490689,60092,47873,2024-10-04 19:37:26,0,0,0,0,0,0
3,201392388,2170660915,0,0,2024-10-04 19:37:26,0,0,0,0,0,0
3,201392388,2170660915,58003,36895,2024-10-04 19:37:26,0,0,0,0,0,0
3,201392388,2170660915,39044,36895,2024-10-04 19:37:27,0,0,0,0,0,0
3,201392388,2170660915,2789,36895,2024-10-04 19:37:27,666,507,1173,6,6,12
3,201392388,2170660915,0,0,2024-10-04 19:37:27,0,0,0,0,0,0
3,201392388,2170660915,58003,36895,2024-10-04 19:37:27,0,0,0,0,0,0
3,201392388,2170660915,39044,36895,2024-10-04 19:37:28,0,0,0,0,0,0
3,201392388,2170660915,2789,36895,2024-10-04 19:37:28,0,0,0,0,0,0
3,201392388,2170660915,0,0,2024-10-04 19:37:28,128,84,212,1,1,2
3,201392388,2170660915,58003,36895,2024-10-04 19:37:28,0,0,0,0,0,0
3,201392388,2170660915,39044,36895,2024-10-04 19:37:29,0,0,0,0,0,0
3,201392388,2170660915,2789,36895,2024-10-04 19:37:29,0,0,0,0,0,0
3,201392388,2170660915,0,0,2024-10-04 19:37:29,128,84,212,1,1,2
3,201392388,2170660915,58003,36895,2024-10-04 19:37:29,0,0,0,0,0,0
3,201392388,2170660915,39044,36895,2024-10-04 19:37:30,0,0,0,0,0,0
3,201392388,2170660915,0,0,2024-10-04 19:37:30,128,84,212,1,1,2
3,201392388,2170660915,58003,36895,2024-10-04 19:37:30,0,0,0,0,0,0
3,201392388,2170660915,39044,36895,2024-10-04 19:37:31,0,0,0,0,0,0
3,201392388,2170660915,0,0,2024-10-04 19:37:31,0,0,0,0,0,0
3,201392388,2170660915,58003,36895,2024-10-04 19:37:31,0,0,0,0,0,0
3,201392388,2170660915,39044,36895,2024-10-04 19:37:32,0,0,0,0,0,0
3,201392388,2170660915,0,0,2024-10-04 19:37:32,0,0,0,0,0,0
3,201392388,2170660915,58003,36895,2024-10-04 19:37:32,0,0,0,0,0,0
3,201392388,2170660915,39044,36895,2024-10-04 19:37:33,0,0,0,0,0,0
3,201392388,2170660915,0,0,2024-10-04 19:37:33,0,0,0,0,0,0
3,201392388,2170660915,58003,36895,2024-10-04 19:37:33,0,0,0,0,0,0
3,201392388,2170660915,39044,36895,2024-10-04 19:37:34,0,0,0,0,0,0
3,201392388,2170660915,0,0,2024-10-04 19:37:34,128,84,212,1,1,2
3,201392388,2170660915,58003,36895,2024-10-04 19:37:34,0,0,0,0,0,0
3,201392388,2170660915,39044,36895,2024-10-04 19:37:35,0,0,0,0,0,0
3,201392388,1145490689,29897,47873,2024-10-04 19:37:35,813,112,925,3,2,5
3,201392388,2170660915,0,0,2024-10-04 19:37:35,256,168,424,2,2,4
3,201392388,2170660915,58003,36895,2024-10-04 19:37:35,0,0,0,0,0,0
3,201392388,2170660915,39044,36895,2024-10-04 19:37:36,0,0,0,0,0,0
3,201392388,1145490689,29897,47873,2024-10-04 19:37:36,4251,90043,94294,38,65,103
3,201392388,2170660915,0,0,2024-10-04 19:37:36,0,0,0,0,0,0
3,201392388,2170660915,58003,36895,2024-10-04 19:37:36,0,0,0,0,0,0
3,201392388,2170660915,39044,36895,2024-10-04 19:37:37,0,0,0,0,0,0
3,201392388,1145490689,29897,47873,2024-10-04 19:37:37,924,13163,14087,9,12,21
3,201392388,2170660915,0,0,2024-10-04 19:37:37,0,0,0,0,0,0
3,201392388,2170660915,58003,36895,2024-10-04 19:37:37,0,0,0,0,0,0
3,201392388,2170660915,39044,36895,2024-10-04 19:37:38,0,0,0,0,0,0
3,201392388,1145490689,29897,47873,2024-10-04 19:37:38,0,0,0,0,0,0
3,201392388,2170660915,0,0,2024-10-04 19:37:38,0,0,0,0,0,0
3,201392388,2170660915,58003,36895,2024-10-04 19:37:38,0,0,0,0,0,0
3,201392388,2170660915,39044,36895,2024-10-04 19:37:39,0,0,0,0,0,0
3,201392388,1145490689,29897,47873,2024-10-04 19:37:39,0,0,0,0,0,0
3,201392388,2170660915,0,0,2024-10-04 19:37:39,0,0,0,0,0,0
3,201392388,2170660915,58003,36895,2024-10-04 19:37:39,0,0,0,0,0,0
3,201392388,2170660915,39044,36895,2024-10-04 19:37:40,0,0,0,0,0,0
3,201392388,1145490689,29897,47873,2024-10-04 19:37:40,0,0,0,0,0,0
3,201392388,2170660915,0,0,2024-10-04 19:37:40,0,0,0,0,0,0
3,201392388,2170660915,58003,36895,2024-10-04 19:37:40,0,0,0,0,0,0
3,201392388,2170660915,39044,36895,2024-10-04 19:37:41,0,0,0,0,0,0
3,201392388,1145490689,29897,47873,2024-10-04 19:37:41,0,0,0,0,0,0
3,201392388,2170660915,0,0,2024-10-04 19:37:41,0,0,0,0,0,0
3,201392388,2170660915,58003,36895,2024-10-04 19:37:41,0,0,0,0,0,0
3,201392388,2170660915,39044,36895,2024-10-04 19:37:42,0,0,0,0,0,0
3,201392388,1145490689,29897,47873,2024-10-04 19:37:42,0,0,0,0,0,0
3,201392388,2170660915,0,0,2024-10-04 19:37:42,0,0,0,0,0,0
3,201392388,2170660915,58003,36895,2024-10-04 19:37:42,0,0,0,0,0,0
3,201392388,2170660915,39044,36895,2024-10-04 19:37:43,0,0,0,0,0,0
3,201392388,1145490689,29897,47873,2024-10-04 19:37:43,0,0,0,0,0,0
3,201392388,2170660915,0,0,2024-10-04 19:37:43,0,0,0,0,0,0
3,201392388,2170660915,58003,36895,2024-10-04 19:37:43,0,0,0,0,0,0
3,201392388,2170660915,39044,36895,2024-10-04 19:37:44,0,0,0,0,0,0
3,201392388,1145490689,29897,47873,2024-10-04 19:37:44,0,0,0,0,0,0
3,201392388,2170660915,0,0,2024-10-04 19:37:44,0,0,0,0,0,0
3,201392388,2170660915,58003,36895,2024-10-04 19:37:44,0,0,0,0,0,0
3,201392388,2170660915,39044,36895,2024-10-04 19:37:45,0,0,0,0,0,0
3,201392388,1145490689,29897,47873,2024-10-04 19:37:45,0,0,0,0,0,0
3,201392388,2170660915,0,0,2024-10-04 19:37:45,0,0,0,0,0,0
3,201392388,2170660915,58003,36895,2024-10-04 19:37:45,0,0,0,0,0,0
3,201392388,2170660915,39044,36895,2024-10-04 19:37:46,0,0,0,0,0,0
3,201392388,1145490689,29897,47873,2024-10-04 19:37:46,0,0,0,0,0,0
3,201392388,2170660915,0,0,2024-10-04 19:37:46,128,0,128,1,0,1
3,201392388,2170660915,58003,36895,2024-10-04 19:37:46,0,0,0,0,0,0
3,201392388,2170660915,39044,36895,2024-10-04 19:37:47,0,0,0,0,0,0
3,201392388,1145490689,29897,47873,2024-10-04 19:37:47,0,0,0,0,0,0
3,201392388,2170660915,0,0,2024-10-04 19:37:47,128,84,212,1,1,2
3,201392388,2170660915,58003,36895,2024-10-04 19:37:47,0,0,0,0,0,0
3,201392388,2170660915,39044,36895,2024-10-04 19:37:48,0,0,0,0,0,0
3,201392388,1145490689,29897,47873,2024-10-04 19:37:48,0,0,0,0,0,0
3,201392388,2170660915,0,0,2024-10-04 19:37:48,128,84,212,1,1,2
3,201392388,2170660915,58003,36895,2024-10-04 19:37:48,0,0,0,0,0,0
3,201392388,2170660915,39044,36895,2024-10-04 19:37:49,0,0,0,0,0,0
3,201392388,1145490689,29897,47873,2024-10-04 19:37:49,0,0,0,0,0,0
3,201392388,2170660915,0,0,2024-10-04 19:37:49,128,84,212,1,1,2
3,201392388,2170660915,58003,36895,2024-10-04 19:37:49,0,0,0,0,0,0
3,201392388,2170660915,39044,36895,2024-10-04 19:37:50,0,0,0,0,0,0
3,201392388,1145490689,29897,47873,2024-10-04 19:37:50,0,0,0,0,0,0
3,201392388,2170660915,0,0,2024-10-04 19:37:50,0,84,84,0,1,1
3,201392388,2170660915,58003,36895,2024-10-04 19:37:50,0,0,0,0,0,0
3,201392388,2170660915,39044,36895,2024-10-04 19:37:51,0,0,0,0,0,0
3,201392388,1145490689,29897,47873,2024-10-04 19:37:51,0,0,0,0,0,0
3,201392388,2170660915,0,0,2024-10-04 19:37:51,128,84,212,1,1,2
3,201392388,2170660915,58003,36895,2024-10-04 19:37:51,0,0,0,0,0,0
3,201392388,2170660915,39044,36895,2024-10-04 19:37:52,0,0,0,0,0,0
3,201392388,1145490689,29897,47873,2024-10-04 19:37:52,0,0,0,0,0,0
3,201392388,2170660915,0,0,2024-10-04 19:37:52,128,84,212,1,1,2
3,201392388,2170660915,58003,36895,2024-10-04 19:37:52,0,0,0,0,0,0
3,201392388,2170660915,39044,36895,2024-10-04 19:37:53,0,0,0,0,0,0
3,201392388,1145490689,29897,47873,2024-10-04 19:37:53,0,0,0,0,0,0
3,201392388,2170660915,0,0,2024-10-04 19:37:53,128,84,212,1,1,2
3,201392388,2170660915,58003,36895,2024-10-04 19:37:53,0,0,0,0,0,0
3,201392388,2170660915,39044,36895,2024-10-04 19:37:54,0,0,0,0,0,0
3,201392388,1145490689,29897,47873,2024-10-04 19:37:54,0,0,0,0,0,0
3,201392388,2170660915,0,0,2024-10-04 19:37:54,128,84,212,1,1,2
3,201392388,2170660915,58003,36895,2024-10-04 19:37:54,0,0,0,0,0,0
3,201392388,2170660915,39044,36895,2024-10-04 19:37:55,0,0,0,0,0,0
3,201392388,1145490689,29897,47873,2024-10-04 19:37:55,0,0,0,0,0,0
3,201392388,2170660915,0,0,2024-10-04 19:37:55,128,84,212,1,1,2
3,201392388,2170660915,58003,36895,2024-10-04 19:37:55,0,0,0,0,0,0
3,201392388,2170660915,39044,36895,2024-10-04 19:37:56,0,0,0,0,0,0
3,201392388,1145490689,29897,47873,2024-10-04 19:37:56,0,0,0,0,0,0
3,201392388,2170660915,0,0,2024-10-04 19:37:56,128,84,212,1,1,2
3,201392388,2170660915,58003,36895,2024-10-04 19:37:56,0,0,0,0,0,0
3,201392388,2170660915,39044,36895,2024-10-04 19:37:57,0,0,0,0,0,0
3,201392388,1145490689,29897,47873,2024-10-04 19:37:57,0,0,0,0,0,0
3,201392388,2170660915,0,0,2024-10-04 19:37:57,0,0,0,0,0,0
3,201392388,2170660915,58003,36895,2024-10-04 19:37:57,0,0,0,0,0,0
3,201392388,2170660915,39044,36895,2024-10-04 19:37:58,0,0,0,0,0,0
3,201392388,2170660915,49357,36895,2024-10-04 19:37:58,570,455,1025,5,5,10
3,201392388,2170660915,0,0,2024-10-04 19:37:58,0,0,0,0,0,0
3,201392388,2170660915,58003,36895,2024-10-04 19:37:58,0,0,0,0,0,0
3,201392388,2170660915,39044,36895,2024-10-04 19:37:59,0,0,0,0,0,0
3,201392388,2170660915,49357,36895,2024-10-04 19:37:59,0,0,0,0,0,0
3,201392388,2170660915,0,0,2024-10-04 19:37:59,128,84,212,1,1,2
3,201392388,2170660915,58003,36895,2024-10-04 19:37:59,0,0,0,0,0,0
3,201392388,2170660915,39044,36895,2024-10-04 19:38:00,0,0,0,0,0,0
3,201392388,2170660915,49357,36895,2024-10-04 19:38:00,0,0,0,0,0,0
3,201392388,2170660915,0,0,2024-10-04 19:38:00,128,84,212,1,1,2
3,201392388,2170660915,58003,36895,2024-10-04 19:38:00,0,0,0,0,0,0
3,201392388,2170660915,39044,36895,2024-10-04 19:38:01,0,0,0,0,0,0
3,201392388,2170660915,49357,36895,2024-10-04 19:38:01,0,0,0,0,0,0
3,201392388,2170660915,0,0,2024-10-04 19:38:01,128,84,212,1,1,2
3,201392388,2170660915,58003,36895,2024-10-04 19:38:01,0,0,0,0,0,0
3,201392388,2170660915,39044,36895,2024-10-04 19:38:02,0,0,0,0,0,0
3,201392388,2170660915,49357,36895,2024-10-04 19:38:02,0,0,0,0,0,0
3,201392388,2170660915,0,0,2024-10-04 19:38:02,0,0,0,0,0,0
3,201392388,2170660915,58003,36895,2024-10-04 19:38:02,0,0,0,0,0,0
3,201392388,2170660915,39044,36895,2024-10-04 19:38:03,0,0,0,0,0,0
3,201392388,2170660915,49357,36895,2024-10-04 19:38:03,0,0,0,0,0,0
3,201392388,2170660915,0,0,2024-10-04 19:38:03,0,0,0,0,0,0
3,201392388,2170660915,58003,36895,2024-10-04 19:38:03,0,0,0,0,0,0
3,201392388,2170660915,39044,36895,2024-10-04 19:38:04,0,0,0,0,0,0
3,201392388,2170660915,49357,36895,2024-10-04 19:38:04,0,0,0,0,0,0
3,201392388,2170660915,0,0,2024-10-04 19:38:04,128,0,128,1,0,1
3,201392388,2170660915,58003,36895,2024-10-04 19:38:04,0,0,0,0,0,0
3,201392388,2170660915,39044,36895,2024-10-04 19:38:05,0,0,0,0,0,0
3,201392388,2170660915,49357,36895,2024-10-04 19:38:05,0,0,0,0,0,0
3,201392388,2170660915,0,0,2024-10-04 19:38:05,128,84,212,1,1,2
3,201392388,2170660915,58003,36895,2024-10-04 19:38:05,0,0,0,0,0,0
3,201392388,2170660915,39044,36895,2024-10-04 19:38:06,0,0,0,0,0,0
3,201392388,2170660915,49357,36895,2024-10-04 19:38:06,0,0,0,0,0,0
3,201392388,2170660915,0,0,2024-10-04 19:38:06,128,84,212,1,1,2
3,201392388,2170660915,58003,36895,2024-10-04 19:38:06,0,0,0,0,0,0
3,201392388,2170660915,39044,36895,2024-10-04 19:38:07,0,0,0,0,0,0
3,201392388,2170660915,49357,36895,2024-10-04 19:38:07,0,0,0,0,0,0
3,201392388,1145490689,57986,47873,2024-10-04 19:38:07,2532,26269,28801,17,26,43
3,201392388,2170660915,0,0,2024-10-04 19:38:07,0,84,84,0,1,1
3,201392388,2170660915,58003,36895,2024-10-04 19:38:07,0,0,0,0,0,0
3,201392388,2170660915,39044,36895,2024-10-04 19:38:08,0,0,0,0,0,0
3,201392388,2170660915,49357,36895,2024-10-04 19:38:08,0,0,0,0,0,0
3,201392388,1145490689,57986,47873,2024-10-04 19:38:08,3864,75067,78931,38,53,91
3,201392388,2170660915,0,0,2024-10-04 19:38:08,0,0,0,0,0,0
3,201392388,2170660915,58003,36895,2024-10-04 19:38:08,0,0,0,0,0,0
3,201392388,2170660915,39044,36895,2024-10-04 19:38:09,0,0,0,0,0,0
3,201392388,2170660915,49357,36895,2024-10-04 19:38:09,0,0,0,0,0,0
3,201392388,1145490689,57986,47873,2024-10-04 19:38:09,0,0,0,0,0,0
3,201392388,2170660915,0,0,2024-10-04 19:38:09,0,0,0,0,0,0
3,201392388,2170660915,58003,36895,2024-10-04 19:38:09,0,0,0,0,0,0
3,201392388,2170660915,39044,36895,2024-10-04 19:38:10,0,0,0,0,0,0
3,201392388,2170660915,49357,36895,2024-10-04 19:38:10,0,0,0,0,0,0
3,201392388,1145490689,57986,47873,2024-10-04 19:38:10,0,0,0,0,0,0
3,201392388,2170660915,0,0,2024-10-04 19:38:10,0,0,0,0,0,0
3,201392388,2170660915,58003,36895,2024-10-04 19:38:10,0,0,0,0,0,0
3,201392388,2170660915,39044,36895,2024-10-04 19:38:11,0,0,0,0,0,0
3,201392388,2170660915,49357,36895,2024-10-04 19:38:11,0,0,0,0,0,0
3,201392388,1145490689,57986,47873,2024-10-04 19:38:11,0,0,0,0,0,0
3,201392388,2170660915,0,0,2024-10-04 19:38:11,0,0,0,0,0,0
3,201392388,2170660915,58003,36895,2024-10-04 19:38:11,0,0,0,0,0,0
3,201392388,2170660915,39044,36895,2024-10-04 19:38:12,0,0,0,0,0,0
3,201392388,2170660915,49357,36895,2024-10-04 19:38:12,0,0,0,0,0,0
3,201392388,1145490689,57986,47873,2024-10-04 19:38:12,0,0,0,0,0,0
3,201392388,2170660915,0,0,2024-10-04 19:38:12,0,0,0,0,0,0
3,201392388,2170660915,58003,36895,2024-10-04 19:38:12,0,0,0,0,0,0
3,201392388,2170660915,39044,36895,2024-10-04 19:38:13,0,0,0,0,0,0
3,201392388,2170660915,49357,36895,2024-10-04 19:38:13,0,0,0,0,0,0
3,201392388,1145490689,57986,47873,2024-10-04 19:38:13,0,0,0,0,0,0
3,201392388,2170660915,0,0,2024-10-04 19:38:13,0,0,0,0,0,0
3,201392388,2170660915,58003,36895,2024-10-04 19:38:13,0,0,0,0,0,0
3,201392388,2170660915,39044,36895,2024-10-04 19:38:14,0,0,0,0,0,0
3,201392388,2170660915,49357,36895,2024-10-04 19:38:14,0,0,0,0,0,0
3,201392388,1145490689,57986,47873,2024-10-04 19:38:14,0,0,0,0,0,0
3,201392388,2170660915,0,0,2024-10-04 19:38:14,0,0,0,0,0,0
3,201392388,2170660915,58003,36895,2024-10-04 19:38:14,0,0,0,0,0,0
3,201392388,2170660915,39044,36895,2024-10-04 19:38:15,0,0,0,0,0,0
3,201392388,2170660915,49357,36895,2024-10-04 19:38:15,0,0,0,0,0,0
3,201392388,1145490689,57986,47873,2024-10-04 19:38:15,0,0,0,0,0,0
3,201392388,2170660915,0,0,2024-10-04 19:38:15,0,0,0,0,0,0
3,201392388,2170660915,58003,36895,2024-10-04 19:38:15,0,0,0,0,0,0
3,201392388,2170660915,39044,36895,2024-10-04 19:38:16,0,0,0,0,0,0
3,201392388,2170660915,49357,36895,2024-10-04 19:38:16,0,0,0,0,0,0
3,201392388,1145490689,57986,47873,2024-10-04 19:38:16,0,0,0,0,0,0
3,201392388,2170660915,0,0,2024-10-04 19:38:16,0,0,0,0,0,0
3,201392388,2170660915,58003,36895,2024-10-04 19:38:16,0,0,0,0,0,0
3,201392388,2170660915,39044,36895,2024-10-04 19:38:17,0,0,0,0,0,0
3,201392388,2170660915,49357,36895,2024-10-04 19:38:17,0,0,0,0,0,0
3,201392388,1145490689,57986,47873,2024-10-04 19:38:17,0,0,0,0,0,0
3,201392388,2170660915,0,0,2024-10-04 19:38:17,0,0,0,0,0,0
3,201392388,2170660915,58003,36895,2024-10-04 19:38:17,0,0,0,0,0,0
3,201392388,2170660915,39044,36895,2024-10-04 19:38:18,0,0,0,0,0,0
3,201392388,2170660915,49357,36895,2024-10-04 19:38:18,0,0,0,0,0,0
3,201392388,1145490689,57986,47873,2024-10-04 19:38:18,0,0,0,0,0,0
3,201392388,2170660915,0,0,2024-10-04 19:38:18,128,0,128,1,0,1
3,201392388,2170660915,58003,36895,2024-10-04 19:38:18,0,0,0,0,0,0
3,201392388,2170660915,39044,36895,2024-10-04 19:38:19,0,0,0,0,0,0
3,201392388,2170660915,49357,36895,2024-10-04 19:38:19,0,0,0,0,0,0
3,201392388,1145490689,57986,47873,2024-10-04 19:38:19,0,0,0,0,0,0
3,201392388,2170660915,0,0,2024-10-04 19:38:19,0,84,84,0,1,1
3,201392388,2170660915,58003,36895,2024-10-04 19:38:19,0,0,0,0,0,0
3,201392388,2170660915,39044,36895,2024-10-04 19:38:20,0,0,0,0,0,0
3,201392388,2170660915,49357,36895,2024-10-04 19:38:20,0,0,0,0,0,0
3,201392388,1145490689,57986,47873,2024-10-04 19:38:20,0,0,0,0,0,0
3,201392388,2170660915,0,0,2024-10-04 19:38:20,128,84,212,1,1,2
3,201392388,2170660915,58003,36895,2024-10-04 19:38:20,0,0,0,0,0,0
3,201392388,2170660915,39044,36895,2024-10-04 19:38:21,0,0,0,0,0,0
3,201392388,2170660915,49357,36895,2024-10-04 19:38:21,0,0,0,0,0,0
3,201392388,1145490689,57986,47873,2024-10-04 19:38:21,0,0,0,0,0,0
3,201392388,2170660915,0,0,2024-10-04 19:38:21,128,84,212,1,1,2
3,201392388,2170660915,58003,36895,2024-10-04 19:38:21,0,0,0,0,0,0
3,201392388,2170660915,39044,36895,2024-10-04 19:38:22,0,0,0,0,0,0
3,201392388,2170660915,49357,36895,2024-10-04 19:38:22,0,0,0,0,0,0
3,201392388,1145490689,57986,47873,2024-10-04 19:38:22,0,0,0,0,0,0
3,201392388,2170660915,0,0,2024-10-04 19:38:22,128,84,212,1,1,2
3,201392388,2170660915,58003,36895,2024-10-04 19:38:22,0,0,0,0,0,0
3,201392388,2170660915,39044,36895,2024-10-04 19:38:23,0,0,0,0,0,0
3,201392388,2170660915,49357,36895,2024-10-04 19:38:23,0,0,0,0,0,0
3,201392388,1145490689,57986,47873,2024-10-04 19:38:23,0,0,0,0,0,0
3,201392388,2170660915,0,0,2024-10-04 19:38:23,128,84,212,1,1,2
3,201392388,2170660915,58003,36895,2024-10-04 19:38:23,0,0,0,0,0,0
3,201392388,2170660915,39044,36895,2024-10-04 19:38:24,0,0,0,0,0,0
3,201392388,2170660915,49357,36895,2024-10-04 19:38:24,0,0,0,0,0,0
3,201392388,1145490689,57986,47873,2024-10-04 19:38:24,0,0,0,0,0,0
3,201392388,2170660915,0,0,2024-10-04 19:38:24,256,84,340,2,1,3
3,201392388,2170660915,58003,36895,2024-10-04 19:38:24,0,0,0,0,0,0
3,201392388,2170660915,39044,36895,2024-10-04 19:38:25,0,0,0,0,0,0
3,201392388,2170660915,49357,36895,2024-10-04 19:38:25,0,0,0,0,0,0
3,201392388,1145490689,57986,47873,2024-10-04 19:38:25,0,0,0,0,0,0
3,201392388,2170660915,0,0,2024-10-04 19:38:25,128,84,212,1,1,2
3,201392388,2170660915,58003,36895,2024-10-04 19:38:25,0,0,0,0,0,0
3,201392388,2170660915,39044,36895,2024-10-04 19:38:26,0,0,0,0,0,0
3,201392388,2170660915,49357,36895,2024-10-04 19:38:26,0,0,0,0,0,0
3,201392388,1145490689,57986,47873,2024-10-04 19:38:26,0,0,0,0,0,0
3,201392388,2170660915,0,0,2024-10-04 19:38:26,128,84,212,1,1,2
3,201392388,2170660915,58003,36895,2024-10-04 19:38:26,0,0,0,0,0,0
3,201392388,2170660915,39044,36895,2024-10-04 19:38:27,0,0,0,0,0,0
3,201392388,2170660915,49357,36895,2024-10-04 19:38:27,0,0,0,0,0,0
3,201392388,1145490689,57986,47873,2024-10-04 19:38:27,0,0,0,0,0,0
3,201392388,2170660915,0,0,2024-10-04 19:38:27,128,84,212,1,1,2
3,201392388,2170660915,58003,36895,2024-10-04 19:38:27,0,0,0,0,0,0
3,201392388,2170660915,39044,36895,2024-10-04 19:38:28,0,0,0,0,0,0
3,201392388,2170660915,49357,36895,2024-10-04 19:38:28,0,0,0,0,0,0
3,201392388,1145490689,57986,47873,2024-10-04 19:38:28,0,0,0,0,0,0
3,201392388,2170660915,0,0,2024-10-04 19:38:28,0,84,84,0,1,1
3,201392388,2170660915,58003,36895,2024-10-04 19:38:28,0,0,0,0,0,0
3,201392388,2170660915,39044,36895,2024-10-04 19:38:29,0,0,0,0,0,0
3,201392388,2170660915,49357,36895,2024-10-04 19:38:29,0,0,0,0,0,0
3,201392388,2170660915,25730,36895,2024-10-04 19:38:29,666,507,1173,6,6,12
3,201392388,2170660915,0,0,2024-10-04 19:38:29,0,0,0,0,0,0
3,201392388,2170660915,58003,36895,2024-10-04 19:38:29,0,0,0,0,0,0
3,201392388,2170660915,39044,36895,2024-10-04 19:38:30,0,0,0,0,0,0
3,201392388,2170660915,49357,36895,2024-10-04 19:38:30,0,0,0,0,0,0
3,201392388,2170660915,25730,36895,2024-10-04 19:38:30,0,0,0,0,0,0
3,201392388,2170660915,0,0,2024-10-04 19:38:30,128,84,212,1,1,2
3,201392388,2170660915,58003,36895,2024-10-04 19:38:30,0,0,0,0,0,0
3,201392388,2170660915,39044,36895,2024-10-04 19:38:31,0,0,0,0,0,0
3,201392388,2170660915,25730,36895,2024-10-04 19:38:31,0,0,0,0,0,0
3,201392388,2170660915,0,0,2024-10-04 19:38:31,128,84,212,1,1,2
3,201392388,2170660915,58003,36895,2024-10-04 19:38:31,0,0,0,0,0,0
3,201392388,2170660915,39044,36895,2024-10-04 19:38:32,0,0,0,0,0,0
3,201392388,2170660915,0,0,2024-10-04 19:38:32,128,84,212,1,1,2
3,201392388,2170660915,58003,36895,2024-10-04 19:38:32,0,0,0,0,0,0
3,201392388,2170660915,39044,36895,2024-10-04 19:38:33,0,0,0,0,0,0
3,201392388,2170660915,0,0,2024-10-04 19:38:33,0,0,0,0,0,0
3,201392388,2170660915,58003,36895,2024-10-04 19:38:33,0,0,0,0,0,0
3,201392388,2170660915,39044,36895,2024-10-04 19:38:34,0,0,0,0,0,0
3,201392388,2170660915,0,0,2024-10-04 19:38:34,0,0,0,0,0,0
3,201392388,2170660915,58003,36895,2024-10-04 19:38:34,0,0,0,0,0,0
3,201392388,2170660915,39044,36895,2024-10-04 19:38:35,0,0,0,0,0,0
3,201392388,2170660915,0,0,2024-10-04 19:38:35,0,0,0,0,0,0
3,201392388,2170660915,58003,36895,2024-10-04 19:38:35,0,0,0,0,0,0
3,201392388,2170660915,39044,36895,2024-10-04 19:38:36,0,0,0,0,0,0
3,201392388,2170660915,0,0,2024-10-04 19:38:36,128,0,128,1,0,1
3,201392388,2170660915,58003,36895,2024-10-04 19:38:36,0,0,0,0,0,0
3,201392388,2170660915,39044,36895,2024-10-04 19:38:37,0,0,0,0,0,0
3,201392388,2170660915,0,0,2024-10-04 19:38:37,128,84,212,1,1,2
3,201392388,2170660915,58003,36895,2024-10-04 19:38:37,0,0,0,0,0,0
3,201392388,2170660915,39044,36895,2024-10-04 19:38:38,0,0,0,0,0,0
3,201392388,1145490691,49884,47873,2024-10-04 19:38:38,2316,17941,20257,15,21,36
3,201392388,2170660915,0,0,2024-10-04 19:38:38,128,168,296,1,2,3
3,201392388,2170660915,58003,36895,2024-10-04 19:38:38,0,0,0,0,0,0
3,201392388,2170660915,39044,36895,2024-10-04 19:38:39,0,0,0,0,0,0
3,201392388,1145490691,49884,47873,2024-10-04 19:38:39,0,0,0,0,0,0
3,201392388,2170660915,0,0,2024-10-04 19:38:39,0,0,0,0,0,0
3,201392388,2170660915,58003,36895,2024-10-04 19:38:39,0,0,0,0,0,0
3,201392388,2170660915,39044,36895,2024-10-04 19:38:40,0,0,0,0,0,0
3,201392388,1145490691,49884,47873,2024-10-04 19:38:40,4356,79327,83683,43,56,99
3,201392388,2170660915,0,0,2024-10-04 19:38:40,0,0,0,0,0,0
3,201392388,2170660915,58003,36895,2024-10-04 19:38:40,0,0,0,0,0,0
3,201392388,2170660915,39044,36895,2024-10-04 19:38:41,0,0,0,0,0,0
3,201392388,1145490691,49884,47873,2024-10-04 19:38:41,0,0,0,0,0,0
3,201392388,2170660915,0,0,2024-10-04 19:38:41,0,0,0,0,0,0
3,201392388,2170660915,58003,36895,2024-10-04 19:38:41,0,0,0,0,0,0
3,201392388,2170660915,39044,36895,2024-10-04 19:38:42,0,0,0,0,0,0
3,201392388,1145490691,49884,47873,2024-10-04 19:38:42,0,0,0,0,0,0
3,201392388,2170660915,0,0,2024-10-04 19:38:42,0,0,0,0,0,0
3,201392388,2170660915,58003,36895,2024-10-04 19:38:42,0,0,0,0,0,0
3,201392388,2170660915,39044,36895,2024-10-04 19:38:43,0,0,0,0,0,0
3,201392388,1145490691,49884,47873,2024-10-04 19:38:43,0,0,0,0,0,0
3,201392388,2170660915,0,0,2024-10-04 19:38:43,0,0,0,0,0,0
3,201392388,2170660915,58003,36895,2024-10-04 19:38:43,0,0,0,0,0,0
3,201392388,2170660915,39044,36895,2024-10-04 19:38:44,0,0,0,0,0,0
3,201392388,1145490691,49884,47873,2024-10-04 19:38:44,0,0,0,0,0,0
3,201392388,2170660915,0,0,2024-10-04 19:38:44,0,0,0,0,0,0
3,201392388,2170660915,58003,36895,2024-10-04 19:38:44,0,0,0,0,0,0
3,201392388,2170660915,39044,36895,2024-10-04 19:38:45,0,0,0,0,0,0
3,201392388,1145490691,49884,47873,2024-10-04 19:38:45,0,0,0,0,0,0
3,201392388,2170660915,0,0,2024-10-04 19:38:45,0,0,0,0,0,0
3,201392388,2170660915,58003,36895,2024-10-04 19:38:45,0,0,0,0,0,0
3,201392388,2170660915,39044,36895,2024-10-04 19:38:46,0,0,0,0,0,0
3,201392388,1145490691,49884,47873,2024-10-04 19:38:46,0,0,0,0,0,0
3,201392388,2170660915,0,0,2024-10-04 19:38:46,0,0,0,0,0,0
3,201392388,2170660915,58003,36895,2024-10-04 19:38:46,0,0,0,0,0,0
3,201392388,2170660915,39044,36895,2024-10-04 19:38:47,0,0,0,0,0,0
3,201392388,2170660915,0,0,2024-10-04 19:38:47,0,0,0,0,0,0
3,201392388,2170660915,58003,36895,2024-10-04 19:38:47,0,0,0,0,0,0
3,201392388,2170660915,39044,36895,2024-10-04 19:38:48,0,0,0,0,0,0
3,201392388,2170660915,0,0,2024-10-04 19:38:48,0,0,0,0,0,0
3,201392388,2170660915,58003,36895,2024-10-04 19:38:48,0,0,0,0,0,0
3,201392388,2170660915,39044,36895,2024-10-04 19:38:49,0,0,0,0,0,0
3,201392388,2170660915,0,0,2024-10-04 19:38:49,0,0,0,0,0,0
3,201392388,2170660915,58003,36895,2024-10-04 19:38:49,0,0,0,0,0,0
3,201392388,2170660915,39044,36895,2024-10-04 19:38:50,0,0,0,0,0,0
3,201392388,2170660915,0,0,2024-10-04 19:38:50,128,84,212,1,1,2
3,201392388,2170660915,58003,36895,2024-10-04 19:38:50,0,0,0,0,0,0
3,201392388,2170660915,39044,36895,2024-10-04 19:38:51,0,0,0,0,0,0
3,201392388,2170660915,0,0,2024-10-04 19:38:51,128,84,212,1,1,2
3,201392388,2170660915,58003,36895,2024-10-04 19:38:51,0,0,0,0,0,0
3,201392388,2170660915,39044,36895,2024-10-04 19:38:52,0,0,0,0,0,0
3,201392388,2170660915,0,0,2024-10-04 19:38:52,256,84,340,2,1,3
3,201392388,2170660915,58003,36895,2024-10-04 19:38:52,0,0,0,0,0,0
3,201392388,2170660915,39044,36895,2024-10-04 19:38:53,0,0,0,0,0,0
3,201392388,2170660915,0,0,2024-10-04 19:38:53,128,84,212,1,1,2
3,201392388,2170660915,58003,36895,2024-10-04 19:38:53,0,0,0,0,0,0
3,201392388,2170660915,39044,36895,2024-10-04 19:38:54,0,0,0,0,0,0
3,201392388,2170660915,0,0,2024-10-04 19:38:54,128,84,212,1,1,2
3,201392388,2170660915,58003,36895,2024-10-04 19:38:54,0,0,0,0,0,0
3,201392388,2170660915,39044,36895,2024-10-04 19:38:55,0,0,0,0,0,0
3,201392388,2170660915,0,0,2024-10-04 19:38:55,128,84,212,1,1,2
3,201392388,2170660915,58003,36895,2024-10-04 19:38:55,0,0,0,0,0,0
3,201392388,2170660915,39044,36895,2024-10-04 19:38:56,0,0,0,0,0,0
3,201392388,2170660915,0,0,2024-10-04 19:38:56,128,84,212,1,1,2
3,201392388,2170660915,58003,36895,2024-10-04 19:38:56,0,0,0,0,0,0
3,201392388,2170660915,39044,36895,2024-10-04 19:38:57,0,0,0,0,0,0
3,201392388,2170660915,0,0,2024-10-04 19:38:57,0,84,84,0,1,1
3,201392388,2170660915,58003,36895,2024-10-04 19:38:57,0,0,0,0,0,0
3,201392388,2170660915,39044,36895,2024-10-04 19:38:58,0,0,0,0,0,0
3,201392388,2170660915,0,0,2024-10-04 19:38:58,128,84,212,1,1,2
3,201392388,2170660915,58003,36895,2024-10-04 19:38:58,0,0,0,0,0,0
3,201392388,2170660915,39044,36895,2024-10-04 19:38:59,0,0,0,0,0,0
3,201392388,2170660915,0,0,2024-10-04 19:38:59,128,84,212,1,1,2
3,201392388,2170660915,58003,36895,2024-10-04 19:38:59,0,0,0,0,0,0
3,201392388,2170660915,39044,36895,2024-10-04 19:39:00,0,0,0,0,0,0
3,201392388,2170660915,0,0,2024-10-04 19:39:00,0,0,0,0,0,0
3,201392388,2170660915,58003,36895,2024-10-04 19:39:00,0,0,0,0,0,0
3,201392388,2170660915,39044,36895,2024-10-04 19:39:01,0,0,0,0,0,0
3,201392388,2170660915,55527,36895,2024-10-04 19:39:01,570,455,1025,5,5,10
3,201392388,2170660915,0,0,2024-10-04 19:39:01,128,0,128,1,0,1
3,201392388,2170660915,58003,36895,2024-10-04 19:39:01,0,0,0,0,0,0
3,201392388,2170660915,39044,36895,2024-10-04 19:39:02,0,0,0,0,0,0
3,201392388,2170660915,55527,36895,2024-10-04 19:39:02,0,0,0,0,0,0
3,201392388,2170660915,0,0,2024-10-04 19:39:02,128,84,212,1,1,2
3,201392388,2170660915,58003,36895,2024-10-04 19:39:02,0,0,0,0,0,0
3,201392388,2170660915,39044,36895,2024-10-04 19:39:03,0,0,0,0,0,0
3,201392388,2170660915,0,0,2024-10-04 19:39:03,128,84,212,1,1,2
3,201392388,2170660915,58003,36895,2024-10-04 19:39:03,0,0,0,0,0,0
3,201392388,2170660915,39044,36895,2024-10-04 19:39:04,0,0,0,0,0,0
3,201392388,2170660915,0,0,2024-10-04 19:39:04,0,0,0,0,0,0
3,201392388,2170660915,58003,36895,2024-10-04 19:39:04,0,0,0,0,0,0
3,201392388,2170660915,39044,36895,2024-10-04 19:39:05,0,0,0,0,0,0
3,201392388,2170660915,0,0,2024-10-04 19:39:05,0,84,84,0,1,1
3,201392388,2170660915,58003,36895,2024-10-04 19:39:05,0,0,0,0,0,0
3,201392388,2170660915,39044,36895,2024-10-04 19:39:06,0,0,0,0,0,0
3,201392388,2170660915,0,0,2024-10-04 19:39:06,0,0,0,0,0,0
3,201392388,2170660915,58003,36895,2024-10-04 19:39:06,0,0,0,0,0,0
3,201392388,2170660915,39044,36895,2024-10-04 19:39:07,0,0,0,0,0,0
3,201392388,2170660915,0,0,2024-10-04 19:39:07,128,84,212,1,1,2
3,201392388,2170660915,58003,36895,2024-10-04 19:39:07,0,0,0,0,0,0
3,201392388,2170660915,39044,36895,2024-10-04 19:39:08,0,0,0,0,0,0
3,201392388,2170660915,0,0,2024-10-04 19:39:08,128,84,212,1,1,2
3,201392388,2170660915,58003,36895,2024-10-04 19:39:08,0,0,0,0,0,0
3,201392388,2170660915,39044,36895,2024-10-04 19:39:09,0,0,0,0,0,0
3,201392388,1145490692,20167,47873,2024-10-04 19:39:09,3872,53079,56951,29,44,73
3,201392388,2170660915,0,0,2024-10-04 19:39:09,128,84,212,1,1,2
3,201392388,2170660915,58003,36895,2024-10-04 19:39:09,0,0,0,0,0,0
3,201392388,2170660915,39044,36895,2024-10-04 19:39:10,0,0,0,0,0,0
3,201392388,1145490692,20167,47873,2024-10-04 19:39:10,0,0,0,0,0,0
3,201392388,2170660915,0,0,2024-10-04 19:39:10,0,0,0,0,0,0
3,201392388,2170660915,58003,36895,2024-10-04 19:39:10,0,0,0,0,0,0
3,201392388,2170660915,39044,36895,2024-10-04 19:39:11,0,0,0,0,0,0
3,201392388,1145490692,20167,47873,2024-10-04 19:39:11,2748,46245,48993,26,34,60
3,201392388,2170660915,0,0,2024-10-04 19:39:11,0,0,0,0,0,0
3,201392388,2170660915,58003,36895,2024-10-04 19:39:11,0,0,0,0,0,0
3,201392388,2170660915,39044,36895,2024-10-04 19:39:12,0,0,0,0,0,0
3,201392388,2170660915,0,0,2024-10-04 19:39:12,0,0,0,0,0,0
3,201392388,2170660915,58003,36895,2024-10-04 19:39:12,0,0,0,0,0,0
3,201392388,2170660915,39044,36895,2024-10-04 19:39:13,0,0,0,0,0,0
3,201392388,2170660915,0,0,2024-10-04 19:39:13,0,0,0,0,0,0
3,201392388,2170660915,58003,36895,2024-10-04 19:39:13,0,0,0,0,0,0
3,201392388,2170660915,39044,36895,2024-10-04 19:39:14,0,0,0,0,0,0
3,201392388,2170660915,0,0,2024-10-04 19:39:14,0,0,0,0,0,0
3,201392388,2170660915,58003,36895,2024-10-04 19:39:14,0,0,0,0,0,0
3,201392388,2170660915,39044,36895,2024-10-04 19:39:15,0,0,0,0,0,0
3,201392388,2170660915,0,0,2024-10-04 19:39:15,0,0,0,0,0,0
3,201392388,2170660915,58003,36895,2024-10-04 19:39:15,0,0,0,0,0,0
3,201392388,2170660915,39044,36895,2024-10-04 19:39:16,0,0,0,0,0,0
3,201392388,2170660915,0,0,2024-10-04 19:39:16,0,0,0,0,0,0
3,201392388,2170660915,58003,36895,2024-10-04 19:39:16,0,0,0,0,0,0
3,201392388,2170660915,39044,36895,2024-10-04 19:39:17,0,0,0,0,0,0
3,201392388,2170660915,0,0,2024-10-04 19:39:17,0,0,0,0,0,0
3,201392388,2170660915,58003,36895,2024-10-04 19:39:17,0,0,0,0,0,0
3,201392388,2170660915,39044,36895,2024-10-04 19:39:18,0,0,0,0,0,0
3,201392388,2170660915,0,0,2024-10-04 19:39:18,0,0,0,0,0,0
3,201392388,2170660915,58003,36895,2024-10-04 19:39:18,0,0,0,0,0,0
3,201392388,2170660915,39044,36895,2024-10-04 19:39:19,0,0,0,0,0,0
3,201392388,2170660915,0,0,2024-10-04 19:39:19,128,0,128,1,0,1
3,201392388,2170660915,58003,36895,2024-10-04 19:39:19,0,0,0,0,0,0
3,201392388,2170660915,39044,36895,2024-10-04 19:39:20,0,0,0,0,0,0
3,201392388,2170660915,0,0,2024-10-04 19:39:20,128,84,212,1,1,2
3,201392388,2170660915,58003,36895,2024-10-04 19:39:20,0,0,0,0,0,0
3,201392388,2170660915,39044,36895,2024-10-04 19:39:21,0,0,0,0,0,0
3,201392388,2170660915,0,0,2024-10-04 19:39:21,128,84,212,1,1,2
3,201392388,2170660915,58003,36895,2024-10-04 19:39:21,0,0,0,0,0,0
3,201392388,2170660915,39044,36895,2024-10-04 19:39:22,0,0,0,0,0,0
3,201392388,2170660915,0,0,2024-10-04 19:39:22,128,84,212,1,1,2
3,201392388,2170660915,58003,36895,2024-10-04 19:39:22,0,0,0,0,0,0
3,201392388,2170660915,39044,36895,2024-10-04 19:39:23,0,0,0,0,0,0
3,201392388,2170660915,0,0,2024-10-04 19:39:23,0,84,84,0,1,1
3,201392388,2170660915,58003,36895,2024-10-04 19:39:23,0,0,0,0,0,0
3,201392388,2170660915,39044,36895,2024-10-04 19:39:24,0,0,0,0,0,0
3,201392388,2170660915,0,0,2024-10-04 19:39:24,128,84,212,1,1,2
3,201392388,2170660915,58003,36895,2024-10-04 19:39:24,0,0,0,0,0,0
3,201392388,2170660915,39044,36895,2024-10-04 19:39:25,0,0,0,0,0,0
3,201392388,2170660915,0,0,2024-10-04 19:39:25,128,84,212,1,1,2
3,201392388,2170660915,58003,36895,2024-10-04 19:39:25,0,0,0,0,0,0
3,201392388,2170660915,39044,36895,2024-10-04 19:39:26,0,0,0,0,0,0
3,201392388,2170660915,0,0,2024-10-04 19:39:26,128,84,212,1,1,2
3,201392388,2170660915,58003,36895,2024-10-04 19:39:26,0,0,0,0,0,0
3,201392388,2170660915,39044,36895,2024-10-04 19:39:27,0,0,0,0,0,0
3,201392388,2170660915,0,0,2024-10-04 19:39:27,128,84,212,1,1,2
3,201392388,2170660915,58003,36895,2024-10-04 19:39:27,0,0,0,0,0,0
3,201392388,2170660915,39044,36895,2024-10-04 19:39:28,0,0,0,0,0,0
3,201392388,2170660915,0,0,2024-10-04 19:39:28,128,84,212,1,1,2
3,201392388,2170660915,58003,36895,2024-10-04 19:39:28,0,0,0,0,0,0
3,201392388,2170660915,39044,36895,2024-10-04 19:39:29,0,0,0,0,0,0
3,201392388,2170660915,0,0,2024-10-04 19:39:29,128,84,212,1,1,2
3,201392388,2170660915,58003,36895,2024-10-04 19:39:29,0,0,0,0,0,0
3,201392388,2170660915,39044,36895,2024-10-04 19:39:30,0,0,0,0,0,0
3,201392388,2170660915,0,0,2024-10-04 19:39:30,0,0,0,0,0,0
3,201392388,2170660915,4764,36895,2024-10-04 19:39:30,666,507,1173,6,6,12
3,201392388,2170660915,58003,36895,2024-10-04 19:39:30,0,0,0,0,0,0
3,201392388,2170660915,39044,36895,2024-10-04 19:39:31,0,0,0,0,0,0
3,201392388,2170660915,0,0,2024-10-04 19:39:31,128,84,212,1,1,2
3,201392388,2170660915,4764,36895,2024-10-04 19:39:31,0,0,0,0,0,0
3,201392388,2170660915,58003,36895,2024-10-04 19:39:31,0,0,0,0,0,0
3,201392388,2170660915,39044,36895,2024-10-04 19:39:32,0,0,0,0,0,0
3,201392388,2170660915,0,0,2024-10-04 19:39:32,128,84,212,1,1,2
3,201392388,2170660915,4764,36895,2024-10-04 19:39:32,0,0,0,0,0,0
3,201392388,2170660915,58003,36895,2024-10-04 19:39:32,0,0,0,0,0,0
3,201392388,2170660915,39044,36895,2024-10-04 19:39:33,0,0,0,0,0,0
3,201392388,2170660915,0,0,2024-10-04 19:39:33,128,84,212,1,1,2
3,201392388,2170660915,58003,36895,2024-10-04 19:39:33,0,0,0,0,0,0
3,201392388,2170660915,39044,36895,2024-10-04 19:39:34,0,0,0,0,0,0
3,201392388,2170660915,0,0,2024-10-04 19:39:34,0,0,0,0,0,0
3,201392388,2170660915,58003,36895,2024-10-04 19:39:34,0,0,0,0,0,0
3,201392388,2170660915,39044,36895,2024-10-04 19:39:35,0,0,0,0,0,0
3,201392388,2170660915,0,0,2024-10-04 19:39:35,0,0,0,0,0,0
3,201392388,2170660915,58003,36895,2024-10-04 19:39:35,0,0,0,0,0,0
3,201392388,2170660915,0,0,2024-10-04 19:39:36,0,0,0,0,0,0
3,201392388,2170660915,58003,36895,2024-10-04 19:39:36,0,0,0,0,0,0
3,201392388,2170660915,0,0,2024-10-04 19:39:37,128,84,212,1,1,2
3,201392388,2170660915,58003,36895,2024-10-04 19:39:37,0,0,0,0,0,0
3,201392388,2170660915,0,0,2024-10-04 19:39:38,128,84,212,1,1,2
3,201392388,2170660915,58003,36895,2024-10-04 19:39:38,0,0,0,0,0,0
3,201392388,1145490692,11963,47873,2024-10-04 19:39:39,2832,32637,35469,20,31,51
3,201392388,2170660915,0,0,2024-10-04 19:39:39,128,84,212,1,1,2
3,201392388,2170660915,58003,36895,2024-10-04 19:39:39,0,0,0,0,0,0
3,201392388,1145490692,11963,47873,2024-10-04 19:39:40,2940,62671,65611,29,46,75
3,201392388,2170660915,0,0,2024-10-04 19:39:40,0,0,0,0,0,0
3,201392388,2170660915,58003,36895,2024-10-04 19:39:40,0,0,0,0,0,0
3,201392388,1145490692,11963,47873,2024-10-04 19:39:41,0,0,0,0,0,0
3,201392388,2170660915,0,0,2024-10-04 19:39:41,0,0,0,0,0,0
3,201392388,2170660915,58003,36895,2024-10-04 19:39:41,0,0,0,0,0,0
3,201392388,1145490692,11963,47873,2024-10-04 19:39:42,0,0,0,0,0,0
3,201392388,2170660915,0,0,2024-10-04 19:39:42,0,0,0,0,0,0
3,201392388,2170660915,58003,36895,2024-10-04 19:39:42,0,0,0,0,0,0
3,201392388,1145490692,11963,47873,2024-10-04 19:39:43,0,0,0,0,0,0
3,201392388,2170660915,0,0,2024-10-04 19:39:43,0,0,0,0,0,0
3,201392388,2170660915,58003,36895,2024-10-04 19:39:43,0,0,0,0,0,0
3,201392388,1145490692,11963,47873,2024-10-04 19:39:44,0,0,0,0,0,0
3,201392388,2170660915,0,0,2024-10-04 19:39:44,0,0,0,0,0,0
3,201392388,2170660915,58003,36895,2024-10-04 19:39:44,0,0,0,0,0,0
3,201392388,1145490692,11963,47873,2024-10-04 19:39:45,0,0,0,0,0,0
3,201392388,2170660915,0,0,2024-10-04 19:39:45,0,0,0,0,0,0
3,201392388,2170660915,58003,36895,2024-10-04 19:39:45,0,0,0,0,0,0
3,201392388,1145490692,11963,47873,2024-10-04 19:39:46,0,0,0,0,0,0
3,201392388,2170660915,0,0,2024-10-04 19:39:46,0,0,0,0,0,0
3,201392388,2170660915,58003,36895,2024-10-04 19:39:46,0,0,0,0,0,0
3,201392388,1145490692,11963,47873,2024-10-04 19:39:47,0,0,0,0,0,0
3,201392388,2170660915,0,0,2024-10-04 19:39:47,0,0,0,0,0,0
3,201392388,2170660915,58003,36895,2024-10-04 19:39:47,0,0,0,0,0,0
3,201392388,1145490692,11963,47873,2024-10-04 19:39:48,0,0,0,0,0,0
3,201392388,2170660915,0,0,2024-10-04 19:39:48,0,0,0,0,0,0
3,201392388,2170660915,58003,36895,2024-10-04 19:39:48,0,0,0,0,0,0
3,201392388,1145490692,11963,47873,2024-10-04 19:39:49,0,0,0,0,0,0
3,201392388,2170660915,0,0,2024-10-04 19:39:49,0,0,0,0,0,0
3,201392388,2170660915,58003,36895,2024-10-04 19:39:49,0,0,0,0,0,0
3,201392388,1145490692,11963,47873,2024-10-04 19:39:50,0,0,0,0,0,0
3,201392388,2170660915,0,0,2024-10-04 19:39:50,128,0,128,1,0,1
3,201392388,2170660915,58003,36895,2024-10-04 19:39:50,0,0,0,0,0,0
3,201392388,1145490692,11963,47873,2024-10-04 19:39:51,0,0,0,0,0,0
3,201392388,2170660915,0,0,2024-10-04 19:39:51,128,84,212,1,1,2
3,201392388,2170660915,58003,36895,2024-10-04 19:39:51,0,0,0,0,0,0
3,201392388,1145490692,11963,47873,2024-10-04 19:39:52,0,0,0,0,0,0
3,201392388,2170660915,0,0,2024-10-04 19:39:52,128,84,212,1,1,2
3,201392388,2170660915,58003,36895,2024-10-04 19:39:52,0,0,0,0,0,0
3,201392388,1145490692,11963,47873,2024-10-04 19:39:53,0,0,0,0,0,0
3,201392388,2170660915,0,0,2024-10-04 19:39:53,128,84,212,1,1,2
3,201392388,2170660915,58003,36895,2024-10-04 19:39:53,0,0,0,0,0,0
3,201392388,1145490692,11963,47873,2024-10-04 19:39:54,0,0,0,0,0,0
3,201392388,2170660915,0,0,2024-10-04 19:39:54,128,168,296,1,2,3
3,201392388,2170660915,58003,36895,2024-10-04 19:39:54,0,0,0,0,0,0
3,201392388,1145490692,11963,47873,2024-10-04 19:39:55,0,0,0,0,0,0
3,201392388,2170660915,0,0,2024-10-04 19:39:55,128,84,212,1,1,2
3,201392388,2170660915,58003,36895,2024-10-04 19:39:55,0,0,0,0,0,0
3,201392388,1145490692,11963,47873,2024-10-04 19:39:56,0,0,0,0,0,0
3,201392388,2170660915,0,0,2024-10-04 19:39:56,128,84,212,1,1,2
3,201392388,2170660915,58003,36895,2024-10-04 19:39:56,0,0,0,0,0,0
3,201392388,1145490692,11963,47873,2024-10-04 19:39:57,0,0,0,0,0,0
3,201392388,2170660915,0,0,2024-10-04 19:39:57,128,84,212,1,1,2
3,201392388,2170660915,58003,36895,2024-10-04 19:39:57,0,0,0,0,0,0
3,201392388,1145490692,11963,47873,2024-10-04 19:39:58,0,0,0,0,0,0
3,201392388,2170660915,0,0,2024-10-04 19:39:58,128,84,212,1,1,2
3,201392388,2170660915,58003,36895,2024-10-04 19:39:58,0,0,0,0,0,0
3,201392388,1145490692,11963,47873,2024-10-04 19:39:59,0,0,0,0,0,0
3,201392388,2170660915,0,0,2024-10-04 19:39:59,128,84,212,1,1,2
3,201392388,2170660915,58003,36895,2024-10-04 19:39:59,0,0,0,0,0,0
3,201392388,1145490692,11963,47873,2024-10-04 19:40:00,0,0,0,0,0,0
3,201392388,2170660915,0,0,2024-10-04 19:40:00,0,0,0,0,0,0
3,201392388,2170660915,58003,36895,2024-10-04 19:40:00,0,0,0,0,0,0
3,201392388,2170660915,0,0,2024-10-04 19:40:01,128,0,128,1,0,1
3,201392388,2170660915,24253,36895,2024-10-04 19:40:01,666,507,1173,6,6,12
3,201392388,2170660915,58003,36895,2024-10-04 19:40:01,0,0,0,0,0,0
3,201392388,2170660915,0,0,2024-10-04 19:40:02,128,84,212,1,1,2
3,201392388,2170660915,24253,36895,2024-10-04 19:40:02,0,0,0,0,0,0
3,201392388,2170660915,58003,36895,2024-10-04 19:40:02,0,0,0,0,0,0
3,201392388,2170660915,0,0,2024-10-04 19:40:03,128,84,212,1,1,2
3,201392388,2170660915,24253,36895,2024-10-04 19:40:03,0,0,0,0,0,0
3,201392388,2170660915,58003,36895,2024-10-04 19:40:03,0,0,0,0,0,0
3,201392388,2170660915,0,0,2024-10-04 19:40:04,0,0,0,0,0,0
3,201392388,2170660915,24253,36895,2024-10-04 19:40:04,0,0,0,0,0,0
3,201392388,2170660915,58003,36895,2024-10-04 19:40:04,0,0,0,0,0,0
3,201392388,2170660915,0,0,2024-10-04 19:40:05,0,84,84,0,1,1
3,201392388,2170660915,24253,36895,2024-10-04 19:40:05,0,0,0,0,0,0
3,201392388,2170660915,58003,36895,2024-10-04 19:40:05,0,0,0,0,0,0
3,201392388,2170660915,0,0,2024-10-04 19:40:06,0,0,0,0,0,0
3,201392388,2170660915,24253,36895,2024-10-04 19:40:06,0,0,0,0,0,0
3,201392388,2170660915,58003,36895,2024-10-04 19:40:06,0,0,0,0,0,0
3,201392388,2170660915,0,0,2024-10-04 19:40:07,0,0,0,0,0,0
3,201392388,2170660915,58003,36895,2024-10-04 19:40:07,0,0,0,0,0,0
3,201392388,2170660915,0,0,2024-10-04 19:40:08,128,84,212,1,1,2
3,201392388,2170660915,58003,36895,2024-10-04 19:40:08,0,0,0,0,0,0
3,201392388,2170660915,0,0,2024-10-04 19:40:09,256,168,424,2,2,4
3,201392388,1145490691,15545,47873,2024-10-04 19:40:09,104,60,164,1,1,2
3,201392388,2170660915,58003,36895,2024-10-04 19:40:09,0,0,0,0,0,0
3,201392388,2170660915,0,0,2024-10-04 19:40:10,0,0,0,0,0,0
3,201392388,1145490691,15545,47873,2024-10-04 19:40:10,6484,101276,107760,55,78,133
3,201392388,2170660915,58003,36895,2024-10-04 19:40:10,0,0,0,0,0,0
3,201392388,2170660915,0,0,2024-10-04 19:40:11,0,0,0,0,0,0
3,201392388,1145490691,15545,47873,2024-10-04 19:40:11,0,0,0,0,0,0
3,201392388,2170660915,58003,36895,2024-10-04 19:40:11,0,0,0,0,0,0
3,201392388,2170660915,0,0,2024-10-04 19:40:12,0,0,0,0,0,0
3,201392388,1145490691,15545,47873,2024-10-04 19:40:12,0,0,0,0,0,0
3,201392388,2170660915,58003,36895,2024-10-04 19:40:12,0,0,0,0,0,0
3,201392388,2170660915,0,0,2024-10-04 19:40:13,0,0,0,0,0,0
3,201392388,1145490691,15545,47873,2024-10-04 19:40:13,0,0,0,0,0,0
3,201392388,2170660915,58003,36895,2024-10-04 19:40:13,0,0,0,0,0,0
3,201392388,2170660915,0,0,2024-10-04 19:40:14,0,0,0,0,0,0
3,201392388,1145490691,15545,47873,2024-10-04 19:40:14,0,0,0,0,0,0
3,201392388,2170660915,58003,36895,2024-10-04 19:40:14,0,0,0,0,0,0
3,201392388,2170660915,0,0,2024-10-04 19:40:15,0,0,0,0,0,0
3,201392388,1145490691,15545,47873,2024-10-04 19:40:15,0,0,0,0,0,0
3,201392388,2170660915,58003,36895,2024-10-04 19:40:15,0,0,0,0,0,0
3,201392388,2170660915,0,0,2024-10-04 19:40:16,0,0,0,0,0,0
3,201392388,1145490691,15545,47873,2024-10-04 19:40:16,0,0,0,0,0,0
3,201392388,2170660915,58003,36895,2024-10-04 19:40:16,0,0,0,0,0,0
3,201392388,2170660915,0,0,2024-10-04 19:40:17,0,0,0,0,0,0
3,201392388,1145490691,15545,47873,2024-10-04 19:40:17,0,0,0,0,0,0
3,201392388,2170660915,58003,36895,2024-10-04 19:40:17,0,0,0,0,0,0
3,201392388,2170660915,0,0,2024-10-04 19:40:18,0,0,0,0,0,0
3,201392388,1145490691,15545,47873,2024-10-04 19:40:18,0,0,0,0,0,0
3,201392388,2170660915,58003,36895,2024-10-04 19:40:18,0,0,0,0,0,0
3,201392388,2170660915,0,0,2024-10-04 19:40:19,0,0,0,0,0,0
3,201392388,1145490691,15545,47873,2024-10-04 19:40:19,0,0,0,0,0,0
3,201392388,2170660915,58003,36895,2024-10-04 19:40:19,0,0,0,0,0,0
3,201392388,2170660915,0,0,2024-10-04 19:40:20,128,0,128,1,0,1
3,201392388,1145490691,15545,47873,2024-10-04 19:40:20,0,0,0,0,0,0
3,201392388,2170660915,58003,36895,2024-10-04 19:40:20,0,0,0,0,0,0
3,201392388,2170660915,0,0,2024-10-04 19:40:21,128,168,296,1,2,3
3,201392388,1145490691,15545,47873,2024-10-04 19:40:21,0,0,0,0,0,0
3,201392388,2170660915,58003,36895,2024-10-04 19:40:21,0,0,0,0,0,0
3,201392388,2170660915,0,0,2024-10-04 19:40:22,128,84,212,1,1,2
3,201392388,1145490691,15545,47873,2024-10-04 19:40:22,0,0,0,0,0,0
3,201392388,2170660915,58003,36895,2024-10-04 19:40:22,0,0,0,0,0,0
3,201392388,2170660915,0,0,2024-10-04 19:40:23,128,84,212,1,1,2
3,201392388,1145490691,15545,47873,2024-10-04 19:40:23,0,0,0,0,0,0
3,201392388,2170660915,58003,36895,2024-10-04 19:40:23,0,0,0,0,0,0
3,201392388,2170660915,0,0,2024-10-04 19:40:24,128,84,212,1,1,2
3,201392388,1145490691,15545,47873,2024-10-04 19:40:24,0,0,0,0,0,0
3,201392388,2170660915,58003,36895,2024-10-04 19:40:24,0,0,0,0,0,0
3,201392388,2170660915,0,0,2024-10-04 19:40:25,128,84,212,1,1,2
3,201392388,1145490691,15545,47873,2024-10-04 19:40:25,0,0,0,0,0,0
3,201392388,2170660915,58003,36895,2024-10-04 19:40:25,0,0,0,0,0,0
3,201392388,2170660915,0,0,2024-10-04 19:40:26,128,84,212,1,1,2
3,201392388,1145490691,15545,47873,2024-10-04 19:40:26,0,0,0,0,0,0
3,201392388,2170660915,58003,36895,2024-10-04 19:40:26,0,0,0,0,0,0
3,201392388,2170660915,0,0,2024-10-04 19:40:27,128,84,212,1,1,2
3,201392388,1145490691,15545,47873,2024-10-04 19:40:27,0,0,0,0,0,0
3,201392388,2170660915,58003,36895,2024-10-04 19:40:27,0,0,0,0,0,0
3,201392388,2170660915,0,0,2024-10-04 19:40:28,128,84,212,1,1,2
3,201392388,1145490691,15545,47873,2024-10-04 19:40:28,0,0,0,0,0,0
3,201392388,2170660915,58003,36895,2024-10-04 19:40:28,0,0,0,0,0,0
3,201392388,2170660915,0,0,2024-10-04 19:40:29,128,84,212,1,1,2
3,201392388,1145490691,15545,47873,2024-10-04 19:40:29,0,0,0,0,0,0
3,201392388,2170660915,58003,36895,2024-10-04 19:40:29,0,0,0,0,0,0
3,201392388,2170660915,0,0,2024-10-04 19:40:30,0,0,0,0,0,0
3,201392388,1145490691,15545,47873,2024-10-04 19:40:30,0,0,0,0,0,0
3,201392388,2170660915,58003,36895,2024-10-04 19:40:30,0,0,0,0,0,0
3,201392388,2170660915,0,0,2024-10-04 19:40:31,0,0,0,0,0,0
3,201392388,2170660915,15537,36895,2024-10-04 19:40:31,570,455,1025,5,5,10
3,201392388,2170660915,58003,36895,2024-10-04 19:40:31,0,0,0,0,0,0
3,201392388,2170660915,0,0,2024-10-04 19:40:32,128,84,212,1,1,2
3,201392388,2170660915,15537,36895,2024-10-04 19:40:32,0,0,0,0,0,0
3,201392388,2170660915,58003,36895,2024-10-04 19:40:32,0,0,0,0,0,0
3,201392388,2170660915,0,0,2024-10-04 19:40:33,128,84,212,1,1,2
3,201392388,2170660915,15537,36895,2024-10-04 19:40:33,0,0,0,0,0,0
3,201392388,2170660915,58003,36895,2024-10-04 19:40:33,0,0,0,0,0,0
3,201392388,2170660915,0,0,2024-10-04 19:40:34,128,84,212,1,1,2
3,201392388,2170660915,15537,36895,2024-10-04 19:40:34,0,0,0,0,0,0
3,201392388,2170660915,58003,36895,2024-10-04 19:40:34,0,0,0,0,0,0
3,201392388,2170660915,0,0,2024-10-04 19:40:35,0,0,0,0,0,0
3,201392388,2170660915,15537,36895,2024-10-04 19:40:35,0,0,0,0,0,0
3,201392388,2170660915,58003,36895,2024-10-04 19:40:35,0,0,0,0,0,0
3,201392388,2170660915,0,0,2024-10-04 19:40:36,0,0,0,0,0,0
3,201392388,2170660915,15537,36895,2024-10-04 19:40:36,0,0,0,0,0,0
3,201392388,2170660915,58003,36895,2024-10-04 19:40:36,0,0,0,0,0,0
3,201392388,2170660915,0,0,2024-10-04 19:40:37,128,0,128,1,0,1
3,201392388,2170660915,15537,36895,2024-10-04 19:40:37,0,0,0,0,0,0
3,201392388,2170660915,58003,36895,2024-10-04 19:40:37,0,0,0,0,0,0
3,201392388,2170660915,0,0,2024-10-04 19:40:38,128,84,212,1,1,2
3,201392388,2170660915,15537,36895,2024-10-04 19:40:38,0,0,0,0,0,0
3,201392388,2170660915,58003,36895,2024-10-04 19:40:38,0,0,0,0,0,0
3,201392388,2170660915,0,0,2024-10-04 19:40:39,128,84,212,1,1,2
3,201392388,2170660915,15537,36895,2024-10-04 19:40:39,0,0,0,0,0,0
3,201392388,2170660915,58003,36895,2024-10-04 19:40:39,0,0,0,0,0,0
3,201392388,1145490692,28863,47873,2024-10-04 19:40:40,4236,62575,66811,34,52,86
3,201392388,2170660915,0,0,2024-10-04 19:40:40,0,84,84,0,1,1
3,201392388,2170660915,15537,36895,2024-10-04 19:40:40,0,0,0,0,0,0
3,201392388,2170660915,58003,36895,2024-10-04 19:40:40,0,0,0,0,0,0
3,201392388,1145490692,28863,47873,2024-10-04 19:40:41,1644,28591,30235,16,22,38
3,201392388,2170660915,0,0,2024-10-04 19:40:41,0,0,0,0,0,0
3,201392388,2170660915,15537,36895,2024-10-04 19:40:41,0,0,0,0,0,0
3,201392388,2170660915,58003,36895,2024-10-04 19:40:41,0,0,0,0,0,0
3,201392388,1145490692,28863,47873,2024-10-04 19:40:42,0,0,0,0,0,0
3,201392388,2170660915,0,0,2024-10-04 19:40:42,0,0,0,0,0,0
3,201392388,2170660915,15537,36895,2024-10-04 19:40:42,0,0,0,0,0,0
3,201392388,2170660915,58003,36895,2024-10-04 19:40:42,0,0,0,0,0,0
3,201392388,1145490692,28863,47873,2024-10-04 19:40:43,0,0,0,0,0,0
3,201392388,2170660915,0,0,2024-10-04 19:40:43,0,0,0,0,0,0
3,201392388,2170660915,15537,36895,2024-10-04 19:40:43,0,0,0,0,0,0
3,201392388,2170660915,58003,36895,2024-10-04 19:40:43,0,0,0,0,0,0
3,201392388,1145490692,28863,47873,2024-10-04 19:40:44,0,0,0,0,0,0
3,201392388,2170660915,0,0,2024-10-04 19:40:44,0,0,0,0,0,0
3,201392388,2170660915,15537,36895,2024-10-04 19:40:44,0,0,0,0,0,0
3,201392388,2170660915,58003,36895,2024-10-04 19:40:44,0,0,0,0,0,0
3,201392388,2170660915,0,0,2024-10-04 19:40:45,0,0,0,0,0,0
3,201392388,2170660915,15537,36895,2024-10-04 19:40:45,0,0,0,0,0,0
3,201392388,2170660915,58003,36895,2024-10-04 19:40:45,0,0,0,0,0,0
3,201392388,2170660915,0,0,2024-10-04 19:40:46,0,0,0,0,0,0
3,201392388,2170660915,15537,36895,2024-10-04 19:40:46,0,0,0,0,0,0
3,201392388,2170660915,58003,36895,2024-10-04 19:40:46,0,0,0,0,0,0
3,201392388,2170660915,0,0,2024-10-04 19:40:47,0,0,0,0,0,0
3,201392388,2170660915,15537,36895,2024-10-04 19:40:47,0,0,0,0,0,0
3,201392388,2170660915,58003,36895,2024-10-04 19:40:47,0,0,0,0,0,0
3,201392388,2170660915,0,0,2024-10-04 19:40:48,0,0,0,0,0,0
3,201392388,2170660915,15537,36895,2024-10-04 19:40:48,0,0,0,0,0,0
3,201392388,2170660915,58003,36895,2024-10-04 19:40:48,0,0,0,0,0,0
3,201392388,2170660915,0,0,2024-10-04 19:40:49,0,0,0,0,0,0
3,201392388,2170660915,15537,36895,2024-10-04 19:40:49,0,0,0,0,0,0
3,201392388,2170660915,58003,36895,2024-10-04 19:40:49,0,0,0,0,0,0
3,201392388,2170660915,0,0,2024-10-04 19:40:50,0,0,0,0,0,0
3,201392388,2170660915,15537,36895,2024-10-04 19:40:50,0,0,0,0,0,0
3,201392388,2170660915,58003,36895,2024-10-04 19:40:50,0,0,0,0,0,0
3,201392388,2170660915,0,0,2024-10-04 19:40:51,128,0,128,1,0,1
3,201392388,2170660915,15537,36895,2024-10-04 19:40:51,0,0,0,0,0,0
3,201392388,2170660915,58003,36895,2024-10-04 19:40:51,0,0,0,0,0,0
3,201392388,2170660915,0,0,2024-10-04 19:40:52,128,84,212,1,1,2
3,201392388,2170660915,15537,36895,2024-10-04 19:40:52,0,0,0,0,0,0
3,201392388,2170660915,58003,36895,2024-10-04 19:40:52,0,0,0,0,0,0
3,201392388,2170660915,0,0,2024-10-04 19:40:53,128,84,212,1,1,2
3,201392388,2170660915,15537,36895,2024-10-04 19:40:53,0,0,0,0,0,0
3,201392388,2170660915,58003,36895,2024-10-04 19:40:53,0,0,0,0,0,0
3,201392388,2170660915,0,0,2024-10-04 19:40:54,128,84,212,1,1,2
3,201392388,2170660915,15537,36895,2024-10-04 19:40:54,0,0,0,0,0,0
3,201392388,2170660915,58003,36895,2024-10-04 19:40:54,0,0,0,0,0,0
3,201392388,2170660915,0,0,2024-10-04 19:40:55,128,168,296,1,2,3
3,201392388,2170660915,15537,36895,2024-10-04 19:40:55,0,0,0,0,0,0
3,201392388,2170660915,58003,36895,2024-10-04 19:40:55,0,0,0,0,0,0
3,201392388,2170660915,0,0,2024-10-04 19:40:56,128,84,212,1,1,2
3,201392388,2170660915,15537,36895,2024-10-04 19:40:56,0,0,0,0,0,0
3,201392388,2170660915,58003,36895,2024-10-04 19:40:56,0,0,0,0,0,0
3,201392388,2170660915,0,0,2024-10-04 19:40:57,128,84,212,1,1,2
3,201392388,2170660915,15537,36895,2024-10-04 19:40:57,0,0,0,0,0,0
3,201392388,2170660915,58003,36895,2024-10-04 19:40:57,0,0,0,0,0,0
3,201392388,2170660915,0,0,2024-10-04 19:40:58,128,84,212,1,1,2
3,201392388,2170660915,15537,36895,2024-10-04 19:40:58,0,0,0,0,0,0
3,201392388,2170660915,58003,36895,2024-10-04 19:40:58,0,0,0,0,0,0
3,201392388,2170660915,0,0,2024-10-04 19:40:59,128,84,212,1,1,2
3,201392388,2170660915,15537,36895,2024-10-04 19:40:59,0,0,0,0,0,0
3,201392388,2170660915,58003,36895,2024-10-04 19:40:59,0,0,0,0,0,0
3,201392388,2170660915,0,0,2024-10-04 19:41:00,128,84,212,1,1,2
3,201392388,2170660915,15537,36895,2024-10-04 19:41:00,0,0,0,0,0,0
3,201392388,2170660915,58003,36895,2024-10-04 19:41:00,0,0,0,0,0,0
3,201392388,2170660915,0,0,2024-10-04 19:41:01,0,0,0,0,0,0
3,201392388,2170660915,15537,36895,2024-10-04 19:41:01,0,0,0,0,0,0
3,201392388,2170660915,58003,36895,2024-10-04 19:41:01,0,0,0,0,0,0
3,201392388,2170660915,18564,36895,2024-10-04 19:41:02,666,507,1173,6,6,12
3,201392388,2170660915,0,0,2024-10-04 19:41:02,0,0,0,0,0,0
3,201392388,2170660915,15537,36895,2024-10-04 19:41:02,0,0,0,0,0,0
3,201392388,2170660915,58003,36895,2024-10-04 19:41:02,0,0,0,0,0,0
3,201392388,2170660915,18564,36895,2024-10-04 19:41:03,0,0,0,0,0,0
3,201392388,2170660915,0,0,2024-10-04 19:41:03,128,84,212,1,1,2
3,201392388,2170660915,15537,36895,2024-10-04 19:41:03,0,0,0,0,0,0
3,201392388,2170660915,58003,36895,2024-10-04 19:41:03,0,0,0,0,0,0
3,201392388,2170660915,18564,36895,2024-10-04 19:41:04,0,0,0,0,0,0
3,201392388,2170660915,0,0,2024-10-04 19:41:04,128,84,212,1,1,2
3,201392388,2170660915,15537,36895,2024-10-04 19:41:04,0,0,0,0,0,0
3,201392388,2170660915,58003,36895,2024-10-04 19:41:04,0,0,0,0,0,0
3,201392388,2170660915,0,0,2024-10-04 19:41:05,128,84,212,1,1,2
3,201392388,2170660915,15537,36895,2024-10-04 19:41:05,0,0,0,0,0,0
3,201392388,2170660915,58003,36895,2024-10-04 19:41:05,0,0,0,0,0,0
3,201392388,2170660915,0,0,2024-10-04 19:41:06,0,0,0,0,0,0
3,201392388,2170660915,15537,36895,2024-10-04 19:41:06,0,0,0,0,0,0
3,201392388,2170660915,58003,36895,2024-10-04 19:41:06,0,0,0,0,0,0
3,201392388,2170660915,0,0,2024-10-04 19:41:07,0,0,0,0,0,0
3,201392388,2170660915,58003,36895,2024-10-04 19:41:07,0,0,0,0,0,0
3,201392388,2170660915,0,0,2024-10-04 19:41:08,128,0,128,1,0,1
3,201392388,2170660915,58003,36895,2024-10-04 19:41:08,0,0,0,0,0,0
3,201392388,2170660915,0,0,2024-10-04 19:41:09,128,84,212,1,1,2
3,201392388,2170660915,58003,36895,2024-10-04 19:41:09,0,0,0,0,0,0
3,201392388,2170660915,0,0,2024-10-04 19:41:10,128,84,212,1,1,2
3,201392388,2170660915,58003,36895,2024-10-04 19:41:10,0,0,0,0,0,0
3,201392388,1145490690,21183,47873,2024-10-04 19:41:11,5176,89823,94999,42,66,108
3,201392388,2170660915,0,0,2024-10-04 19:41:11,0,84,84,0,1,1
3,201392388,2170660915,58003,36895,2024-10-04 19:41:11,0,0,0,0,0,0
3,201392388,1145490690,21183,47873,2024-10-04 19:41:12,384,13816,14200,4,8,12
3,201392388,2170660915,0,0,2024-10-04 19:41:12,0,0,0,0,0,0
3,201392388,2170660915,58003,36895,2024-10-04 19:41:12,0,0,0,0,0,0
3,201392388,1145490690,21183,47873,2024-10-04 19:41:13,1368,16003,17371,14,14,28
3,201392388,2170660915,0,0,2024-10-04 19:41:13,0,0,0,0,0,0
3,201392388,2170660915,58003,36895,2024-10-04 19:41:13,0,0,0,0,0,0
3,201392388,1145490690,21183,47873,2024-10-04 19:41:14,0,0,0,0,0,0
3,201392388,2170660915,0,0,2024-10-04 19:41:14,0,0,0,0,0,0
3,201392388,2170660915,58003,36895,2024-10-04 19:41:14,0,0,0,0,0,0
3,201392388,1145490690,21183,47873,2024-10-04 19:41:15,0,0,0,0,0,0
3,201392388,2170660915,0,0,2024-10-04 19:41:15,0,0,0,0,0,0
3,201392388,2170660915,58003,36895,2024-10-04 19:41:15,0,0,0,0,0,0
3,201392388,1145490690,21183,47873,2024-10-04 19:41:16,0,0,0,0,0,0
3,201392388,2170660915,0,0,2024-10-04 19:41:16,0,0,0,0,0,0
3,201392388,2170660915,58003,36895,2024-10-04 19:41:16,0,0,0,0,0,0
3,201392388,1145490690,21183,47873,2024-10-04 19:41:17,0,0,0,0,0,0
3,201392388,2170660915,0,0,2024-10-04 19:41:17,0,0,0,0,0,0
3,201392388,2170660915,58003,36895,2024-10-04 19:41:17,0,0,0,0,0,0
3,201392388,1145490690,21183,47873,2024-10-04 19:41:18,0,0,0,0,0,0
3,201392388,2170660915,0,0,2024-10-04 19:41:18,0,0,0,0,0,0
3,201392388,2170660915,58003,36895,2024-10-04 19:41:18,0,0,0,0,0,0
3,201392388,1145490690,21183,47873,2024-10-04 19:41:19,0,0,0,0,0,0
3,201392388,2170660915,0,0,2024-10-04 19:41:19,0,0,0,0,0,0
3,201392388,2170660915,58003,36895,2024-10-04 19:41:19,0,0,0,0,0,0
3,201392388,1145490690,21183,47873,2024-10-04 19:41:20,0,0,0,0,0,0
3,201392388,2170660915,0,0,2024-10-04 19:41:20,0,0,0,0,0,0
3,201392388,2170660915,58003,36895,2024-10-04 19:41:20,0,0,0,0,0,0
3,201392388,1145490690,21183,47873,2024-10-04 19:41:21,0,0,0,0,0,0
3,201392388,2170660915,0,0,2024-10-04 19:41:21,0,0,0,0,0,0
3,201392388,2170660915,58003,36895,2024-10-04 19:41:21,0,0,0,0,0,0
3,201392388,1145490690,21183,47873,2024-10-04 19:41:22,0,0,0,0,0,0
3,201392388,2170660915,0,0,2024-10-04 19:41:22,0,0,0,0,0,0
3,201392388,2170660915,58003,36895,2024-10-04 19:41:22,0,0,0,0,0,0
3,201392388,1145490690,21183,47873,2024-10-04 19:41:23,0,0,0,0,0,0
3,201392388,2170660915,0,0,2024-10-04 19:41:23,128,84,212,1,1,2
3,201392388,2170660915,58003,36895,2024-10-04 19:41:23,0,0,0,0,0,0
3,201392388,1145490690,21183,47873,2024-10-04 19:41:24,0,0,0,0,0,0
3,201392388,2170660915,0,0,2024-10-04 19:41:24,128,84,212,1,1,2
3,201392388,2170660915,58003,36895,2024-10-04 19:41:24,0,0,0,0,0,0
3,201392388,1145490690,21183,47873,2024-10-04 19:41:25,0,0,0,0,0,0
3,201392388,2170660915,0,0,2024-10-04 19:41:25,128,84,212,1,1,2
3,201392388,2170660915,58003,36895,2024-10-04 19:41:25,0,0,0,0,0,0
3,201392388,1145490690,21183,47873,2024-10-04 19:41:26,0,0,0,0,0,0
3,201392388,2170660915,0,0,2024-10-04 19:41:26,128,84,212,1,1,2
3,201392388,2170660915,58003,36895,2024-10-04 19:41:26,0,0,0,0,0,0
3,201392388,1145490690,21183,47873,2024-10-04 19:41:27,0,0,0,0,0,0
3,201392388,2170660915,0,0,2024-10-04 19:41:27,128,84,212,1,1,2
3,201392388,2170660915,58003,36895,2024-10-04 19:41:27,0,0,0,0,0,0
3,201392388,1145490690,21183,47873,2024-10-04 19:41:28,0,0,0,0,0,0
3,201392388,2170660915,0,0,2024-10-04 19:41:28,128,84,212,1,1,2
3,201392388,2170660915,58003,36895,2024-10-04 19:41:28,0,0,0,0,0,0
3,201392388,1145490690,21183,47873,2024-10-04 19:41:29,0,0,0,0,0,0
3,201392388,2170660915,0,0,2024-10-04 19:41:29,0,0,0,0,0,0
3,201392388,2170660915,58003,36895,2024-10-04 19:41:29,0,0,0,0,0,0
3,201392388,1145490690,21183,47873,2024-10-04 19:41:30,0,0,0,0,0,0
3,201392388,2170660915,0,0,2024-10-04 19:41:30,128,84,212,1,1,2
3,201392388,2170660915,58003,36895,2024-10-04 19:41:30,0,0,0,0,0,0
3,201392388,1145490690,21183,47873,2024-10-04 19:41:31,0,0,0,0,0,0
3,201392388,2170660915,0,0,2024-10-04 19:41:31,128,84,212,1,1,2
3,201392388,2170660915,58003,36895,2024-10-04 19:41:31,0,0,0,0,0,0
3,201392388,1145490690,21183,47873,2024-10-04 19:41:32,0,0,0,0,0,0
3,201392388,2170660915,0,0,2024-10-04 19:41:32,128,84,212,1,1,2
3,201392388,2170660915,58003,36895,2024-10-04 19:41:32,0,0,0,0,0,0
3,201392388,1145490690,21183,47873,2024-10-04 19:41:33,0,0,0,0,0,0
3,201392388,2170660915,0,0,2024-10-04 19:41:33,128,84,212,1,1,2
3,201392388,2170660915,58003,36895,2024-10-04 19:41:33,0,0,0,0,0,0
3,201392388,2170660915,22191,36895,2024-10-04 19:41:34,666,507,1173,6,6,12
3,201392388,2170660915,0,0,2024-10-04 19:41:34,0,0,0,0,0,0
3,201392388,2170660915,58003,36895,2024-10-04 19:41:34,0,0,0,0,0,0
3,201392388,2170660915,22191,36895,2024-10-04 19:41:35,0,0,0,0,0,0
3,201392388,2170660915,0,0,2024-10-04 19:41:35,128,84,212,1,1,2
3,201392388,2170660915,58003,36895,2024-10-04 19:41:35,0,0,0,0,0,0
3,201392388,2170660915,22191,36895,2024-10-04 19:41:36,0,0,0,0,0,0
3,201392388,2170660915,0,0,2024-10-04 19:41:36,128,84,212,1,1,2
3,201392388,2170660915,58003,36895,2024-10-04 19:41:36,0,0,0,0,0,0
3,201392388,2170660915,22191,36895,2024-10-04 19:41:37,0,0,0,0,0,0
3,201392388,2170660915,0,0,2024-10-04 19:41:37,128,84,212,1,1,2
3,201392388,2170660915,58003,36895,2024-10-04 19:41:37,0,0,0,0,0,0
3,201392388,2170660915,22191,36895,2024-10-04 19:41:38,0,0,0,0,0,0
3,201392388,2170660915,0,0,2024-10-04 19:41:38,0,0,0,0,0,0
3,201392388,2170660915,58003,36895,2024-10-04 19:41:38,0,0,0,0,0,0
3,201392388,2170660915,22191,36895,2024-10-04 19:41:39,0,0,0,0,0,0
3,201392388,2170660915,0,0,2024-10-04 19:41:39,0,0,0,0,0,0
3,201392388,2170660915,58003,36895,2024-10-04 19:41:39,0,0,0,0,0,0
3,201392388,2170660915,22191,36895,2024-10-04 19:41:40,0,0,0,0,0,0
3,201392388,2170660915,0,0,2024-10-04 19:41:40,128,0,128,1,0,1
3,201392388,2170660915,58003,36895,2024-10-04 19:41:40,0,0,0,0,0,0
3,201392388,2170660915,22191,36895,2024-10-04 19:41:41,0,0,0,0,0,0
3,201392388,2170660915,0,0,2024-10-04 19:41:41,128,84,212,1,1,2
3,201392388,2170660915,58003,36895,2024-10-04 19:41:41,0,0,0,0,0,0
3,201392388,2170660915,22191,36895,2024-10-04 19:41:42,0,0,0,0,0,0
3,201392388,2170660915,0,0,2024-10-04 19:41:42,128,84,212,1,1,2
3,201392388,2170660915,58003,36895,2024-10-04 19:41:42,0,0,0,0,0,0
3,201392388,1145490692,11486,47873,2024-10-04 19:41:43,4900,78233,83133,39,60,99
3,201392388,2170660915,22191,36895,2024-10-04 19:41:43,0,0,0,0,0,0
3,201392388,2170660915,0,0,2024-10-04 19:41:43,0,84,84,0,1,1
3,201392388,2170660915,58003,36895,2024-10-04 19:41:43,0,0,0,0,0,0
3,201392388,1145490692,11486,47873,2024-10-04 19:41:44,1536,25137,26673,15,20,35
3,201392388,2170660915,22191,36895,2024-10-04 19:41:44,0,0,0,0,0,0
3,201392388,2170660915,0,0,2024-10-04 19:41:44,0,0,0,0,0,0
3,201392388,2170660915,58003,36895,2024-10-04 19:41:44,0,0,0,0,0,0
3,201392388,1145490692,11486,47873,2024-10-04 19:41:45,0,0,0,0,0,0
3,201392388,2170660915,22191,36895,2024-10-04 19:41:45,0,0,0,0,0,0
3,201392388,2170660915,0,0,2024-10-04 19:41:45,0,0,0,0,0,0
3,201392388,2170660915,58003,36895,2024-10-04 19:41:45,0,0,0,0,0,0
3,201392388,1145490692,11486,47873,2024-10-04 19:41:46,0,0,0,0,0,0
3,201392388,2170660915,22191,36895,2024-10-04 19:41:46,0,0,0,0,0,0
3,201392388,2170660915,0,0,2024-10-04 19:41:46,0,0,0,0,0,0
3,201392388,2170660915,58003,36895,2024-10-04 19:41:46,0,0,0,0,0,0
3,201392388,1145490692,11486,47873,2024-10-04 19:41:47,0,0,0,0,0,0
3,201392388,2170660915,22191,36895,2024-10-04 19:41:47,0,0,0,0,0,0
3,201392388,2170660915,0,0,2024-10-04 19:41:47,0,0,0,0,0,0
3,201392388,2170660915,58003,36895,2024-10-04 19:41:47,0,0,0,0,0,0
3,201392388,1145490692,11486,47873,2024-10-04 19:41:48,0,0,0,0,0,0
3,201392388,2170660915,22191,36895,2024-10-04 19:41:48,0,0,0,0,0,0
3,201392388,2170660915,0,0,2024-10-04 19:41:48,0,0,0,0,0,0
3,201392388,2170660915,58003,36895,2024-10-04 19:41:48,0,0,0,0,0,0
3,201392388,1145490692,11486,47873,2024-10-04 19:41:49,0,0,0,0,0,0
3,201392388,2170660915,22191,36895,2024-10-04 19:41:49,0,0,0,0,0,0
3,201392388,2170660915,0,0,2024-10-04 19:41:49,0,0,0,0,0,0
3,201392388,2170660915,58003,36895,2024-10-04 19:41:49,0,0,0,0,0,0
3,201392388,1145490692,11486,47873,2024-10-04 19:41:50,0,0,0,0,0,0
3,201392388,2170660915,22191,36895,2024-10-04 19:41:50,0,0,0,0,0,0
3,201392388,2170660915,0,0,2024-10-04 19:41:50,0,0,0,0,0,0
3,201392388,2170660915,58003,36895,2024-10-04 19:41:50,0,0,0,0,0,0
3,201392388,1145490692,11486,47873,2024-10-04 19:41:51,0,0,0,0,0,0
3,201392388,2170660915,22191,36895,2024-10-04 19:41:51,0,0,0,0,0,0
3,201392388,2170660915,0,0,2024-10-04 19:41:51,0,0,0,0,0,0
3,201392388,2170660915,58003,36895,2024-10-04 19:41:51,0,0,0,0,0,0
3,201392388,1145490692,11486,47873,2024-10-04 19:41:52,0,0,0,0,0,0
3,201392388,2170660915,22191,36895,2024-10-04 19:41:52,0,0,0,0,0,0
3,201392388,2170660915,0,0,2024-10-04 19:41:52,0,0,0,0,0,0
3,201392388,2170660915,58003,36895,2024-10-04 19:41:52,0,0,0,0,0,0
3,201392388,1145490692,11486,47873,2024-10-04 19:41:53,0,0,0,0,0,0
3,201392388,2170660915,22191,36895,2024-10-04 19:41:53,0,0,0,0,0,0
3,201392388,2170660915,0,0,2024-10-04 19:41:53,128,0,128,1,0,1
3,201392388,2170660915,58003,36895,2024-10-04 19:41:53,0,0,0,0,0,0
3,201392388,1145490692,11486,47873,2024-10-04 19:41:54,0,0,0,0,0,0
3,201392388,2170660915,22191,36895,2024-10-04 19:41:54,0,0,0,0,0,0
3,201392388,2170660915,0,0,2024-10-04 19:41:54,128,84,212,1,1,2
3,201392388,2170660915,58003,36895,2024-10-04 19:41:54,0,0,0,0,0,0
3,201392388,1145490692,11486,47873,2024-10-04 19:41:55,0,0,0,0,0,0
3,201392388,2170660915,22191,36895,2024-10-04 19:41:55,0,0,0,0,0,0
3,201392388,2170660915,0,0,2024-10-04 19:41:55,128,84,212,1,1,2
3,201392388,2170660915,58003,36895,2024-10-04 19:41:55,0,0,0,0,0,0
3,201392388,1145490692,11486,47873,2024-10-04 19:41:56,0,0,0,0,0,0
3,201392388,2170660915,22191,36895,2024-10-04 19:41:56,0,0,0,0,0,0
3,201392388,2170660915,0,0,2024-10-04 19:41:56,0,84,84,0,1,1
3,201392388,2170660915,58003,36895,2024-10-04 19:41:56,0,0,0,0,0,0
3,201392388,1145490692,11486,47873,2024-10-04 19:41:57,0,0,0,0,0,0
3,201392388,2170660915,22191,36895,2024-10-04 19:41:57,0,0,0,0,0,0
3,201392388,2170660915,0,0,2024-10-04 19:41:57,128,84,212,1,1,2
3,201392388,2170660915,58003,36895,2024-10-04 19:41:57,0,0,0,0,0,0
3,201392388,1145490692,11486,47873,2024-10-04 19:41:58,0,0,0,0,0,0
3,201392388,2170660915,22191,36895,2024-10-04 19:41:58,0,0,0,0,0,0
3,201392388,2170660915,0,0,2024-10-04 19:41:58,128,84,212,1,1,2
3,201392388,2170660915,58003,36895,2024-10-04 19:41:58,0,0,0,0,0,0
3,201392388,1145490692,11486,47873,2024-10-04 19:41:59,0,0,0,0,0,0
3,201392388,2170660915,22191,36895,2024-10-04 19:41:59,0,0,0,0,0,0
3,201392388,2170660915,0,0,2024-10-04 19:41:59,128,84,212,1,1,2
3,201392388,2170660915,58003,36895,2024-10-04 19:41:59,0,0,0,0,0,0
3,201392388,1145490692,11486,47873,2024-10-04 19:42:00,0,0,0,0,0,0
3,201392388,2170660915,22191,36895,2024-10-04 19:42:00,0,0,0,0,0,0
3,201392388,2170660915,0,0,2024-10-04 19:42:00,128,84,212,1,1,2
3,201392388,2170660915,58003,36895,2024-10-04 19:42:00,0,0,0,0,0,0
3,201392388,1145490692,11486,47873,2024-10-04 19:42:01,0,0,0,0,0,0
3,201392388,2170660915,22191,36895,2024-10-04 19:42:01,0,0,0,0,0,0
3,201392388,2170660915,0,0,2024-10-04 19:42:01,128,84,212,1,1,2
3,201392388,2170660915,58003,36895,2024-10-04 19:42:01,0,0,0,0,0,0
3,201392388,1145490692,11486,47873,2024-10-04 19:42:02,0,0,0,0,0,0
3,201392388,2170660915,22191,36895,2024-10-04 19:42:02,0,0,0,0,0,0
3,201392388,2170660915,0,0,2024-10-04 19:42:02,128,84,212,1,1,2
3,201392388,2170660915,58003,36895,2024-10-04 19:42:02,0,0,0,0,0,0
3,201392388,1145490692,11486,47873,2024-10-04 19:42:03,0,0,0,0,0,0
3,201392388,2170660915,22191,36895,2024-10-04 19:42:03,0,0,0,0,0,0
3,201392388,2170660915,0,0,2024-10-04 19:42:03,128,84,212,1,1,2
3,201392388,2170660915,58003,36895,2024-10-04 19:42:03,0,0,0,0,0,0
3,201392388,1145490692,11486,47873,2024-10-04 19:42:04,0,0,0,0,0,0
3,201392388,2170660915,60652,36895,2024-10-04 19:42:04,666,507,1173,6,6,12
3,201392388,2170660915,22191,36895,2024-10-04 19:42:04,0,0,0,0,0,0
3,201392388,2170660915,0,0,2024-10-04 19:42:04,0,0,0,0,0,0
3,201392388,2170660915,58003,36895,2024-10-04 19:42:04,0,0,0,0,0,0
3,201392388,2170660915,60652,36895,2024-10-04 19:42:05,0,0,0,0,0,0
3,201392388,2170660915,22191,36895,2024-10-04 19:42:05,0,0,0,0,0,0
3,201392388,2170660915,0,0,2024-10-04 19:42:05,128,84,212,1,1,2
3,201392388,2170660915,58003,36895,2024-10-04 19:42:05,0,0,0,0,0,0
3,201392388,2170660915,60652,36895,2024-10-04 19:42:06,0,0,0,0,0,0
3,201392388,2170660915,22191,36895,2024-10-04 19:42:06,0,0,0,0,0,0
3,201392388,2170660915,0,0,2024-10-04 19:42:06,128,84,212,1,1,2
3,201392388,2170660915,58003,36895,2024-10-04 19:42:06,0,0,0,0,0,0
3,201392388,2170660915,22191,36895,2024-10-04 19:42:07,0,0,0,0,0,0
3,201392388,2170660915,0,0,2024-10-04 19:42:07,128,84,212,1,1,2
3,201392388,2170660915,58003,36895,2024-10-04 19:42:07,0,0,0,0,0,0
3,201392388,2170660915,22191,36895,2024-10-04 19:42:08,0,0,0,0,0,0
3,201392388,2170660915,0,0,2024-10-04 19:42:08,0,0,0,0,0,0
3,201392388,2170660915,58003,36895,2024-10-04 19:42:08,0,0,0,0,0,0
3,201392388,2170660915,22191,36895,2024-10-04 19:42:09,0,0,0,0,0,0
3,201392388,2170660915,0,0,2024-10-04 19:42:09,0,0,0,0,0,0
3,201392388,2170660915,58003,36895,2024-10-04 19:42:09,0,0,0,0,0,0
3,201392388,2170660915,22191,36895,2024-10-04 19:42:10,0,0,0,0,0,0
3,201392388,2170660915,0,0,2024-10-04 19:42:10,0,0,0,0,0,0
3,201392388,2170660915,58003,36895,2024-10-04 19:42:10,0,0,0,0,0,0
3,201392388,2170660915,22191,36895,2024-10-04 19:42:11,0,0,0,0,0,0
3,201392388,2170660915,0,0,2024-10-04 19:42:11,128,0,128,1,0,1
3,201392388,2170660915,58003,36895,2024-10-04 19:42:11,0,0,0,0,0,0
3,201392388,2170660915,22191,36895,2024-10-04 19:42:12,0,0,0,0,0,0
3,201392388,2170660915,0,0,2024-10-04 19:42:12,128,84,212,1,1,2
3,201392388,2170660915,58003,36895,2024-10-04 19:42:12,0,0,0,0,0,0
3,201392388,1145490691,35563,47873,2024-10-04 19:42:13,4056,55231,59287,32,45,77
3,201392388,2170660915,22191,36895,2024-10-04 19:42:13,0,0,0,0,0,0
3,201392388,2170660915,0,0,2024-10-04 19:42:13,128,168,296,1,2,3
3,201392388,2170660915,58003,36895,2024-10-04 19:42:13,0,0,0,0,0,0
3,201392388,1145490691,35563,47873,2024-10-04 19:42:14,2376,37865,40241,24,28,52
3,201392388,2170660915,22191,36895,2024-10-04 19:42:14,0,0,0,0,0,0
3,201392388,2170660915,0,0,2024-10-04 19:42:14,0,0,0,0,0,0
3,201392388,2170660915,58003,36895,2024-10-04 19:42:14,0,0,0,0,0,0
3,201392388,1145490691,35563,47873,2024-10-04 19:42:15,0,0,0,0,0,0
3,201392388,2170660915,22191,36895,2024-10-04 19:42:15,0,0,0,0,0,0
3,201392388,2170660915,0,0,2024-10-04 19:42:15,0,0,0,0,0,0
3,201392388,2170660915,58003,36895,2024-10-04 19:42:15,0,0,0,0,0,0
3,201392388,1145490691,35563,47873,2024-10-04 19:42:16,0,0,0,0,0,0
3,201392388,2170660915,22191,36895,2024-10-04 19:42:16,0,0,0,0,0,0
3,201392388,2170660915,0,0,2024-10-04 19:42:16,0,0,0,0,0,0
3,201392388,2170660915,58003,36895,2024-10-04 19:42:16,0,0,0,0,0,0
3,201392388,1145490691,35563,47873,2024-10-04 19:42:17,0,0,0,0,0,0
3,201392388,2170660915,22191,36895,2024-10-04 19:42:17,0,0,0,0,0,0
3,201392388,2170660915,0,0,2024-10-04 19:42:17,0,0,0,0,0,0
3,201392388,2170660915,58003,36895,2024-10-04 19:42:17,0,0,0,0,0,0
3,201392388,1145490691,35563,47873,2024-10-04 19:42:18,0,0,0,0,0,0
3,201392388,2170660915,22191,36895,2024-10-04 19:42:18,0,0,0,0,0,0
3,201392388,2170660915,0,0,2024-10-04 19:42:18,0,0,0,0,0,0
3,201392388,2170660915,58003,36895,2024-10-04 19:42:18,0,0,0,0,0,0
3,201392388,1145490691,35563,47873,2024-10-04 19:42:19,0,0,0,0,0,0
3,201392388,2170660915,22191,36895,2024-10-04 19:42:19,0,0,0,0,0,0
3,201392388,2170660915,0,0,2024-10-04 19:42:19,0,0,0,0,0,0
3,201392388,2170660915,58003,36895,2024-10-04 19:42:19,0,0,0,0,0,0
3,201392388,1145490691,35563,47873,2024-10-04 19:42:20,0,0,0,0,0,0
3,201392388,2170660915,22191,36895,2024-10-04 19:42:20,0,0,0,0,0,0
3,201392388,2170660915,0,0,2024-10-04 19:42:20,0,0,0,0,0,0
3,201392388,2170660915,58003,36895,2024-10-04 19:42:20,0,0,0,0,0,0
3,201392388,1145490691,35563,47873,2024-10-04 19:42:21,0,0,0,0,0,0
3,201392388,2170660915,22191,36895,2024-10-04 19:42:21,0,0,0,0,0,0
3,201392388,2170660915,0,0,2024-10-04 19:42:21,0,0,0,0,0,0
3,201392388,2170660915,58003,36895,2024-10-04 19:42:21,0,0,0,0,0,0
3,201392388,1145490691,35563,47873,2024-10-04 19:42:22,0,0,0,0,0,0
3,201392388,2170660915,22191,36895,2024-10-04 19:42:22,0,0,0,0,0,0
3,201392388,2170660915,0,0,2024-10-04 19:42:22,0,0,0,0,0,0
3,201392388,2170660915,58003,36895,2024-10-04 19:42:22,0,0,0,0,0,0
3,201392388,1145490691,35563,47873,2024-10-04 19:42:23,0,0,0,0,0,0
3,201392388,2170660915,22191,36895,2024-10-04 19:42:23,0,0,0,0,0,0
3,201392388,2170660915,0,0,2024-10-04 19:42:23,0,0,0,0,0,0
3,201392388,2170660915,58003,36895,2024-10-04 19:42:23,0,0,0,0,0,0
3,201392388,1145490691,35563,47873,2024-10-04 19:42:24,0,0,0,0,0,0
3,201392388,2170660915,22191,36895,2024-10-04 19:42:24,0,0,0,0,0,0
3,201392388,2170660915,0,0,2024-10-04 19:42:24,128,0,128,1,0,1
3,201392388,2170660915,58003,36895,2024-10-04 19:42:24,0,0,0,0,0,0
3,201392388,1145490691,35563,47873,2024-10-04 19:42:25,0,0,0,0,0,0
3,201392388,2170660915,22191,36895,2024-10-04 19:42:25,0,0,0,0,0,0
3,201392388,2170660915,0,0,2024-10-04 19:42:25,128,168,296,1,2,3
3,201392388,2170660915,58003,36895,2024-10-04 19:42:25,0,0,0,0,0,0
3,201392388,1145490691,35563,47873,2024-10-04 19:42:26,0,0,0,0,0,0
3,201392388,2170660915,22191,36895,2024-10-04 19:42:26,0,0,0,0,0,0
3,201392388,2170660915,0,0,2024-10-04 19:42:26,128,84,212,1,1,2
3,201392388,2170660915,58003,36895,2024-10-04 19:42:26,0,0,0,0,0,0
3,201392388,1145490691,35563,47873,2024-10-04 19:42:27,0,0,0,0,0,0
3,201392388,2170660915,22191,36895,2024-10-04 19:42:27,0,0,0,0,0,0
3,201392388,2170660915,0,0,2024-10-04 19:42:27,128,84,212,1,1,2
3,201392388,2170660915,58003,36895,2024-10-04 19:42:27,0,0,0,0,0,0
3,201392388,1145490691,35563,47873,2024-10-04 19:42:28,0,0,0,0,0,0
3,201392388,2170660915,22191,36895,2024-10-04 19:42:28,0,0,0,0,0,0
3,201392388,2170660915,0,0,2024-10-04 19:42:28,128,84,212,1,1,2
3,201392388,2170660915,58003,36895,2024-10-04 19:42:28,0,0,0,0,0,0
3,201392388,1145490691,35563,47873,2024-10-04 19:42:29,0,0,0,0,0,0
3,201392388,2170660915,22191,36895,2024-10-04 19:42:29,0,0,0,0,0,0
3,201392388,2170660915,0,0,2024-10-04 19:42:29,128,84,212,1,1,2
3,201392388,2170660915,58003,36895,2024-10-04 19:42:29,0,0,0,0,0,0
3,201392388,1145490691,35563,47873,2024-10-04 19:42:30,0,0,0,0,0,0
3,201392388,2170660915,22191,36895,2024-10-04 19:42:30,0,0,0,0,0,0
3,201392388,2170660915,0,0,2024-10-04 19:42:30,128,84,212,1,1,2
3,201392388,2170660915,58003,36895,2024-10-04 19:42:30,0,0,0,0,0,0
3,201392388,1145490691,35563,47873,2024-10-04 19:42:31,0,0,0,0,0,0
3,201392388,2170660915,22191,36895,2024-10-04 19:42:31,0,0,0,0,0,0
3,201392388,2170660915,0,0,2024-10-04 19:42:31,128,84,212,1,1,2
3,201392388,2170660915,58003,36895,2024-10-04 19:42:31,0,0,0,0,0,0
3,201392388,1145490691,35563,47873,2024-10-04 19:42:32,0,0,0,0,0,0
3,201392388,2170660915,22191,36895,2024-10-04 19:42:32,0,0,0,0,0,0
3,201392388,2170660915,0,0,2024-10-04 19:42:32,128,84,212,1,1,2
3,201392388,2170660915,58003,36895,2024-10-04 19:42:32,0,0,0,0,0,0
3,201392388,1145490691,35563,47873,2024-10-04 19:42:33,0,0,0,0,0,0
3,201392388,2170660915,22191,36895,2024-10-04 19:42:33,0,0,0,0,0,0
3,201392388,2170660915,0,0,2024-10-04 19:42:33,128,84,212,1,1,2
3,201392388,2170660915,58003,36895,2024-10-04 19:42:33,0,0,0,0,0,0
3,201392388,1145490691,35563,47873,2024-10-04 19:42:34,0,0,0,0,0,0
3,201392388,2170660915,22191,36895,2024-10-04 19:42:34,0,0,0,0,0,0
3,201392388,2170660915,0,0,2024-10-04 19:42:34,0,0,0,0,0,0
3,201392388,2170660915,58003,36895,2024-10-04 19:42:34,0,0,0,0,0,0
3,201392388,1145490691,35563,47873,2024-10-04 19:42:35,0,0,0,0,0,0
3,201392388,2170660915,47340,36895,2024-10-04 19:42:35,666,507,1173,6,6,12
3,201392388,2170660915,22191,36895,2024-10-04 19:42:35,0,0,0,0,0,0
3,201392388,2170660915,0,0,2024-10-04 19:42:35,0,0,0,0,0,0
3,201392388,2170660915,58003,36895,2024-10-04 19:42:35,0,0,0,0,0,0
3,201392388,2170660915,47340,36895,2024-10-04 19:42:36,0,0,0,0,0,0
3,201392388,2170660915,22191,36895,2024-10-04 19:42:36,0,0,0,0,0,0
3,201392388,2170660915,0,0,2024-10-04 19:42:36,128,84,212,1,1,2
3,201392388,2170660915,58003,36895,2024-10-04 19:42:36,0,0,0,0,0,0
3,201392388,2170660915,47340,36895,2024-10-04 19:42:37,0,0,0,0,0,0
3,201392388,2170660915,0,0,2024-10-04 19:42:37,128,84,212,1,1,2
3,201392388,2170660915,58003,36895,2024-10-04 19:42:37,0,0,0,0,0,0
3,201392388,2170660915,47340,36895,2024-10-04 19:42:38,0,0,0,0,0,0
3,201392388,2170660915,0,0,2024-10-04 19:42:38,128,84,212,1,1,2
3,201392388,2170660915,58003,36895,2024-10-04 19:42:38,0,0,0,0,0,0
3,201392388,2170660915,47340,36895,2024-10-04 19:42:39,0,0,0,0,0,0
3,201392388,2170660915,0,0,2024-10-04 19:42:39,0,0,0,0,0,0
3,201392388,2170660915,58003,36895,2024-10-04 19:42:39,0,0,0,0,0,0
3,201392388,2170660915,47340,36895,2024-10-04 19:42:40,0,0,0,0,0,0
3,201392388,2170660915,0,0,2024-10-04 19:42:40,0,0,0,0,0,0
3,201392388,2170660915,58003,36895,2024-10-04 19:42:40,0,0,0,0,0,0
3,201392388,2170660915,47340,36895,2024-10-04 19:42:41,0,0,0,0,0,0
3,201392388,2170660915,0,0,2024-10-04 19:42:41,128,0,128,1,0,1
3,201392388,2170660915,58003,36895,2024-10-04 19:42:41,0,0,0,0,0,0
3,201392388,2170660915,47340,36895,2024-10-04 19:42:42,0,0,0,0,0,0
3,201392388,2170660915,0,0,2024-10-04 19:42:42,128,84,212,1,1,2
3,201392388,2170660915,58003,36895,2024-10-04 19:42:42,0,0,0,0,0,0
3,201392388,2170660915,47340,36895,2024-10-04 19:42:43,0,0,0,0,0,0
3,201392388,2170660915,0,0,2024-10-04 19:42:43,128,168,296,1,2,3
3,201392388,1145490690,22250,47873,2024-10-04 19:42:43,1029,5429,6458,5,6,11
3,201392388,2170660915,58003,36895,2024-10-04 19:42:43,0,0,0,0,0,0
3,201392388,2170660915,47340,36895,2024-10-04 19:42:44,0,0,0,0,0,0
3,201392388,2170660915,0,0,2024-10-04 19:42:44,0,0,0,0,0,0
3,201392388,1145490690,22250,47873,2024-10-04 19:42:44,2427,37636,40063,21,30,51
3,201392388,2170660915,58003,36895,2024-10-04 19:42:44,0,0,0,0,0,0
3,201392388,2170660915,47340,36895,2024-10-04 19:42:45,0,0,0,0,0,0
3,201392388,2170660915,0,0,2024-10-04 19:42:45,0,0,0,0,0,0
3,201392388,1145490690,22250,47873,2024-10-04 19:42:45,2832,50083,52915,29,38,67
3,201392388,2170660915,58003,36895,2024-10-04 19:42:45,0,0,0,0,0,0
3,201392388,2170660915,47340,36895,2024-10-04 19:42:46,0,0,0,0,0,0
3,201392388,2170660915,0,0,2024-10-04 19:42:46,0,0,0,0,0,0
3,201392388,1145490690,22250,47873,2024-10-04 19:42:46,0,0,0,0,0,0
3,201392388,2170660915,58003,36895,2024-10-04 19:42:46,0,0,0,0,0,0
3,201392388,2170660915,47340,36895,2024-10-04 19:42:47,0,0,0,0,0,0
3,201392388,2170660915,0,0,2024-10-04 19:42:47,0,0,0,0,0,0
3,201392388,1145490690,22250,47873,2024-10-04 19:42:47,0,0,0,0,0,0
3,201392388,2170660915,58003,36895,2024-10-04 19:42:47,0,0,0,0,0,0
3,201392388,2170660915,47340,36895,2024-10-04 19:42:48,0,0,0,0,0,0
3,201392388,2170660915,0,0,2024-10-04 19:42:48,0,0,0,0,0,0
3,201392388,1145490690,22250,47873,2024-10-04 19:42:48,0,0,0,0,0,0
3,201392388,2170660915,58003,36895,2024-10-04 19:42:48,0,0,0,0,0,0
3,201392388,2170660915,47340,36895,2024-10-04 19:42:49,0,0,0,0,0,0
3,201392388,2170660915,0,0,2024-10-04 19:42:49,0,0,0,0,0,0
3,201392388,1145490690,22250,47873,2024-10-04 19:42:49,0,0,0,0,0,0
3,201392388,2170660915,58003,36895,2024-10-04 19:42:49,0,0,0,0,0,0
3,201392388,2170660915,47340,36895,2024-10-04 19:42:50,0,0,0,0,0,0
3,201392388,2170660915,0,0,2024-10-04 19:42:50,0,0,0,0,0,0
3,201392388,1145490690,22250,47873,2024-10-04 19:42:50,0,0,0,0,0,0
3,201392388,2170660915,58003,36895,2024-10-04 19:42:50,0,0,0,0,0,0
3,201392388,2170660915,47340,36895,2024-10-04 19:42:51,0,0,0,0,0,0
3,201392388,2170660915,0,0,2024-10-04 19:42:51,0,0,0,0,0,0
3,201392388,1145490690,22250,47873,2024-10-04 19:42:51,0,0,0,0,0,0
3,201392388,2170660915,58003,36895,2024-10-04 19:42:51,0,0,0,0,0,0
3,201392388,2170660915,47340,36895,2024-10-04 19:42:52,0,0,0,0,0,0
3,201392388,2170660915,0,0,2024-10-04 19:42:52,0,0,0,0,0,0
3,201392388,1145490690,22250,47873,2024-10-04 19:42:52,0,0,0,0,0,0
3,201392388,2170660915,58003,36895,2024-10-04 19:42:52,0,0,0,0,0,0
3,201392388,2170660915,47340,36895,2024-10-04 19:42:53,0,0,0,0,0,0
3,201392388,2170660915,0,0,2024-10-04 19:42:53,0,0,0,0,0,0
3,201392388,1145490690,22250,47873,2024-10-04 19:42:53,0,0,0,0,0,0
3,201392388,2170660915,58003,36895,2024-10-04 19:42:53,0,0,0,0,0,0
3,201392388,2170660915,47340,36895,2024-10-04 19:42:54,0,0,0,0,0,0
3,201392388,2170660915,0,0,2024-10-04 19:42:54,128,0,128,1,0,1
3,201392388,1145490690,22250,47873,2024-10-04 19:42:54,0,0,0,0,0,0
3,201392388,2170660915,58003,36895,2024-10-04 19:42:54,0,0,0,0,0,0
3,201392388,2170660915,47340,36895,2024-10-04 19:42:55,0,0,0,0,0,0
3,201392388,2170660915,0,0,2024-10-04 19:42:55,128,84,212,1,1,2
3,201392388,1145490690,22250,47873,2024-10-04 19:42:55,0,0,0,0,0,0
3,201392388,2170660915,58003,36895,2024-10-04 19:42:55,0,0,0,0,0,0
3,201392388,2170660915,47340,36895,2024-10-04 19:42:56,0,0,0,0,0,0
3,201392388,2170660915,0,0,2024-10-04 19:42:56,128,84,212,1,1,2
3,201392388,1145490690,22250,47873,2024-10-04 19:42:56,0,0,0,0,0,0
3,201392388,2170660915,58003,36895,2024-10-04 19:42:56,0,0,0,0,0,0
3,201392388,2170660915,47340,36895,2024-10-04 19:42:57,0,0,0,0,0,0
3,201392388,2170660915,0,0,2024-10-04 19:42:57,0,84,84,0,1,1
3,201392388,1145490690,22250,47873,2024-10-04 19:42:57,0,0,0,0,0,0
3,201392388,2170660915,58003,36895,2024-10-04 19:42:57,0,0,0,0,0,0
3,201392388,2170660915,47340,36895,2024-10-04 19:42:58,0,0,0,0,0,0
3,201392388,2170660915,0,0,2024-10-04 19:42:58,128,84,212,1,1,2
3,201392388,1145490690,22250,47873,2024-10-04 19:42:58,0,0,0,0,0,0
3,201392388,2170660915,58003,36895,2024-10-04 19:42:58,0,0,0,0,0,0
3,201392388,2170660915,47340,36895,2024-10-04 19:42:59,0,0,0,0,0,0
3,201392388,2170660915,0,0,2024-10-04 19:42:59,128,84,212,1,1,2
3,201392388,1145490690,22250,47873,2024-10-04 19:42:59,0,0,0,0,0,0
3,201392388,2170660915,58003,36895,2024-10-04 19:42:59,0,0,0,0,0,0
3,201392388,2170660915,47340,36895,2024-10-04 19:43:00,0,0,0,0,0,0
3,201392388,2170660915,0,0,2024-10-04 19:43:00,128,84,212,1,1,2
3,201392388,1145490690,22250,47873,2024-10-04 19:43:00,0,0,0,0,0,0
3,201392388,2170660915,58003,36895,2024-10-04 19:43:00,0,0,0,0,0,0
3,201392388,2170660915,47340,36895,2024-10-04 19:43:01,0,0,0,0,0,0
3,201392388,2170660915,0,0,2024-10-04 19:43:01,128,84,212,1,1,2
3,201392388,1145490690,22250,47873,2024-10-04 19:43:01,0,0,0,0,0,0
3,201392388,2170660915,58003,36895,2024-10-04 19:43:01,0,0,0,0,0,0
3,201392388,2170660915,47340,36895,2024-10-04 19:43:02,0,0,0,0,0,0
3,201392388,2170660915,0,0,2024-10-04 19:43:02,128,84,212,1,1,2
3,201392388,1145490690,22250,47873,2024-10-04 19:43:02,0,0,0,0,0,0
3,201392388,2170660915,58003,36895,2024-10-04 19:43:02,0,0,0,0,0,0
3,201392388,2170660915,47340,36895,2024-10-04 19:43:03,0,0,0,0,0,0
3,201392388,2170660915,0,0,2024-10-04 19:43:03,128,84,212,1,1,2
3,201392388,1145490690,22250,47873,2024-10-04 19:43:03,0,0,0,0,0,0
3,201392388,2170660915,58003,36895,2024-10-04 19:43:03,0,0,0,0,0,0
3,201392388,2170660915,47340,36895,2024-10-04 19:43:04,0,0,0,0,0,0
3,201392388,2170660915,0,0,2024-10-04 19:43:04,128,84,212,1,1,2
3,201392388,1145490690,22250,47873,2024-10-04 19:43:04,0,0,0,0,0,0
3,201392388,2170660915,58003,36895,2024-10-04 19:43:04,0,0,0,0,0,0
3,201392388,2170660915,47340,36895,2024-10-04 19:43:05,0,0,0,0,0,0
3,201392388,2170660915,0,0,2024-10-04 19:43:05,0,0,0,0,0,0
3,201392388,1145490690,22250,47873,2024-10-04 19:43:05,0,0,0,0,0,0
3,201392388,2170660915,58003,36895,2024-10-04 19:43:05,0,0,0,0,0,0
3,201392388,2170660915,49794,36895,2024-10-04 19:43:06,666,507,1173,6,6,12
3,201392388,2170660915,47340,36895,2024-10-04 19:43:06,0,0,0,0,0,0
3,201392388,2170660915,0,0,2024-10-04 19:43:06,0,0,0,0,0,0
3,201392388,1145490690,22250,47873,2024-10-04 19:43:06,0,0,0,0,0,0
3,201392388,2170660915,58003,36895,2024-10-04 19:43:06,0,0,0,0,0,0
3,201392388,2170660915,49794,36895,2024-10-04 19:43:07,0,0,0,0,0,0
3,201392388,2170660915,47340,36895,2024-10-04 19:43:07,0,0,0,0,0,0
3,201392388,2170660915,0,0,2024-10-04 19:43:07,128,84,212,1,1,2
3,201392388,2170660915,58003,36895,2024-10-04 19:43:07,0,0,0,0,0,0
3,201392388,2170660915,49794,36895,2024-10-04 19:43:08,0,0,0,0,0,0
3,201392388,2170660915,47340,36895,2024-10-04 19:43:08,0,0,0,0,0,0
3,201392388,2170660915,0,0,2024-10-04 19:43:08,0,0,0,0,0,0
3,201392388,2170660915,58003,36895,2024-10-04 19:43:08,0,0,0,0,0,0
3,201392388,2170660915,49794,36895,2024-10-04 19:43:09,0,0,0,0,0,0
3,201392388,2170660915,0,0,2024-10-04 19:43:09,256,84,340,2,1,3
3,201392388,2170660915,58003,36895,2024-10-04 19:43:09,0,0,0,0,0,0
3,201392388,2170660915,49794,36895,2024-10-04 19:43:10,0,0,0,0,0,0
3,201392388,2170660915,0,0,2024-10-04 19:43:10,0,84,84,0,1,1
3,201392388,2170660915,58003,36895,2024-10-04 19:43:10,0,0,0,0,0,0
3,201392388,2170660915,49794,36895,2024-10-04 19:43:11,0,0,0,0,0,0
3,201392388,2170660915,0,0,2024-10-04 19:43:11,0,0,0,0,0,0
3,201392388,2170660915,58003,36895,2024-10-04 19:43:11,0,0,0,0,0,0
3,201392388,2170660915,49794,36895,2024-10-04 19:43:12,0,0,0,0,0,0
3,201392388,2170660915,0,0,2024-10-04 19:43:12,128,0,128,1,0,1
3,201392388,2170660915,58003,36895,2024-10-04 19:43:12,0,0,0,0,0,0
3,201392388,2170660915,49794,36895,2024-10-04 19:43:13,0,0,0,0,0,0
3,201392388,2170660915,0,0,2024-10-04 19:43:13,128,84,212,1,1,2
3,201392388,2170660915,58003,36895,2024-10-04 19:43:13,0,0,0,0,0,0
3,201392388,2170660915,49794,36895,2024-10-04 19:43:14,0,0,0,0,0,0
3,201392388,2170660915,0,0,2024-10-04 19:43:14,128,84,212,1,1,2
3,201392388,2170660915,58003,36895,2024-10-04 19:43:14,0,0,0,0,0,0
3,201392388,2170660915,49794,36895,2024-10-04 19:43:15,0,0,0,0,0,0
3,201392388,1145490689,24713,47873,2024-10-04 19:43:15,4644,80881,85525,36,61,97
3,201392388,2170660915,0,0,2024-10-04 19:43:15,0,84,84,0,1,1
3,201392388,2170660915,58003,36895,2024-10-04 19:43:15,0,0,0,0,0,0
3,201392388,2170660915,49794,36895,2024-10-04 19:43:16,0,0,0,0,0,0
3,201392388,1145490689,24713,47873,2024-10-04 19:43:16,0,0,0,0,0,0
3,201392388,2170660915,0,0,2024-10-04 19:43:16,0,0,0,0,0,0
3,201392388,2170660915,58003,36895,2024-10-04 19:43:16,0,0,0,0,0,0
3,201392388,2170660915,49794,36895,2024-10-04 19:43:17,0,0,0,0,0,0
3,201392388,1145490689,24713,47873,2024-10-04 19:43:17,1920,24471,26391,19,19,38
3,201392388,2170660915,0,0,2024-10-04 19:43:17,0,0,0,0,0,0
3,201392388,2170660915,58003,36895,2024-10-04 19:43:17,0,0,0,0,0,0
3,201392388,2170660915,49794,36895,2024-10-04 19:43:18,0,0,0,0,0,0
3,201392388,1145490689,24713,47873,2024-10-04 19:43:18,0,0,0,0,0,0
3,201392388,2170660915,0,0,2024-10-04 19:43:18,0,0,0,0,0,0
3,201392388,2170660915,58003,36895,2024-10-04 19:43:18,0,0,0,0,0,0
3,201392388,2170660915,49794,36895,2024-10-04 19:43:19,0,0,0,0,0,0
3,201392388,1145490689,24713,47873,2024-10-04 19:43:19,0,0,0,0,0,0
3,201392388,2170660915,0,0,2024-10-04 19:43:19,0,0,0,0,0,0
3,201392388,2170660915,58003,36895,2024-10-04 19:43:19,0,0,0,0,0,0
3,201392388,2170660915,49794,36895,2024-10-04 19:43:20,0,0,0,0,0,0
3,201392388,1145490689,24713,47873,2024-10-04 19:43:20,0,0,0,0,0,0
3,201392388,2170660915,0,0,2024-10-04 19:43:20,0,0,0,0,0,0
3,201392388,2170660915,58003,36895,2024-10-04 19:43:20,0,0,0,0,0,0
3,201392388,2170660915,49794,36895,2024-10-04 19:43:21,0,0,0,0,0,0
3,201392388,1145490689,24713,47873,2024-10-04 19:43:21,0,0,0,0,0,0
3,201392388,2170660915,0,0,2024-10-04 19:43:21,0,0,0,0,0,0
3,201392388,2170660915,58003,36895,2024-10-04 19:43:21,0,0,0,0,0,0
3,201392388,2170660915,49794,36895,2024-10-04 19:43:22,0,0,0,0,0,0
3,201392388,1145490689,24713,47873,2024-10-04 19:43:22,0,0,0,0,0,0
3,201392388,2170660915,0,0,2024-10-04 19:43:22,0,0,0,0,0,0
3,201392388,2170660915,58003,36895,2024-10-04 19:43:22,0,0,0,0,0,0
3,201392388,2170660915,49794,36895,2024-10-04 19:43:23,0,0,0,0,0,0
3,201392388,1145490689,24713,47873,2024-10-04 19:43:23,0,0,0,0,0,0
3,201392388,2170660915,0,0,2024-10-04 19:43:23,0,0,0,0,0,0
3,201392388,2170660915,58003,36895,2024-10-04 19:43:23,0,0,0,0,0,0
3,201392388,2170660915,49794,36895,2024-10-04 19:43:24,0,0,0,0,0,0
3,201392388,1145490689,24713,47873,2024-10-04 19:43:24,0,0,0,0,0,0
3,201392388,2170660915,0,0,2024-10-04 19:43:24,0,0,0,0,0,0
3,201392388,2170660915,58003,36895,2024-10-04 19:43:24,0,0,0,0,0,0
3,201392388,2170660915,49794,36895,2024-10-04 19:43:25,0,0,0,0,0,0
3,201392388,1145490689,24713,47873,2024-10-04 19:43:25,0,0,0,0,0,0
3,201392388,2170660915,0,0,2024-10-04 19:43:25,128,0,128,1,0,1
3,201392388,2170660915,58003,36895,2024-10-04 19:43:25,0,0,0,0,0,0
3,201392388,2170660915,49794,36895,2024-10-04 19:43:26,0,0,0,0,0,0
3,201392388,1145490689,24713,47873,2024-10-04 19:43:26,0,0,0,0,0,0
3,201392388,2170660915,0,0,2024-10-04 19:43:26,128,84,212,1,1,2
3,201392388,2170660915,58003,36895,2024-10-04 19:43:26,0,0,0,0,0,0
3,201392388,2170660915,49794,36895,2024-10-04 19:43:27,0,0,0,0,0,0
3,201392388,1145490689,24713,47873,2024-10-04 19:43:27,0,0,0,0,0,0
3,201392388,2170660915,0,0,2024-10-04 19:43:27,128,84,212,1,1,2
3,201392388,2170660915,58003,36895,2024-10-04 19:43:27,0,0,0,0,0,0
3,201392388,2170660915,49794,36895,2024-10-04 19:43:28,0,0,0,0,0,0
3,201392388,1145490689,24713,47873,2024-10-04 19:43:28,0,0,0,0,0,0
3,201392388,2170660915,0,0,2024-10-04 19:43:28,0,84,84,0,1,1
3,201392388,2170660915,58003,36895,2024-10-04 19:43:28,0,0,0,0,0,0
3,201392388,2170660915,49794,36895,2024-10-04 19:43:29,0,0,0,0,0,0
3,201392388,1145490689,24713,47873,2024-10-04 19:43:29,0,0,0,0,0,0
3,201392388,2170660915,0,0,2024-10-04 19:43:29,128,84,212,1,1,2
3,201392388,2170660915,58003,36895,2024-10-04 19:43:29,0,0,0,0,0,0
3,201392388,2170660915,49794,36895,2024-10-04 19:43:30,0,0,0,0,0,0
3,201392388,1145490689,24713,47873,2024-10-04 19:43:30,0,0,0,0,0,0
3,201392388,2170660915,0,0,2024-10-04 19:43:30,128,84,212,1,1,2
3,201392388,2170660915,58003,36895,2024-10-04 19:43:30,0,0,0,0,0,0
3,201392388,2170660915,49794,36895,2024-10-04 19:43:31,0,0,0,0,0,0
3,201392388,1145490689,24713,47873,2024-10-04 19:43:31,0,0,0,0,0,0
3,201392388,2170660915,0,0,2024-10-04 19:43:31,128,84,212,1,1,2
3,201392388,2170660915,58003,36895,2024-10-04 19:43:31,0,0,0,0,0,0
3,201392388,2170660915,49794,36895,2024-10-04 19:43:32,0,0,0,0,0,0
3,201392388,1145490689,24713,47873,2024-10-04 19:43:32,0,0,0,0,0,0
3,201392388,2170660915,0,0,2024-10-04 19:43:32,128,84,212,1,1,2
3,201392388,2170660915,58003,36895,2024-10-04 19:43:32,0,0,0,0,0,0
3,201392388,2170660915,49794,36895,2024-10-04 19:43:33,0,0,0,0,0,0
3,201392388,1145490689,24713,47873,2024-10-04 19:43:33,0,0,0,0,0,0
3,201392388,2170660915,0,0,2024-10-04 19:43:33,128,84,212,1,1,2
3,201392388,2170660915,58003,36895,2024-10-04 19:43:33,0,0,0,0,0,0
3,201392388,2170660915,49794,36895,2024-10-04 19:43:34,0,0,0,0,0,0
3,201392388,1145490689,24713,47873,2024-10-04 19:43:34,0,0,0,0,0,0
3,201392388,2170660915,0,0,2024-10-04 19:43:34,128,84,212,1,1,2
3,201392388,2170660915,58003,36895,2024-10-04 19:43:34,0,0,0,0,0,0
3,201392388,2170660915,49794,36895,2024-10-04 19:43:35,0,0,0,0,0,0
3,201392388,1145490689,24713,47873,2024-10-04 19:43:35,0,0,0,0,0,0
3,201392388,2170660915,0,0,2024-10-04 19:43:35,128,84,212,1,1,2
3,201392388,2170660915,58003,36895,2024-10-04 19:43:35,0,0,0,0,0,0
3,201392388,2170660915,49794,36895,2024-10-04 19:43:36,0,0,0,0,0,0
3,201392388,1145490689,24713,47873,2024-10-04 19:43:36,0,0,0,0,0,0
3,201392388,2170660915,0,0,2024-10-04 19:43:36,0,0,0,0,0,0
3,201392388,2170660915,58003,36895,2024-10-04 19:43:36,0,0,0,0,0,0
3,201392388,2170660915,49794,36895,2024-10-04 19:43:37,0,0,0,0,0,0
3,201392388,1145490689,24713,47873,2024-10-04 19:43:37,0,0,0,0,0,0
3,201392388,2170660915,0,0,2024-10-04 19:43:37,0,0,0,0,0,0
3,201392388,2170660915,55982,36895,2024-10-04 19:43:37,570,455,1025,5,5,10
3,201392388,2170660915,58003,36895,2024-10-04 19:43:37,0,0,0,0,0,0
3,201392388,2170660915,49794,36895,2024-10-04 19:43:38,0,0,0,0,0,0
3,201392388,2170660915,0,0,2024-10-04 19:43:38,128,84,212,1,1,2
3,201392388,2170660915,55982,36895,2024-10-04 19:43:38,0,0,0,0,0,0
3,201392388,2170660915,58003,36895,2024-10-04 19:43:38,0,0,0,0,0,0
3,201392388,2170660915,0,0,2024-10-04 19:43:39,256,84,340,2,1,3
3,201392388,2170660915,55982,36895,2024-10-04 19:43:39,0,0,0,0,0,0
3,201392388,2170660915,58003,36895,2024-10-04 19:43:39,0,0,0,0,0,0
3,201392388,2170660915,0,0,2024-10-04 19:43:40,0,0,0,0,0,0
3,201392388,2170660915,55982,36895,2024-10-04 19:43:40,0,0,0,0,0,0
3,201392388,2170660915,58003,36895,2024-10-04 19:43:40,0,0,0,0,0,0
3,201392388,2170660915,0,0,2024-10-04 19:43:41,0,84,84,0,1,1
3,201392388,2170660915,55982,36895,2024-10-04 19:43:41,0,0,0,0,0,0
3,201392388,2170660915,58003,36895,2024-10-04 19:43:41,0,0,0,0,0,0
3,201392388,2170660915,0,0,2024-10-04 19:43:42,0,0,0,0,0,0
3,201392388,2170660915,55982,36895,2024-10-04 19:43:42,0,0,0,0,0,0
3,201392388,2170660915,58003,36895,2024-10-04 19:43:42,0,0,0,0,0,0
3,201392388,2170660915,0,0,2024-10-04 19:43:43,0,0,0,0,0,0
3,201392388,2170660915,55982,36895,2024-10-04 19:43:43,0,0,0,0,0,0
3,201392388,2170660915,58003,36895,2024-10-04 19:43:43,0,0,0,0,0,0
3,201392388,2170660915,0,0,2024-10-04 19:43:44,256,84,340,2,1,3
3,201392388,2170660915,55982,36895,2024-10-04 19:43:44,0,0,0,0,0,0
3,201392388,2170660915,58003,36895,2024-10-04 19:43:44,0,0,0,0,0,0
3,201392388,1145490690,2281,47873,2024-10-04 19:43:45,813,60,873,3,1,4
3,201392388,2170660915,0,0,2024-10-04 19:43:45,128,168,296,1,2,3
3,201392388,2170660915,55982,36895,2024-10-04 19:43:45,0,0,0,0,0,0
3,201392388,2170660915,58003,36895,2024-10-04 19:43:45,0,0,0,0,0,0
3,201392388,1145490690,2281,47873,2024-10-04 19:43:46,0,0,0,0,0,0
3,201392388,2170660915,0,0,2024-10-04 19:43:46,0,0,0,0,0,0
3,201392388,2170660915,55982,36895,2024-10-04 19:43:46,0,0,0,0,0,0
3,201392388,2170660915,58003,36895,2024-10-04 19:43:46,0,0,0,0,0,0
3,201392388,1145490690,2281,47873,2024-10-04 19:43:47,5023,93110,98133,46,73,119
3,201392388,2170660915,0,0,2024-10-04 19:43:47,0,0,0,0,0,0
3,201392388,2170660915,55982,36895,2024-10-04 19:43:47,0,0,0,0,0,0
3,201392388,2170660915,58003,36895,2024-10-04 19:43:47,0,0,0,0,0,0
3,201392388,1145490690,2281,47873,2024-10-04 19:43:48,0,0,0,0,0,0
3,201392388,2170660915,0,0,2024-10-04 19:43:48,0,0,0,0,0,0
3,201392388,2170660915,55982,36895,2024-10-04 19:43:48,0,0,0,0,0,0
3,201392388,2170660915,58003,36895,2024-10-04 19:43:48,0,0,0,0,0,0
3,201392388,1145490690,2281,47873,2024-10-04 19:43:49,0,0,0,0,0,0
3,201392388,2170660915,0,0,2024-10-04 19:43:49,0,0,0,0,0,0
3,201392388,2170660915,55982,36895,2024-10-04 19:43:49,0,0,0,0,0,0
3,201392388,2170660915,58003,36895,2024-10-04 19:43:49,0,0,0,0,0,0
3,201392388,1145490690,2281,47873,2024-10-04 19:43:50,0,0,0,0,0,0
3,201392388,2170660915,0,0,2024-10-04 19:43:50,0,0,0,0,0,0
3,201392388,2170660915,55982,36895,2024-10-04 19:43:50,0,0,0,0,0,0
3,201392388,2170660915,58003,36895,2024-10-04 19:43:50,0,0,0,0,0,0
3,201392388,1145490690,2281,47873,2024-10-04 19:43:51,0,0,0,0,0,0
3,201392388,2170660915,0,0,2024-10-04 19:43:51,0,0,0,0,0,0
3,201392388,2170660915,55982,36895,2024-10-04 19:43:51,0,0,0,0,0,0
3,201392388,2170660915,58003,36895,2024-10-04 19:43:51,0,0,0,0,0,0
3,201392388,1145490690,2281,47873,2024-10-04 19:43:52,0,0,0,0,0,0
3,201392388,2170660915,0,0,2024-10-04 19:43:52,0,0,0,0,0,0
3,201392388,2170660915,55982,36895,2024-10-04 19:43:52,0,0,0,0,0,0
3,201392388,2170660915,58003,36895,2024-10-04 19:43:52,0,0,0,0,0,0
3,201392388,1145490690,2281,47873,2024-10-04 19:43:53,0,0,0,0,0,0
3,201392388,2170660915,0,0,2024-10-04 19:43:53,0,0,0,0,0,0
3,201392388,2170660915,55982,36895,2024-10-04 19:43:53,0,0,0,0,0,0
3,201392388,2170660915,58003,36895,2024-10-04 19:43:53,0,0,0,0,0,0
3,201392388,1145490690,2281,47873,2024-10-04 19:43:54,0,0,0,0,0,0
3,201392388,2170660915,0,0,2024-10-04 19:43:54,0,0,0,0,0,0
3,201392388,2170660915,55982,36895,2024-10-04 19:43:54,0,0,0,0,0,0
3,201392388,2170660915,58003,36895,2024-10-04 19:43:54,0,0,0,0,0,0
3,201392388,1145490690,2281,47873,2024-10-04 19:43:55,0,0,0,0,0,0
3,201392388,2170660915,0,0,2024-10-04 19:43:55,0,0,0,0,0,0
3,201392388,2170660915,55982,36895,2024-10-04 19:43:55,0,0,0,0,0,0
3,201392388,2170660915,58003,36895,2024-10-04 19:43:55,0,0,0,0,0,0
3,201392388,1145490690,2281,47873,2024-10-04 19:43:56,0,0,0,0,0,0
3,201392388,2170660915,0,0,2024-10-04 19:43:56,128,0,128,1,0,1
3,201392388,2170660915,55982,36895,2024-10-04 19:43:56,0,0,0,0,0,0
3,201392388,2170660915,58003,36895,2024-10-04 19:43:56,0,0,0,0,0,0
3,201392388,1145490690,2281,47873,2024-10-04 19:43:57,0,0,0,0,0,0
3,201392388,2170660915,0,0,2024-10-04 19:43:57,128,84,212,1,1,2
3,201392388,2170660915,55982,36895,2024-10-04 19:43:57,0,0,0,0,0,0
3,201392388,2170660915,58003,36895,2024-10-04 19:43:57,0,0,0,0,0,0
3,201392388,1145490690,2281,47873,2024-10-04 19:43:58,0,0,0,0,0,0
3,201392388,2170660915,0,0,2024-10-04 19:43:58,128,168,296,1,2,3
3,201392388,2170660915,55982,36895,2024-10-04 19:43:58,0,0,0,0,0,0
3,201392388,2170660915,58003,36895,2024-10-04 19:43:58,0,0,0,0,0,0
3,201392388,1145490690,2281,47873,2024-10-04 19:43:59,0,0,0,0,0,0
3,201392388,2170660915,0,0,2024-10-04 19:43:59,128,84,212,1,1,2
3,201392388,2170660915,55982,36895,2024-10-04 19:43:59,0,0,0,0,0,0
3,201392388,2170660915,58003,36895,2024-10-04 19:43:59,0,0,0,0,0,0
3,201392388,1145490690,2281,47873,2024-10-04 19:44:00,0,0,0,0,0,0
3,201392388,2170660915,0,0,2024-10-04 19:44:00,128,84,212,1,1,2
3,201392388,2170660915,55982,36895,2024-10-04 19:44:00,0,0,0,0,0,0
3,201392388,2170660915,58003,36895,2024-10-04 19:44:00,0,0,0,0,0,0
3,201392388,1145490690,2281,47873,2024-10-04 19:44:01,0,0,0,0,0,0
3,201392388,2170660915,0,0,2024-10-04 19:44:01,128,84,212,1,1,2
3,201392388,2170660915,55982,36895,2024-10-04 19:44:01,0,0,0,0,0,0
3,201392388,2170660915,58003,36895,2024-10-04 19:44:01,0,0,0,0,0,0
3,201392388,1145490690,2281,47873,2024-10-04 19:44:02,0,0,0,0,0,0
3,201392388,2170660915,0,0,2024-10-04 19:44:02,128,84,212,1,1,2
3,201392388,2170660915,55982,36895,2024-10-04 19:44:02,0,0,0,0,0,0
3,201392388,2170660915,58003,36895,2024-10-04 19:44:02,0,0,0,0,0,0
3,201392388,1145490690,2281,47873,2024-10-04 19:44:03,0,0,0,0,0,0
3,201392388,2170660915,0,0,2024-10-04 19:44:03,128,84,212,1,1,2
3,201392388,2170660915,55982,36895,2024-10-04 19:44:03,0,0,0,0,0,0
3,201392388,2170660915,58003,36895,2024-10-04 19:44:03,0,0,0,0,0,0
3,201392388,1145490690,2281,47873,2024-10-04 19:44:04,0,0,0,0,0,0
3,201392388,2170660915,0,0,2024-10-04 19:44:04,128,84,212,1,1,2
3,201392388,2170660915,55982,36895,2024-10-04 19:44:04,0,0,0,0,0,0
3,201392388,2170660915,58003,36895,2024-10-04 19:44:04,0,0,0,0,0,0
3,201392388,1145490690,2281,47873,2024-10-04 19:44:05,0,0,0,0,0,0
3,201392388,2170660915,0,0,2024-10-04 19:44:05,128,84,212,1,1,2
3,201392388,2170660915,55982,36895,2024-10-04 19:44:05,0,0,0,0,0,0
3,201392388,2170660915,58003,36895,2024-10-04 19:44:05,0,0,0,0,0,0
3,201392388,1145490690,2281,47873,2024-10-04 19:44:06,0,0,0,0,0,0
3,201392388,2170660915,0,0,2024-10-04 19:44:06,0,0,0,0,0,0
3,201392388,2170660915,55982,36895,2024-10-04 19:44:06,0,0,0,0,0,0
3,201392388,2170660915,58003,36895,2024-10-04 19:44:06,0,0,0,0,0,0
3,201392388,2170660915,29392,36895,2024-10-04 19:44:07,666,507,1173,6,6,12
3,201392388,1145490690,2281,47873,2024-10-04 19:44:07,0,0,0,0,0,0
3,201392388,2170660915,0,0,2024-10-04 19:44:07,0,0,0,0,0,0
3,201392388,2170660915,55982,36895,2024-10-04 19:44:07,0,0,0,0,0,0
3,201392388,2170660915,58003,36895,2024-10-04 19:44:07,0,0,0,0,0,0
3,201392388,2170660915,29392,36895,2024-10-04 19:44:08,0,0,0,0,0,0
3,201392388,2170660915,0,0,2024-10-04 19:44:08,128,84,212,1,1,2
3,201392388,2170660915,55982,36895,2024-10-04 19:44:08,0,0,0,0,0,0
3,201392388,2170660915,58003,36895,2024-10-04 19:44:08,0,0,0,0,0,0
3,201392388,2170660915,29392,36895,2024-10-04 19:44:09,0,0,0,0,0,0
3,201392388,2170660915,0,0,2024-10-04 19:44:09,128,84,212,1,1,2
3,201392388,2170660915,55982,36895,2024-10-04 19:44:09,0,0,0,0,0,0
3,201392388,2170660915,58003,36895,2024-10-04 19:44:09,0,0,0,0,0,0
3,201392388,2170660915,29392,36895,2024-10-04 19:44:10,0,0,0,0,0,0
3,201392388,2170660915,0,0,2024-10-04 19:44:10,0,0,0,0,0,0
3,201392388,2170660915,55982,36895,2024-10-04 19:44:10,0,0,0,0,0,0
3,201392388,2170660915,58003,36895,2024-10-04 19:44:10,0,0,0,0,0,0
3,201392388,2170660915,0,0,2024-10-04 19:44:11,128,84,212,1,1,2
3,201392388,2170660915,55982,36895,2024-10-04 19:44:11,0,0,0,0,0,0
3,201392388,2170660915,58003,36895,2024-10-04 19:44:11,0,0,0,0,0,0
3,201392388,2170660915,0,0,2024-10-04 19:44:12,0,0,0,0,0,0
3,201392388,2170660915,55982,36895,2024-10-04 19:44:12,0,0,0,0,0,0
3,201392388,2170660915,58003,36895,2024-10-04 19:44:12,0,0,0,0,0,0
3,201392388,2170660915,0,0,2024-10-04 19:44:13,0,0,0,0,0,0
3,201392388,2170660915,55982,36895,2024-10-04 19:44:13,0,0,0,0,0,0
3,201392388,2170660915,58003,36895,2024-10-04 19:44:13,0,0,0,0,0,0
3,201392388,2170660915,0,0,2024-10-04 19:44:14,128,0,128,1,0,1
3,201392388,2170660915,55982,36895,2024-10-04 19:44:14,0,0,0,0,0,0
3,201392388,2170660915,58003,36895,2024-10-04 19:44:14,0,0,0,0,0,0
3,201392388,2170660915,0,0,2024-10-04 19:44:15,128,84,212,1,1,2
3,201392388,2170660915,55982,36895,2024-10-04 19:44:15,0,0,0,0,0,0
3,201392388,2170660915,58003,36895,2024-10-04 19:44:15,0,0,0,0,0,0
3,201392388,1145490692,3782,47873,2024-10-04 19:44:16,3936,65453,69389,30,51,81
3,201392388,2170660915,0,0,2024-10-04 19:44:16,128,168,296,1,2,3
3,201392388,2170660915,55982,36895,2024-10-04 19:44:16,0,0,0,0,0,0
3,201392388,2170660915,58003,36895,2024-10-04 19:44:16,0,0,0,0,0,0
3,201392388,1145490692,3782,47873,2024-10-04 19:44:17,1872,35730,37602,18,23,41
3,201392388,2170660915,0,0,2024-10-04 19:44:17,0,0,0,0,0,0
3,201392388,2170660915,55982,36895,2024-10-04 19:44:17,0,0,0,0,0,0
3,201392388,2170660915,58003,36895,2024-10-04 19:44:17,0,0,0,0,0,0
3,201392388,1145490692,3782,47873,2024-10-04 19:44:18,912,8289,9201,9,9,18
3,201392388,2170660915,0,0,2024-10-04 19:44:18,0,0,0,0,0,0
3,201392388,2170660915,55982,36895,2024-10-04 19:44:18,0,0,0,0,0,0
3,201392388,2170660915,58003,36895,2024-10-04 19:44:18,0,0,0,0,0,0
3,201392388,1145490692,3782,47873,2024-10-04 19:44:19,0,0,0,0,0,0
3,201392388,2170660915,0,0,2024-10-04 19:44:19,0,0,0,0,0,0
3,201392388,2170660915,55982,36895,2024-10-04 19:44:19,0,0,0,0,0,0
3,201392388,2170660915,58003,36895,2024-10-04 19:44:19,0,0,0,0,0,0
3,201392388,1145490692,3782,47873,2024-10-04 19:44:20,0,0,0,0,0,0
3,201392388,2170660915,0,0,2024-10-04 19:44:20,0,0,0,0,0,0
3,201392388,2170660915,55982,36895,2024-10-04 19:44:20,0,0,0,0,0,0
3,201392388,2170660915,58003,36895,2024-10-04 19:44:20,0,0,0,0,0,0
3,201392388,1145490692,3782,47873,2024-10-04 19:44:21,0,0,0,0,0,0
3,201392388,2170660915,0,0,2024-10-04 19:44:21,0,0,0,0,0,0
3,201392388,2170660915,55982,36895,2024-10-04 19:44:21,0,0,0,0,0,0
3,201392388,2170660915,58003,36895,2024-10-04 19:44:21,0,0,0,0,0,0
3,201392388,1145490692,3782,47873,2024-10-04 19:44:22,0,0,0,0,0,0
3,201392388,2170660915,0,0,2024-10-04 19:44:22,0,0,0,0,0,0
3,201392388,2170660915,55982,36895,2024-10-04 19:44:22,0,0,0,0,0,0
3,201392388,2170660915,58003,36895,2024-10-04 19:44:22,0,0,0,0,0,0
3,201392388,1145490692,3782,47873,2024-10-04 19:44:23,0,0,0,0,0,0
3,201392388,2170660915,0,0,2024-10-04 19:44:23,0,0,0,0,0,0
3,201392388,2170660915,55982,36895,2024-10-04 19:44:23,0,0,0,0,0,0
3,201392388,2170660915,58003,36895,2024-10-04 19:44:23,0,0,0,0,0,0
3,201392388,1145490692,3782,47873,2024-10-04 19:44:24,0,0,0,0,0,0
3,201392388,2170660915,0,0,2024-10-04 19:44:24,0,0,0,0,0,0
3,201392388,2170660915,55982,36895,2024-10-04 19:44:24,0,0,0,0,0,0
3,201392388,2170660915,58003,36895,2024-10-04 19:44:24,0,0,0,0,0,0
3,201392388,1145490692,3782,47873,2024-10-04 19:44:25,0,0,0,0,0,0
3,201392388,2170660915,0,0,2024-10-04 19:44:25,0,0,0,0,0,0
3,201392388,2170660915,55982,36895,2024-10-04 19:44:25,0,0,0,0,0,0
3,201392388,2170660915,58003,36895,2024-10-04 19:44:25,0,0,0,0,0,0
3,201392388,1145490692,3782,47873,2024-10-04 19:44:26,0,0,0,0,0,0
3,201392388,2170660915,0,0,2024-10-04 19:44:26,0,0,0,0,0,0
3,201392388,2170660915,55982,36895,2024-10-04 19:44:26,0,0,0,0,0,0
3,201392388,2170660915,58003,36895,2024-10-04 19:44:26,0,0,0,0,0,0
3,201392388,1145490692,3782,47873,2024-10-04 19:44:27,0,0,0,0,0,0
3,201392388,2170660915,0,0,2024-10-04 19:44:27,128,0,128,1,0,1
3,201392388,2170660915,55982,36895,2024-10-04 19:44:27,0,0,0,0,0,0
3,201392388,2170660915,58003,36895,2024-10-04 19:44:27,0,0,0,0,0,0
3,201392388,1145490692,3782,47873,2024-10-04 19:44:28,0,0,0,0,0,0
3,201392388,2170660915,0,0,2024-10-04 19:44:28,128,84,212,1,1,2
3,201392388,2170660915,55982,36895,2024-10-04 19:44:28,0,0,0,0,0,0
3,201392388,2170660915,58003,36895,2024-10-04 19:44:28,0,0,0,0,0,0
3,201392388,1145490692,3782,47873,2024-10-04 19:44:29,0,0,0,0,0,0
3,201392388,2170660915,0,0,2024-10-04 19:44:29,128,84,212,1,1,2
3,201392388,2170660915,55982,36895,2024-10-04 19:44:29,0,0,0,0,0,0
3,201392388,2170660915,58003,36895,2024-10-04 19:44:29,0,0,0,0,0,0
3,201392388,1145490692,3782,47873,2024-10-04 19:44:30,0,0,0,0,0,0
3,201392388,2170660915,0,0,2024-10-04 19:44:30,128,84,212,1,1,2
3,201392388,2170660915,55982,36895,2024-10-04 19:44:30,0,0,0,0,0,0
3,201392388,2170660915,58003,36895,2024-10-04 19:44:30,0,0,0,0,0,0
3,201392388,1145490692,3782,47873,2024-10-04 19:44:31,0,0,0,0,0,0
3,201392388,2170660915,0,0,2024-10-04 19:44:31,128,84,212,1,1,2
3,201392388,2170660915,55982,36895,2024-10-04 19:44:31,0,0,0,0,0,0
3,201392388,2170660915,58003,36895,2024-10-04 19:44:31,0,0,0,0,0,0
3,201392388,1145490692,3782,47873,2024-10-04 19:44:32,0,0,0,0,0,0
3,201392388,2170660915,0,0,2024-10-04 19:44:32,128,84,212,1,1,2
3,201392388,2170660915,55982,36895,2024-10-04 19:44:32,0,0,0,0,0,0
3,201392388,2170660915,58003,36895,2024-10-04 19:44:32,0,0,0,0,0,0
3,201392388,1145490692,3782,47873,2024-10-04 19:44:33,0,0,0,0,0,0
3,201392388,2170660915,0,0,2024-10-04 19:44:33,0,84,84,0,1,1
3,201392388,2170660915,55982,36895,2024-10-04 19:44:33,0,0,0,0,0,0
3,201392388,2170660915,58003,36895,2024-10-04 19:44:33,0,0,0,0,0,0
3,201392388,1145490692,3782,47873,2024-10-04 19:44:34,0,0,0,0,0,0
3,201392388,2170660915,0,0,2024-10-04 19:44:34,128,84,212,1,1,2
3,201392388,2170660915,55982,36895,2024-10-04 19:44:34,0,0,0,0,0,0
3,201392388,2170660915,58003,36895,2024-10-04 19:44:34,0,0,0,0,0,0
3,201392388,1145490692,3782,47873,2024-10-04 19:44:35,0,0,0,0,0,0
3,201392388,2170660915,0,0,2024-10-04 19:44:35,128,84,212,1,1,2
3,201392388,2170660915,55982,36895,2024-10-04 19:44:35,0,0,0,0,0,0
3,201392388,2170660915,58003,36895,2024-10-04 19:44:35,0,0,0,0,0,0
3,201392388,1145490692,3782,47873,2024-10-04 19:44:36,0,0,0,0,0,0
3,201392388,2170660915,0,0,2024-10-04 19:44:36,128,84,212,1,1,2
3,201392388,2170660915,55982,36895,2024-10-04 19:44:36,0,0,0,0,0,0
3,201392388,2170660915,58003,36895,2024-10-04 19:44:36,0,0,0,0,0,0
3,201392388,1145490692,3782,47873,2024-10-04 19:44:37,0,0,0,0,0,0
3,201392388,2170660915,0,0,2024-10-04 19:44:37,128,84,212,1,1,2
3,201392388,2170660915,55982,36895,2024-10-04 19:44:37,0,0,0,0,0,0
3,201392388,2170660915,58003,36895,2024-10-04 19:44:37,0,0,0,0,0,0
3,201392388,1145490692,3782,47873,2024-10-04 19:44:38,0,0,0,0,0,0
3,201392388,2170660915,1672,36895,2024-10-04 19:44:38,570,455,1025,5,5,10
3,201392388,2170660915,0,0,2024-10-04 19:44:38,0,0,0,0,0,0
3,201392388,2170660915,55982,36895,2024-10-04 19:44:38,0,0,0,0,0,0
3,201392388,2170660915,58003,36895,2024-10-04 19:44:38,0,0,0,0,0,0
3,201392388,1145490692,3782,47873,2024-10-04 19:44:39,0,0,0,0,0,0
3,201392388,2170660915,1672,36895,2024-10-04 19:44:39,0,0,0,0,0,0
3,201392388,2170660915,0,0,2024-10-04 19:44:39,128,84,212,1,1,2
3,201392388,2170660915,55982,36895,2024-10-04 19:44:39,0,0,0,0,0,0
3,201392388,2170660915,58003,36895,2024-10-04 19:44:39,0,0,0,0,0,0
3,201392388,2170660915,1672,36895,2024-10-04 19:44:40,0,0,0,0,0,0
3,201392388,2170660915,0,0,2024-10-04 19:44:40,128,84,212,1,1,2
3,201392388,2170660915,55982,36895,2024-10-04 19:44:40,0,0,0,0,0,0
3,201392388,2170660915,58003,36895,2024-10-04 19:44:40,0,0,0,0,0,0
3,201392388,2170660915,0,0,2024-10-04 19:44:41,128,84,212,1,1,2
3,201392388,2170660915,55982,36895,2024-10-04 19:44:41,0,0,0,0,0,0
3,201392388,2170660915,58003,36895,2024-10-04 19:44:41,0,0,0,0,0,0
3,201392388,2170660915,0,0,2024-10-04 19:44:42,0,0,0,0,0,0
3,201392388,2170660915,55982,36895,2024-10-04 19:44:42,0,0,0,0,0,0
3,201392388,2170660915,58003,36895,2024-10-04 19:44:42,0,0,0,0,0,0
3,201392388,2170660915,0,0,2024-10-04 19:44:43,0,0,0,0,0,0
3,201392388,2170660915,55982,36895,2024-10-04 19:44:43,0,0,0,0,0,0
3,201392388,2170660915,58003,36895,2024-10-04 19:44:43,0,0,0,0,0,0
3,201392388,2170660915,0,0,2024-10-04 19:44:44,0,0,0,0,0,0
3,201392388,2170660915,55982,36895,2024-10-04 19:44:44,0,0,0,0,0,0
3,201392388,2170660915,58003,36895,2024-10-04 19:44:44,0,0,0,0,0,0
3,201392388,2170660915,0,0,2024-10-04 19:44:45,128,0,128,1,0,1
3,201392388,2170660915,55982,36895,2024-10-04 19:44:45,0,0,0,0,0,0
3,201392388,2170660915,58003,36895,2024-10-04 19:44:45,0,0,0,0,0,0
3,201392388,2170660915,0,0,2024-10-04 19:44:46,128,84,212,1,1,2
3,201392388,2170660915,55982,36895,2024-10-04 19:44:46,0,0,0,0,0,0
3,201392388,2170660915,58003,36895,2024-10-04 19:44:46,0,0,0,0,0,0
3,201392388,1145490692,41641,47873,2024-10-04 19:44:47,5088,72937,78025,42,58,100
3,201392388,2170660915,0,0,2024-10-04 19:44:47,128,168,296,1,2,3
3,201392388,2170660915,55982,36895,2024-10-04 19:44:47,0,0,0,0,0,0
3,201392388,2170660915,58003,36895,2024-10-04 19:44:47,0,0,0,0,0,0
3,201392388,1145490692,41641,47873,2024-10-04 19:44:48,1416,22297,23713,14,18,32
3,201392388,2170660915,0,0,2024-10-04 19:44:48,0,0,0,0,0,0
3,201392388,2170660915,55982,36895,2024-10-04 19:44:48,0,0,0,0,0,0
3,201392388,2170660915,58003,36895,2024-10-04 19:44:48,0,0,0,0,0,0
3,201392388,1145490692,41641,47873,2024-10-04 19:44:49,0,0,0,0,0,0
3,201392388,2170660915,0,0,2024-10-04 19:44:49,0,0,0,0,0,0
3,201392388,2170660915,55982,36895,2024-10-04 19:44:49,0,0,0,0,0,0
3,201392388,2170660915,58003,36895,2024-10-04 19:44:49,0,0,0,0,0,0
3,201392388,1145490692,41641,47873,2024-10-04 19:44:50,0,0,0,0,0,0
3,201392388,2170660915,0,0,2024-10-04 19:44:50,0,0,0,0,0,0
3,201392388,2170660915,55982,36895,2024-10-04 19:44:50,0,0,0,0,0,0
3,201392388,2170660915,58003,36895,2024-10-04 19:44:50,0,0,0,0,0,0
3,201392388,1145490692,41641,47873,2024-10-04 19:44:51,0,0,0,0,0,0
3,201392388,2170660915,0,0,2024-10-04 19:44:51,0,0,0,0,0,0
3,201392388,2170660915,55982,36895,2024-10-04 19:44:51,0,0,0,0,0,0
3,201392388,2170660915,58003,36895,2024-10-04 19:44:51,0,0,0,0,0,0
3,201392388,1145490692,41641,47873,2024-10-04 19:44:52,0,0,0,0,0,0
3,201392388,2170660915,0,0,2024-10-04 19:44:52,0,0,0,0,0,0
3,201392388,2170660915,55982,36895,2024-10-04 19:44:52,0,0,0,0,0,0
3,201392388,2170660915,58003,36895,2024-10-04 19:44:52,0,0,0,0,0,0
3,201392388,1145490692,41641,47873,2024-10-04 19:44:53,0,0,0,0,0,0
3,201392388,2170660915,0,0,2024-10-04 19:44:53,0,0,0,0,0,0
3,201392388,2170660915,55982,36895,2024-10-04 19:44:53,0,0,0,0,0,0
3,201392388,2170660915,58003,36895,2024-10-04 19:44:53,0,0,0,0,0,0
3,201392388,1145490692,41641,47873,2024-10-04 19:44:54,0,0,0,0,0,0
3,201392388,2170660915,0,0,2024-10-04 19:44:54,0,0,0,0,0,0
3,201392388,2170660915,55982,36895,2024-10-04 19:44:54,0,0,0,0,0,0
3,201392388,2170660915,58003,36895,2024-10-04 19:44:54,0,0,0,0,0,0
3,201392388,1145490692,41641,47873,2024-10-04 19:44:55,0,0,0,0,0,0
3,201392388,2170660915,0,0,2024-10-04 19:44:55,0,0,0,0,0,0
3,201392388,2170660915,55982,36895,2024-10-04 19:44:55,0,0,0,0,0,0
3,201392388,2170660915,58003,36895,2024-10-04 19:44:55,0,0,0,0,0,0
3,201392388,1145490692,41641,47873,2024-10-04 19:44:56,0,0,0,0,0,0
3,201392388,2170660915,0,0,2024-10-04 19:44:56,0,0,0,0,0,0
3,201392388,2170660915,55982,36895,2024-10-04 19:44:56,0,0,0,0,0,0
3,201392388,2170660915,58003,36895,2024-10-04 19:44:56,0,0,0,0,0,0
3,201392388,1145490692,41641,47873,2024-10-04 19:44:57,0,0,0,0,0,0
3,201392388,2170660915,0,0,2024-10-04 19:44:57,128,0,128,1,0,1
3,201392388,2170660915,55982,36895,2024-10-04 19:44:57,0,0,0,0,0,0
3,201392388,2170660915,58003,36895,2024-10-04 19:44:57,0,0,0,0,0,0
3,201392388,1145490692,41641,47873,2024-10-04 19:44:58,0,0,0,0,0,0
3,201392388,2170660915,0,0,2024-10-04 19:44:58,128,84,212,1,1,2
3,201392388,2170660915,55982,36895,2024-10-04 19:44:58,0,0,0,0,0,0
3,201392388,2170660915,58003,36895,2024-10-04 19:44:58,0,0,0,0,0,0
3,201392388,1145490692,41641,47873,2024-10-04 19:44:59,0,0,0,0,0,0
3,201392388,2170660915,0,0,2024-10-04 19:44:59,128,84,212,1,1,2
3,201392388,2170660915,55982,36895,2024-10-04 19:44:59,0,0,0,0,0,0
3,201392388,2170660915,58003,36895,2024-10-04 19:44:59,0,0,0,0,0,0
3,201392388,1145490692,41641,47873,2024-10-04 19:45:00,0,0,0,0,0,0
3,201392388,2170660915,0,0,2024-10-04 19:45:00,128,84,212,1,1,2
3,201392388,2170660915,55982,36895,2024-10-04 19:45:00,0,0,0,0,0,0
3,201392388,2170660915,58003,36895,2024-10-04 19:45:00,0,0,0,0,0,0
3,201392388,1145490692,41641,47873,2024-10-04 19:45:01,0,0,0,0,0,0
3,201392388,2170660915,0,0,2024-10-04 19:45:01,0,84,84,0,1,1
3,201392388,2170660915,55982,36895,2024-10-04 19:45:01,0,0,0,0,0,0
3,201392388,2170660915,58003,36895,2024-10-04 19:45:01,0,0,0,0,0,0
3,201392388,1145490692,41641,47873,2024-10-04 19:45:02,0,0,0,0,0,0
3,201392388,2170660915,0,0,2024-10-04 19:45:02,128,84,212,1,1,2
3,201392388,2170660915,55982,36895,2024-10-04 19:45:02,0,0,0,0,0,0
3,201392388,2170660915,58003,36895,2024-10-04 19:45:02,0,0,0,0,0,0
3,201392388,1145490692,41641,47873,2024-10-04 19:45:03,0,0,0,0,0,0
3,201392388,2170660915,0,0,2024-10-04 19:45:03,128,84,212,1,1,2
3,201392388,2170660915,55982,36895,2024-10-04 19:45:03,0,0,0,0,0,0
3,201392388,2170660915,58003,36895,2024-10-04 19:45:03,0,0,0,0,0,0
3,201392388,1145490692,41641,47873,2024-10-04 19:45:04,0,0,0,0,0,0
3,201392388,2170660915,0,0,2024-10-04 19:45:04,128,84,212,1,1,2
3,201392388,2170660915,55982,36895,2024-10-04 19:45:04,0,0,0,0,0,0
3,201392388,2170660915,58003,36895,2024-10-04 19:45:04,0,0,0,0,0,0
3,201392388,1145490692,41641,47873,2024-10-04 19:45:05,0,0,0,0,0,0
3,201392388,2170660915,0,0,2024-10-04 19:45:05,128,84,212,1,1,2
3,201392388,2170660915,55982,36895,2024-10-04 19:45:05,0,0,0,0,0,0
3,201392388,2170660915,58003,36895,2024-10-04 19:45:05,0,0,0,0,0,0
3,201392388,1145490692,41641,47873,2024-10-04 19:45:06,0,0,0,0,0,0
3,201392388,2170660915,0,0,2024-10-04 19:45:06,128,84,212,1,1,2
3,201392388,2170660915,55982,36895,2024-10-04 19:45:06,0,0,0,0,0,0
3,201392388,2170660915,58003,36895,2024-10-04 19:45:06,0,0,0,0,0,0
3,201392388,1145490692,41641,47873,2024-10-04 19:45:07,0,0,0,0,0,0
3,201392388,2170660915,0,0,2024-10-04 19:45:07,128,84,212,1,1,2
3,201392388,2170660915,55982,36895,2024-10-04 19:45:07,0,0,0,0,0,0
3,201392388,2170660915,58003,36895,2024-10-04 19:45:07,0,0,0,0,0,0
3,201392388,1145490692,41641,47873,2024-10-04 19:45:08,0,0,0,0,0,0
3,201392388,2170660915,0,0,2024-10-04 19:45:08,0,0,0,0,0,0
3,201392388,2170660915,55982,36895,2024-10-04 19:45:08,0,0,0,0,0,0
3,201392388,2170660915,58003,36895,2024-10-04 19:45:08,0,0,0,0,0,0
3,201392388,1145490692,41641,47873,2024-10-04 19:45:09,0,0,0,0,0,0
3,201392388,2170660915,13542,36895,2024-10-04 19:45:09,666,507,1173,6,6,12
3,201392388,2170660915,0,0,2024-10-04 19:45:09,0,0,0,0,0,0
3,201392388,2170660915,55982,36895,2024-10-04 19:45:09,0,0,0,0,0,0
3,201392388,2170660915,58003,36895,2024-10-04 19:45:09,0,0,0,0,0,0
3,201392388,1145490692,41641,47873,2024-10-04 19:45:10,0,0,0,0,0,0
3,201392388,2170660915,13542,36895,2024-10-04 19:45:10,0,0,0,0,0,0
3,201392388,2170660915,0,0,2024-10-04 19:45:10,128,84,212,1,1,2
3,201392388,2170660915,55982,36895,2024-10-04 19:45:10,0,0,0,0,0,0
3,201392388,2170660915,58003,36895,2024-10-04 19:45:10,0,0,0,0,0,0
3,201392388,2170660915,13542,36895,2024-10-04 19:45:11,0,0,0,0,0,0
3,201392388,2170660915,0,0,2024-10-04 19:45:11,128,84,212,1,1,2
3,201392388,2170660915,55982,36895,2024-10-04 19:45:11,0,0,0,0,0,0
3,201392388,2170660915,58003,36895,2024-10-04 19:45:11,0,0,0,0,0,0
3,201392388,2170660915,0,0,2024-10-04 19:45:12,128,84,212,1,1,2
3,201392388,2170660915,55982,36895,2024-10-04 19:45:12,0,0,0,0,0,0
3,201392388,2170660915,58003,36895,2024-10-04 19:45:12,0,0,0,0,0,0
3,201392388,2170660915,0,0,2024-10-04 19:45:13,0,0,0,0,0,0
3,201392388,2170660915,55982,36895,2024-10-04 19:45:13,0,0,0,0,0,0
3,201392388,2170660915,58003,36895,2024-10-04 19:45:13,0,0,0,0,0,0
3,201392388,2170660915,0,0,2024-10-04 19:45:14,0,0,0,0,0,0
3,201392388,2170660915,55982,36895,2024-10-04 19:45:14,0,0,0,0,0,0
3,201392388,2170660915,58003,36895,2024-10-04 19:45:14,0,0,0,0,0,0
3,201392388,2170660915,0,0,2024-10-04 19:45:15,128,0,128,1,0,1
3,201392388,2170660915,55982,36895,2024-10-04 19:45:15,0,0,0,0,0,0
3,201392388,2170660915,58003,36895,2024-10-04 19:45:15,0,0,0,0,0,0
3,201392388,2170660915,0,0,2024-10-04 19:45:16,128,84,212,1,1,2
3,201392388,2170660915,55982,36895,2024-10-04 19:45:16,0,0,0,0,0,0
3,201392388,2170660915,58003,36895,2024-10-04 19:45:16,0,0,0,0,0,0
3,201392388,2170660915,0,0,2024-10-04 19:45:17,128,84,212,1,1,2
3,201392388,2170660915,55982,36895,2024-10-04 19:45:17,0,0,0,0,0,0
3,201392388,2170660915,58003,36895,2024-10-04 19:45:17,0,0,0,0,0,0
3,201392388,1145490689,41644,47873,2024-10-04 19:45:18,6156,96163,102319,51,75,126
3,201392388,2170660915,0,0,2024-10-04 19:45:18,0,84,84,0,1,1
3,201392388,2170660915,55982,36895,2024-10-04 19:45:18,0,0,0,0,0,0
3,201392388,2170660915,58003,36895,2024-10-04 19:45:18,0,0,0,0,0,0
3,201392388,1145490689,41644,47873,2024-10-04 19:45:19,0,0,0,0,0,0
3,201392388,2170660915,0,0,2024-10-04 19:45:19,0,0,0,0,0,0
3,201392388,2170660915,55982,36895,2024-10-04 19:45:19,0,0,0,0,0,0
3,201392388,2170660915,58003,36895,2024-10-04 19:45:19,0,0,0,0,0,0
3,201392388,1145490689,41644,47873,2024-10-04 19:45:20,0,0,0,0,0,0
3,201392388,2170660915,0,0,2024-10-04 19:45:20,0,0,0,0,0,0
3,201392388,2170660915,55982,36895,2024-10-04 19:45:20,0,0,0,0,0,0
3,201392388,2170660915,58003,36895,2024-10-04 19:45:20,0,0,0,0,0,0
3,201392388,2170660915,0,0,2024-10-04 19:45:21,0,0,0,0,0,0
3,201392388,2170660915,55982,36895,2024-10-04 19:45:21,0,0,0,0,0,0
3,201392388,2170660915,58003,36895,2024-10-04 19:45:21,0,0,0,0,0,0
3,201392388,2170660915,0,0,2024-10-04 19:45:22,0,0,0,0,0,0
3,201392388,2170660915,55982,36895,2024-10-04 19:45:22,0,0,0,0,0,0
3,201392388,2170660915,58003,36895,2024-10-04 19:45:22,0,0,0,0,0,0
3,201392388,2170660915,0,0,2024-10-04 19:45:23,0,0,0,0,0,0
3,201392388,2170660915,55982,36895,2024-10-04 19:45:23,0,0,0,0,0,0
3,201392388,2170660915,58003,36895,2024-10-04 19:45:23,0,0,0,0,0,0
3,201392388,2170660915,0,0,2024-10-04 19:45:24,0,0,0,0,0,0
3,201392388,2170660915,55982,36895,2024-10-04 19:45:24,0,0,0,0,0,0
3,201392388,2170660915,58003,36895,2024-10-04 19:45:24,0,0,0,0,0,0
3,201392388,2170660915,0,0,2024-10-04 19:45:25,0,0,0,0,0,0
3,201392388,2170660915,55982,36895,2024-10-04 19:45:25,0,0,0,0,0,0
3,201392388,2170660915,58003,36895,2024-10-04 19:45:25,0,0,0,0,0,0
3,201392388,2170660915,0,0,2024-10-04 19:45:26,0,0,0,0,0,0
3,201392388,2170660915,55982,36895,2024-10-04 19:45:26,0,0,0,0,0,0
3,201392388,2170660915,58003,36895,2024-10-04 19:45:26,0,0,0,0,0,0
3,201392388,2170660915,0,0,2024-10-04 19:45:27,0,0,0,0,0,0
3,201392388,2170660915,55982,36895,2024-10-04 19:45:27,0,0,0,0,0,0
3,201392388,2170660915,58003,36895,2024-10-04 19:45:27,0,0,0,0,0,0
3,201392388,2170660915,0,0,2024-10-04 19:45:28,128,0,128,1,0,1
3,201392388,2170660915,55982,36895,2024-10-04 19:45:28,0,0,0,0,0,0
3,201392388,2170660915,58003,36895,2024-10-04 19:45:28,0,0,0,0,0,0
3,201392388,2170660915,0,0,2024-10-04 19:45:29,128,84,212,1,1,2
3,201392388,2170660915,55982,36895,2024-10-04 19:45:29,0,0,0,0,0,0
3,201392388,2170660915,58003,36895,2024-10-04 19:45:29,0,0,0,0,0,0
3,201392388,2170660915,0,0,2024-10-04 19:45:30,128,84,212,1,1,2
3,201392388,2170660915,55982,36895,2024-10-04 19:45:30,0,0,0,0,0,0
3,201392388,2170660915,58003,36895,2024-10-04 19:45:30,0,0,0,0,0,0
3,201392388,2170660915,0,0,2024-10-04 19:45:31,128,84,212,1,1,2
3,201392388,2170660915,55982,36895,2024-10-04 19:45:31,0,0,0,0,0,0
3,201392388,2170660915,58003,36895,2024-10-04 19:45:31,0,0,0,0,0,0
3,201392388,2170660915,0,0,2024-10-04 19:45:32,128,84,212,1,1,2
3,201392388,2170660915,55982,36895,2024-10-04 19:45:32,0,0,0,0,0,0
3,201392388,2170660915,58003,36895,2024-10-04 19:45:32,0,0,0,0,0,0
3,201392388,2170660915,0,0,2024-10-04 19:45:33,128,84,212,1,1,2
3,201392388,2170660915,55982,36895,2024-10-04 19:45:33,0,0,0,0,0,0
3,201392388,2170660915,58003,36895,2024-10-04 19:45:33,0,0,0,0,0,0
3,201392388,2170660915,0,0,2024-10-04 19:45:34,128,84,212,1,1,2
3,201392388,2170660915,55982,36895,2024-10-04 19:45:34,0,0,0,0,0,0
3,201392388,2170660915,58003,36895,2024-10-04 19:45:34,0,0,0,0,0,0
3,201392388,2170660915,0,0,2024-10-04 19:45:35,128,84,212,1,1,2
3,201392388,2170660915,55982,36895,2024-10-04 19:45:35,0,0,0,0,0,0
3,201392388,2170660915,58003,36895,2024-10-04 19:45:35,0,0,0,0,0,0
3,201392388,2170660915,0,0,2024-10-04 19:45:36,128,84,212,1,1,2
3,201392388,2170660915,55982,36895,2024-10-04 19:45:36,0,0,0,0,0,0
3,201392388,2170660915,58003,36895,2024-10-04 19:45:36,0,0,0,0,0,0
3,201392388,2170660915,0,0,2024-10-04 19:45:37,128,84,212,1,1,2
3,201392388,2170660915,55982,36895,2024-10-04 19:45:37,0,0,0,0,0,0
3,201392388,2170660915,58003,36895,2024-10-04 19:45:37,0,0,0,0,0,0
3,201392388,2170660915,0,0,2024-10-04 19:45:38,0,84,84,0,1,1
3,201392388,2170660915,55982,36895,2024-10-04 19:45:38,0,0,0,0,0,0
3,201392388,2170660915,58003,36895,2024-10-04 19:45:38,0,0,0,0,0,0
3,201392388,2170660915,42144,36895,2024-10-04 19:45:39,666,507,1173,6,6,12
3,201392388,2170660915,0,0,2024-10-04 19:45:39,128,0,128,1,0,1
3,201392388,2170660915,55982,36895,2024-10-04 19:45:39,0,0,0,0,0,0
3,201392388,2170660915,58003,36895,2024-10-04 19:45:39,0,0,0,0,0,0
3,201392388,2170660915,42144,36895,2024-10-04 19:45:40,0,0,0,0,0,0
3,201392388,2170660915,0,0,2024-10-04 19:45:40,128,84,212,1,1,2
3,201392388,2170660915,55982,36895,2024-10-04 19:45:40,0,0,0,0,0,0
3,201392388,2170660915,58003,36895,2024-10-04 19:45:40,0,0,0,0,0,0
3,201392388,2170660915,42144,36895,2024-10-04 19:45:41,0,0,0,0,0,0
3,201392388,2170660915,0,0,2024-10-04 19:45:41,128,84,212,1,1,2
3,201392388,2170660915,55982,36895,2024-10-04 19:45:41,0,0,0,0,0,0
3,201392388,2170660915,58003,36895,2024-10-04 19:45:41,0,0,0,0,0,0
3,201392388,2170660915,0,0,2024-10-04 19:45:42,0,84,84,0,1,1
3,201392388,2170660915,55982,36895,2024-10-04 19:45:42,0,0,0,0,0,0
3,201392388,2170660915,58003,36895,2024-10-04 19:45:42,0,0,0,0,0,0
3,201392388,2170660915,0,0,2024-10-04 19:45:43,0,0,0,0,0,0
3,201392388,2170660915,55982,36895,2024-10-04 19:45:43,0,0,0,0,0,0
3,201392388,2170660915,58003,36895,2024-10-04 19:45:43,0,0,0,0,0,0
3,201392388,2170660915,0,0,2024-10-04 19:45:44,0,0,0,0,0,0
3,201392388,2170660915,55982,36895,2024-10-04 19:45:44,0,0,0,0,0,0
3,201392388,2170660915,58003,36895,2024-10-04 19:45:44,0,0,0,0,0,0
3,201392388,2170660915,0,0,2024-10-04 19:45:45,0,0,0,0,0,0
3,201392388,2170660915,55982,36895,2024-10-04 19:45:45,0,0,0,0,0,0
3,201392388,2170660915,58003,36895,2024-10-04 19:45:45,0,0,0,0,0,0
3,201392388,2170660915,0,0,2024-10-04 19:45:46,128,84,212,1,1,2
3,201392388,2170660915,55982,36895,2024-10-04 19:45:46,0,0,0,0,0,0
3,201392388,2170660915,58003,36895,2024-10-04 19:45:46,0,0,0,0,0,0
3,201392388,1145490689,42692,47873,2024-10-04 19:45:47,104,0,104,1,0,1
3,201392388,2170660915,0,0,2024-10-04 19:45:47,256,168,424,2,2,4
3,201392388,2170660915,55982,36895,2024-10-04 19:45:47,0,0,0,0,0,0
3,201392388,2170660915,58003,36895,2024-10-04 19:45:47,0,0,0,0,0,0
3,201392388,1145490689,42692,47873,2024-10-04 19:45:48,5644,87452,93096,48,67,115
3,201392388,2170660915,0,0,2024-10-04 19:45:48,0,0,0,0,0,0
3,201392388,2170660915,55982,36895,2024-10-04 19:45:48,0,0,0,0,0,0
3,201392388,2170660915,58003,36895,2024-10-04 19:45:48,0,0,0,0,0,0
3,201392388,1145490689,42692,47873,2024-10-04 19:45:49,0,0,0,0,0,0
3,201392388,2170660915,0,0,2024-10-04 19:45:49,0,0,0,0,0,0
3,201392388,2170660915,55982,36895,2024-10-04 19:45:49,0,0,0,0,0,0
3,201392388,2170660915,58003,36895,2024-10-04 19:45:49,0,0,0,0,0,0
3,201392388,1145490689,42692,47873,2024-10-04 19:45:50,516,1576,2092,5,4,9
3,201392388,2170660915,0,0,2024-10-04 19:45:50,0,0,0,0,0,0
3,201392388,2170660915,55982,36895,2024-10-04 19:45:50,0,0,0,0,0,0
3,201392388,2170660915,58003,36895,2024-10-04 19:45:50,0,0,0,0,0,0
3,201392388,1145490689,42692,47873,2024-10-04 19:45:51,0,0,0,0,0,0
3,201392388,2170660915,0,0,2024-10-04 19:45:51,0,0,0,0,0,0
3,201392388,2170660915,55982,36895,2024-10-04 19:45:51,0,0,0,0,0,0
3,201392388,2170660915,58003,36895,2024-10-04 19:45:51,0,0,0,0,0,0
3,201392388,2170660915,0,0,2024-10-04 19:45:52,0,0,0,0,0,0
3,201392388,2170660915,55982,36895,2024-10-04 19:45:52,0,0,0,0,0,0
3,201392388,2170660915,58003,36895,2024-10-04 19:45:52,0,0,0,0,0,0
3,201392388,2170660915,0,0,2024-10-04 19:45:53,0,0,0,0,0,0
3,201392388,2170660915,55982,36895,2024-10-04 19:45:53,0,0,0,0,0,0
3,201392388,2170660915,58003,36895,2024-10-04 19:45:53,0,0,0,0,0,0
3,201392388,2170660915,0,0,2024-10-04 19:45:54,0,0,0,0,0,0
3,201392388,2170660915,55982,36895,2024-10-04 19:45:54,0,0,0,0,0,0
3,201392388,2170660915,58003,36895,2024-10-04 19:45:54,0,0,0,0,0,0
3,201392388,2170660915,0,0,2024-10-04 19:45:55,0,0,0,0,0,0
3,201392388,2170660915,55982,36895,2024-10-04 19:45:55,0,0,0,0,0,0
3,201392388,2170660915,58003,36895,2024-10-04 19:45:55,0,0,0,0,0,0
3,201392388,2170660915,0,0,2024-10-04 19:45:56,0,0,0,0,0,0
3,201392388,2170660915,55982,36895,2024-10-04 19:45:56,0,0,0,0,0,0
3,201392388,2170660915,58003,36895,2024-10-04 19:45:56,0,0,0,0,0,0
3,201392388,2170660915,0,0,2024-10-04 19:45:57,0,0,0,0,0,0
3,201392388,2170660915,55982,36895,2024-10-04 19:45:57,0,0,0,0,0,0
3,201392388,2170660915,58003,36895,2024-10-04 19:45:57,0,0,0,0,0,0
3,201392388,2170660915,0,0,2024-10-04 19:45:58,128,0,128,1,0,1
3,201392388,2170660915,55982,36895,2024-10-04 19:45:58,0,0,0,0,0,0
3,201392388,2170660915,58003,36895,2024-10-04 19:45:58,0,0,0,0,0,0
3,201392388,2170660915,0,0,2024-10-04 19:45:59,128,84,212,1,1,2
3,201392388,2170660915,55982,36895,2024-10-04 19:45:59,0,0,0,0,0,0
3,201392388,2170660915,58003,36895,2024-10-04 19:45:59,0,0,0,0,0,0
3,201392388,2170660915,0,0,2024-10-04 19:46:00,128,84,212,1,1,2
3,201392388,2170660915,55982,36895,2024-10-04 19:46:00,0,0,0,0,0,0
3,201392388,2170660915,58003,36895,2024-10-04 19:46:00,0,0,0,0,0,0
3,201392388,2170660915,0,0,2024-10-04 19:46:01,128,84,212,1,1,2
3,201392388,2170660915,55982,36895,2024-10-04 19:46:01,0,0,0,0,0,0
3,201392388,2170660915,58003,36895,2024-10-04 19:46:01,0,0,0,0,0,0
3,201392388,2170660915,0,0,2024-10-04 19:46:02,128,84,212,1,1,2
3,201392388,2170660915,55982,36895,2024-10-04 19:46:02,0,0,0,0,0,0
3,201392388,2170660915,58003,36895,2024-10-04 19:46:02,0,0,0,0,0,0
3,201392388,2170660915,0,0,2024-10-04 19:46:03,128,84,212,1,1,2
3,201392388,2170660915,55982,36895,2024-10-04 19:46:03,0,0,0,0,0,0
3,201392388,2170660915,58003,36895,2024-10-04 19:46:03,0,0,0,0,0,0
3,201392388,2170660915,0,0,2024-10-04 19:46:04,128,84,212,1,1,2
3,201392388,2170660915,55982,36895,2024-10-04 19:46:04,0,0,0,0,0,0
3,201392388,2170660915,58003,36895,2024-10-04 19:46:04,0,0,0,0,0,0
3,201392388,2170660915,0,0,2024-10-04 19:46:05,128,84,212,1,1,2
3,201392388,2170660915,55982,36895,2024-10-04 19:46:05,0,0,0,0,0,0
3,201392388,2170660915,58003,36895,2024-10-04 19:46:05,0,0,0,0,0,0
3,201392388,2170660915,0,0,2024-10-04 19:46:06,128,84,212,1,1,2
3,201392388,2170660915,55982,36895,2024-10-04 19:46:06,0,0,0,0,0,0
3,201392388,2170660915,58003,36895,2024-10-04 19:46:06,0,0,0,0,0,0
3,201392388,2170660915,0,0,2024-10-04 19:46:07,128,84,212,1,1,2
3,201392388,2170660915,55982,36895,2024-10-04 19:46:07,0,0,0,0,0,0
3,201392388,2170660915,58003,36895,2024-10-04 19:46:07,0,0,0,0,0,0
3,201392388,2170660915,0,0,2024-10-04 19:46:08,0,84,84,0,1,1
3,201392388,2170660915,55982,36895,2024-10-04 19:46:08,0,0,0,0,0,0
3,201392388,2170660915,58003,36895,2024-10-04 19:46:08,0,0,0,0,0,0
3,201392388,2170660915,0,0,2024-10-04 19:46:09,0,0,0,0,0,0
3,201392388,2170660915,55982,36895,2024-10-04 19:46:09,0,0,0,0,0,0
3,201392388,2170660915,58003,36895,2024-10-04 19:46:09,0,0,0,0,0,0
3,201392388,2170660915,11480,36895,2024-10-04 19:46:10,666,507,1173,6,6,12
3,201392388,2170660915,0,0,2024-10-04 19:46:10,128,0,128,1,0,1
3,201392388,2170660915,55982,36895,2024-10-04 19:46:10,0,0,0,0,0,0
3,201392388,2170660915,58003,36895,2024-10-04 19:46:10,0,0,0,0,0,0
3,201392388,2170660915,11480,36895,2024-10-04 19:46:11,0,0,0,0,0,0
3,201392388,2170660915,0,0,2024-10-04 19:46:11,128,84,212,1,1,2
3,201392388,2170660915,55982,36895,2024-10-04 19:46:11,0,0,0,0,0,0
3,201392388,2170660915,58003,36895,2024-10-04 19:46:11,0,0,0,0,0,0
3,201392388,2170660915,11480,36895,2024-10-04 19:46:12,0,0,0,0,0,0
3,201392388,2170660915,0,0,2024-10-04 19:46:12,0,84,84,0,1,1
3,201392388,2170660915,55982,36895,2024-10-04 19:46:12,0,0,0,0,0,0
3,201392388,2170660915,58003,36895,2024-10-04 19:46:12,0,0,0,0,0,0
3,201392388,2170660915,11480,36895,2024-10-04 19:46:13,0,0,0,0,0,0
3,201392388,2170660915,0,0,2024-10-04 19:46:13,128,84,212,1,1,2
3,201392388,2170660915,55982,36895,2024-10-04 19:46:13,0,0,0,0,0,0
3,201392388,2170660915,58003,36895,2024-10-04 19:46:13,0,0,0,0,0,0
3,201392388,2170660915,0,0,2024-10-04 19:46:14,0,0,0,0,0,0
3,201392388,2170660915,55982,36895,2024-10-04 19:46:14,0,0,0,0,0,0
3,201392388,2170660915,58003,36895,2024-10-04 19:46:14,0,0,0,0,0,0
3,201392388,2170660915,0,0,2024-10-04 19:46:15,0,0,0,0,0,0
3,201392388,2170660915,55982,36895,2024-10-04 19:46:15,0,0,0,0,0,0
3,201392388,2170660915,58003,36895,2024-10-04 19:46:15,0,0,0,0,0,0
3,201392388,2170660915,0,0,2024-10-04 19:46:16,0,0,0,0,0,0
3,201392388,2170660915,55982,36895,2024-10-04 19:46:16,0,0,0,0,0,0
3,201392388,2170660915,58003,36895,2024-10-04 19:46:16,0,0,0,0,0,0
3,201392388,2170660915,0,0,2024-10-04 19:46:17,128,84,212,1,1,2
3,201392388,2170660915,55982,36895,2024-10-04 19:46:17,0,0,0,0,0,0
3,201392388,2170660915,58003,36895,2024-10-04 19:46:17,0,0,0,0,0,0
3,201392388,1145490691,57544,47873,2024-10-04 19:46:18,2100,14487,16587,13,19,32
3,201392388,2170660915,0,0,2024-10-04 19:46:18,256,168,424,2,2,4
3,201392388,2170660915,55982,36895,2024-10-04 19:46:18,0,0,0,0,0,0
3,201392388,2170660915,58003,36895,2024-10-04 19:46:18,0,0,0,0,0,0
3,201392388,1145490691,57544,47873,2024-10-04 19:46:19,1464,32890,34354,14,21,35
3,201392388,2170660915,0,0,2024-10-04 19:46:19,0,0,0,0,0,0
3,201392388,2170660915,55982,36895,2024-10-04 19:46:19,0,0,0,0,0,0
3,201392388,2170660915,58003,36895,2024-10-04 19:46:19,0,0,0,0,0,0
3,201392388,1145490691,57544,47873,2024-10-04 19:46:20,0,0,0,0,0,0
3,201392388,2170660915,0,0,2024-10-04 19:46:20,0,0,0,0,0,0
3,201392388,2170660915,55982,36895,2024-10-04 19:46:20,0,0,0,0,0,0
3,201392388,2170660915,58003,36895,2024-10-04 19:46:20,0,0,0,0,0,0
3,201392388,1145490691,57544,47873,2024-10-04 19:46:21,2952,55993,58945,29,40,69
3,201392388,2170660915,0,0,2024-10-04 19:46:21,0,0,0,0,0,0
3,201392388,2170660915,55982,36895,2024-10-04 19:46:21,0,0,0,0,0,0
3,201392388,2170660915,58003,36895,2024-10-04 19:46:21,0,0,0,0,0,0
3,201392388,1145490691,57544,47873,2024-10-04 19:46:22,0,0,0,0,0,0
3,201392388,2170660915,0,0,2024-10-04 19:46:22,0,0,0,0,0,0
3,201392388,2170660915,55982,36895,2024-10-04 19:46:22,0,0,0,0,0,0
3,201392388,2170660915,58003,36895,2024-10-04 19:46:22,0,0,0,0,0,0
3,201392388,1145490691,57544,47873,2024-10-04 19:46:23,0,0,0,0,0,0
3,201392388,2170660915,0,0,2024-10-04 19:46:23,0,0,0,0,0,0
3,201392388,2170660915,55982,36895,2024-10-04 19:46:23,0,0,0,0,0,0
3,201392388,2170660915,58003,36895,2024-10-04 19:46:23,0,0,0,0,0,0
3,201392388,2170660915,0,0,2024-10-04 19:46:24,0,0,0,0,0,0
3,201392388,2170660915,55982,36895,2024-10-04 19:46:24,0,0,0,0,0,0
3,201392388,2170660915,58003,36895,2024-10-04 19:46:24,0,0,0,0,0,0
3,201392388,2170660915,0,0,2024-10-04 19:46:25,0,0,0,0,0,0
3,201392388,2170660915,55982,36895,2024-10-04 19:46:25,0,0,0,0,0,0
3,201392388,2170660915,58003,36895,2024-10-04 19:46:25,0,0,0,0,0,0
3,201392388,2170660915,0,0,2024-10-04 19:46:26,0,0,0,0,0,0
3,201392388,2170660915,55982,36895,2024-10-04 19:46:26,0,0,0,0,0,0
3,201392388,2170660915,58003,36895,2024-10-04 19:46:26,0,0,0,0,0,0
3,201392388,2170660915,0,0,2024-10-04 19:46:27,0,0,0,0,0,0
3,201392388,2170660915,55982,36895,2024-10-04 19:46:27,0,0,0,0,0,0
3,201392388,2170660915,58003,36895,2024-10-04 19:46:27,0,0,0,0,0,0
3,201392388,2170660915,0,0,2024-10-04 19:46:28,0,0,0,0,0,0
3,201392388,2170660915,55982,36895,2024-10-04 19:46:28,0,0,0,0,0,0
3,201392388,2170660915,58003,36895,2024-10-04 19:46:28,0,0,0,0,0,0
3,201392388,2170660915,0,0,2024-10-04 19:46:29,0,0,0,0,0,0
3,201392388,2170660915,55982,36895,2024-10-04 19:46:29,0,0,0,0,0,0
3,201392388,2170660915,58003,36895,2024-10-04 19:46:29,0,0,0,0,0,0
3,201392388,2170660915,0,0,2024-10-04 19:46:30,128,0,128,1,0,1
3,201392388,2170660915,55982,36895,2024-10-04 19:46:30,0,0,0,0,0,0
3,201392388,2170660915,58003,36895,2024-10-04 19:46:30,0,0,0,0,0,0
3,201392388,2170660915,0,0,2024-10-04 19:46:31,128,84,212,1,1,2
3,201392388,2170660915,55982,36895,2024-10-04 19:46:31,0,0,0,0,0,0
3,201392388,2170660915,58003,36895,2024-10-04 19:46:31,0,0,0,0,0,0
3,201392388,2170660915,0,0,2024-10-04 19:46:32,128,84,212,1,1,2
3,201392388,2170660915,55982,36895,2024-10-04 19:46:32,0,0,0,0,0,0
3,201392388,2170660915,58003,36895,2024-10-04 19:46:32,0,0,0,0,0,0
3,201392388,2170660915,0,0,2024-10-04 19:46:33,128,84,212,1,1,2
3,201392388,2170660915,55982,36895,2024-10-04 19:46:33,0,0,0,0,0,0
3,201392388,2170660915,58003,36895,2024-10-04 19:46:33,0,0,0,0,0,0
3,201392388,2170660915,0,0,2024-10-04 19:46:34,128,84,212,1,1,2
3,201392388,2170660915,55982,36895,2024-10-04 19:46:34,0,0,0,0,0,0
3,201392388,2170660915,58003,36895,2024-10-04 19:46:34,0,0,0,0,0,0
3,201392388,2170660915,0,0,2024-10-04 19:46:35,0,84,84,0,1,1
3,201392388,2170660915,55982,36895,2024-10-04 19:46:35,0,0,0,0,0,0
3,201392388,2170660915,58003,36895,2024-10-04 19:46:35,0,0,0,0,0,0
3,201392388,2170660915,0,0,2024-10-04 19:46:36,128,84,212,1,1,2
3,201392388,2170660915,55982,36895,2024-10-04 19:46:36,0,0,0,0,0,0
3,201392388,2170660915,58003,36895,2024-10-04 19:46:36,0,0,0,0,0,0
3,201392388,2170660915,0,0,2024-10-04 19:46:37,128,84,212,1,1,2
3,201392388,2170660915,55982,36895,2024-10-04 19:46:37,0,0,0,0,0,0
3,201392388,2170660915,58003,36895,2024-10-04 19:46:37,0,0,0,0,0,0
3,201392388,2170660915,0,0,2024-10-04 19:46:38,128,84,212,1,1,2
3,201392388,2170660915,55982,36895,2024-10-04 19:46:38,0,0,0,0,0,0
3,201392388,2170660915,58003,36895,2024-10-04 19:46:38,0,0,0,0,0,0
3,201392388,2170660915,0,0,2024-10-04 19:46:39,128,84,212,1,1,2
3,201392388,2170660915,55982,36895,2024-10-04 19:46:39,0,0,0,0,0,0
3,201392388,2170660915,58003,36895,2024-10-04 19:46:39,0,0,0,0,0,0
3,201392388,2170660915,0,0,2024-10-04 19:46:40,128,84,212,1,1,2
3,201392388,2170660915,55982,36895,2024-10-04 19:46:40,0,0,0,0,0,0
3,201392388,2170660915,58003,36895,2024-10-04 19:46:40,0,0,0,0,0,0
3,201392388,2170660915,0,0,2024-10-04 19:46:41,0,0,0,0,0,0
3,201392388,2170660915,55982,36895,2024-10-04 19:46:41,0,0,0,0,0,0
3,201392388,2170660915,58003,36895,2024-10-04 19:46:41,0,0,0,0,0,0
3,201392388,2170660915,25238,36895,2024-10-04 19:46:42,666,507,1173,6,6,12
3,201392388,2170660915,0,0,2024-10-04 19:46:42,128,0,128,1,0,1
3,201392388,2170660915,55982,36895,2024-10-04 19:46:42,0,0,0,0,0,0
3,201392388,2170660915,58003,36895,2024-10-04 19:46:42,0,0,0,0,0,0
3,201392388,2170660915,25238,36895,2024-10-04 19:46:43,0,0,0,0,0,0
3,201392388,2170660915,0,0,2024-10-04 19:46:43,128,84,212,1,1,2
3,201392388,2170660915,55982,36895,2024-10-04 19:46:43,0,0,0,0,0,0
3,201392388,2170660915,58003,36895,2024-10-04 19:46:43,0,0,0,0,0,0
3,201392388,2170660915,25238,36895,2024-10-04 19:46:44,0,0,0,0,0,0
3,201392388,2170660915,0,0,2024-10-04 19:46:44,128,84,212,1,1,2
3,201392388,2170660915,55982,36895,2024-10-04 19:46:44,0,0,0,0,0,0
3,201392388,2170660915,58003,36895,2024-10-04 19:46:44,0,0,0,0,0,0
3,201392388,2170660915,0,0,2024-10-04 19:46:45,0,84,84,0,1,1
3,201392388,2170660915,55982,36895,2024-10-04 19:46:45,0,0,0,0,0,0
3,201392388,2170660915,58003,36895,2024-10-04 19:46:45,0,0,0,0,0,0
3,201392388,2170660915,0,0,2024-10-04 19:46:46,0,0,0,0,0,0
3,201392388,2170660915,55982,36895,2024-10-04 19:46:46,0,0,0,0,0,0
3,201392388,2170660915,58003,36895,2024-10-04 19:46:46,0,0,0,0,0,0
3,201392388,2170660915,0,0,2024-10-04 19:46:47,128,0,128,1,0,1
3,201392388,2170660915,55982,36895,2024-10-04 19:46:47,0,0,0,0,0,0
3,201392388,2170660915,58003,36895,2024-10-04 19:46:47,0,0,0,0,0,0
3,201392388,2170660915,0,0,2024-10-04 19:46:48,128,84,212,1,1,2
3,201392388,2170660915,55982,36895,2024-10-04 19:46:48,0,0,0,0,0,0
3,201392388,2170660915,58003,36895,2024-10-04 19:46:48,0,0,0,0,0,0
3,201392388,2170660915,0,0,2024-10-04 19:46:49,128,84,212,1,1,2
3,201392388,2170660915,55982,36895,2024-10-04 19:46:49,0,0,0,0,0,0
3,201392388,2170660915,58003,36895,2024-10-04 19:46:49,0,0,0,0,0,0
3,201392388,1145490692,27350,47873,2024-10-04 19:46:50,3372,40660,44032,25,36,61
3,201392388,2170660915,0,0,2024-10-04 19:46:50,0,84,84,0,1,1
3,201392388,2170660915,55982,36895,2024-10-04 19:46:50,0,0,0,0,0,0
3,201392388,2170660915,58003,36895,2024-10-04 19:46:50,0,0,0,0,0,0
3,201392388,1145490692,27350,47873,2024-10-04 19:46:51,0,0,0,0,0,0
3,201392388,2170660915,0,0,2024-10-04 19:46:51,0,0,0,0,0,0
3,201392388,2170660915,55982,36895,2024-10-04 19:46:51,0,0,0,0,0,0
3,201392388,2170660915,58003,36895,2024-10-04 19:46:51,0,0,0,0,0,0
3,201392388,1145490692,27350,47873,2024-10-04 19:46:52,0,0,0,0,0,0
3,201392388,2170660915,0,0,2024-10-04 19:46:52,0,0,0,0,0,0
3,201392388,2170660915,55982,36895,2024-10-04 19:46:52,0,0,0,0,0,0
3,201392388,2170660915,58003,36895,2024-10-04 19:46:52,0,0,0,0,0,0
3,201392388,1145490692,27350,47873,2024-10-04 19:46:53,3060,58694,61754,30,43,73
3,201392388,2170660915,0,0,2024-10-04 19:46:53,0,0,0,0,0,0
3,201392388,2170660915,55982,36895,2024-10-04 19:46:53,0,0,0,0,0,0
3,201392388,2170660915,58003,36895,2024-10-04 19:46:53,0,0,0,0,0,0
3,201392388,1145490692,27350,47873,2024-10-04 19:46:54,0,0,0,0,0,0
3,201392388,2170660915,0,0,2024-10-04 19:46:54,0,0,0,0,0,0
3,201392388,2170660915,55982,36895,2024-10-04 19:46:54,0,0,0,0,0,0
3,201392388,2170660915,58003,36895,2024-10-04 19:46:54,0,0,0,0,0,0
3,201392388,2170660915,0,0,2024-10-04 19:46:55,0,0,0,0,0,0
3,201392388,2170660915,55982,36895,2024-10-04 19:46:55,0,0,0,0,0,0
3,201392388,2170660915,58003,36895,2024-10-04 19:46:55,0,0,0,0,0,0
3,201392388,2170660915,0,0,2024-10-04 19:46:56,0,0,0,0,0,0
3,201392388,2170660915,55982,36895,2024-10-04 19:46:56,0,0,0,0,0,0
3,201392388,2170660915,58003,36895,2024-10-04 19:46:56,0,0,0,0,0,0
3,201392388,2170660915,0,0,2024-10-04 19:46:57,0,0,0,0,0,0
3,201392388,2170660915,55982,36895,2024-10-04 19:46:57,0,0,0,0,0,0
3,201392388,2170660915,58003,36895,2024-10-04 19:46:57,0,0,0,0,0,0
3,201392388,2170660915,0,0,2024-10-04 19:46:58,0,0,0,0,0,0
3,201392388,2170660915,55982,36895,2024-10-04 19:46:58,0,0,0,0,0,0
3,201392388,2170660915,58003,36895,2024-10-04 19:46:58,0,0,0,0,0,0
3,201392388,2170660915,0,0,2024-10-04 19:46:59,0,0,0,0,0,0
3,201392388,2170660915,55982,36895,2024-10-04 19:46:59,0,0,0,0,0,0
3,201392388,2170660915,58003,36895,2024-10-04 19:46:59,0,0,0,0,0,0
3,201392388,2170660915,0,0,2024-10-04 19:47:00,0,0,0,0,0,0
3,201392388,2170660915,55982,36895,2024-10-04 19:47:00,0,0,0,0,0,0
3,201392388,2170660915,58003,36895,2024-10-04 19:47:00,0,0,0,0,0,0
3,201392388,2170660915,0,0,2024-10-04 19:47:01,128,0,128,1,0,1
3,201392388,2170660915,55982,36895,2024-10-04 19:47:01,0,0,0,0,0,0
3,201392388,2170660915,58003,36895,2024-10-04 19:47:01,0,0,0,0,0,0
3,201392388,2170660915,0,0,2024-10-04 19:47:02,128,84,212,1,1,2
3,201392388,2170660915,55982,36895,2024-10-04 19:47:02,0,0,0,0,0,0
3,201392388,2170660915,58003,36895,2024-10-04 19:47:02,0,0,0,0,0,0
3,201392388,2170660915,0,0,2024-10-04 19:47:03,128,84,212,1,1,2
3,201392388,2170660915,55982,36895,2024-10-04 19:47:03,0,0,0,0,0,0
3,201392388,2170660915,58003,36895,2024-10-04 19:47:03,0,0,0,0,0,0
3,201392388,2170660915,0,0,2024-10-04 19:47:04,128,84,212,1,1,2
3,201392388,2170660915,55982,36895,2024-10-04 19:47:04,0,0,0,0,0,0
3,201392388,2170660915,58003,36895,2024-10-04 19:47:04,0,0,0,0,0,0
3,201392388,2170660915,0,0,2024-10-04 19:47:05,128,84,212,1,1,2
3,201392388,2170660915,55982,36895,2024-10-04 19:47:05,0,0,0,0,0,0
3,201392388,2170660915,58003,36895,2024-10-04 19:47:05,0,0,0,0,0,0
3,201392388,2170660915,0,0,2024-10-04 19:47:06,128,168,296,1,2,3
3,201392388,2170660915,55982,36895,2024-10-04 19:47:06,0,0,0,0,0,0
3,201392388,2170660915,58003,36895,2024-10-04 19:47:06,0,0,0,0,0,0
3,201392388,2170660915,0,0,2024-10-04 19:47:07,128,84,212,1,1,2
3,201392388,2170660915,55982,36895,2024-10-04 19:47:07,0,0,0,0,0,0
3,201392388,2170660915,58003,36895,2024-10-04 19:47:07,0,0,0,0,0,0
3,201392388,2170660915,0,0,2024-10-04 19:47:08,128,84,212,1,1,2
3,201392388,2170660915,55982,36895,2024-10-04 19:47:08,0,0,0,0,0,0
3,201392388,2170660915,58003,36895,2024-10-04 19:47:08,0,0,0,0,0,0
3,201392388,2170660915,0,0,2024-10-04 19:47:09,128,84,212,1,1,2
3,201392388,2170660915,55982,36895,2024-10-04 19:47:09,0,0,0,0,0,0
3,201392388,2170660915,58003,36895,2024-10-04 19:47:09,0,0,0,0,0,0
3,201392388,2170660915,0,0,2024-10-04 19:47:10,128,84,212,1,1,2
3,201392388,2170660915,55982,36895,2024-10-04 19:47:10,0,0,0,0,0,0
3,201392388,2170660915,58003,36895,2024-10-04 19:47:10,0,0,0,0,0,0
3,201392388,2170660915,0,0,2024-10-04 19:47:11,0,0,0,0,0,0
3,201392388,2170660915,55982,36895,2024-10-04 19:47:11,0,0,0,0,0,0
3,201392388,2170660915,58003,36895,2024-10-04 19:47:11,0,0,0,0,0,0
3,201392388,2170660915,64706,36895,2024-10-04 19:47:12,666,507,1173,6,6,12
3,201392388,2170660915,0,0,2024-10-04 19:47:12,0,0,0,0,0,0
3,201392388,2170660915,55982,36895,2024-10-04 19:47:12,0,0,0,0,0,0
3,201392388,2170660915,58003,36895,2024-10-04 19:47:12,0,0,0,0,0,0
3,201392388,2170660915,64706,36895,2024-10-04 19:47:13,0,0,0,0,0,0
3,201392388,2170660915,0,0,2024-10-04 19:47:13,128,84,212,1,1,2
3,201392388,2170660915,55982,36895,2024-10-04 19:47:13,0,0,0,0,0,0
3,201392388,2170660915,58003,36895,2024-10-04 19:47:13,0,0,0,0,0,0
3,201392388,2170660915,64706,36895,2024-10-04 19:47:14,0,0,0,0,0,0
3,201392388,2170660915,0,0,2024-10-04 19:47:14,128,84,212,1,1,2
3,201392388,2170660915,55982,36895,2024-10-04 19:47:14,0,0,0,0,0,0
3,201392388,2170660915,58003,36895,2024-10-04 19:47:14,0,0,0,0,0,0
3,201392388,2170660915,64706,36895,2024-10-04 19:47:15,0,0,0,0,0,0
3,201392388,2170660915,0,0,2024-10-04 19:47:15,128,84,212,1,1,2
3,201392388,2170660915,55982,36895,2024-10-04 19:47:15,0,0,0,0,0,0
3,201392388,2170660915,58003,36895,2024-10-04 19:47:15,0,0,0,0,0,0
3,201392388,2170660915,64706,36895,2024-10-04 19:47:16,0,0,0,0,0,0
3,201392388,2170660915,0,0,2024-10-04 19:47:16,0,0,0,0,0,0
3,201392388,2170660915,55982,36895,2024-10-04 19:47:16,0,0,0,0,0,0
3,201392388,2170660915,58003,36895,2024-10-04 19:47:16,0,0,0,0,0,0
3,201392388,2170660915,0,0,2024-10-04 19:47:17,0,0,0,0,0,0
3,201392388,2170660915,55982,36895,2024-10-04 19:47:17,0,0,0,0,0,0
3,201392388,2170660915,58003,36895,2024-10-04 19:47:17,0,0,0,0,0,0
3,201392388,2170660915,0,0,2024-10-04 19:47:18,128,0,128,1,0,1
3,201392388,2170660915,55982,36895,2024-10-04 19:47:18,0,0,0,0,0,0
3,201392388,2170660915,58003,36895,2024-10-04 19:47:18,0,0,0,0,0,0
3,201392388,2170660915,0,0,2024-10-04 19:47:19,128,84,212,1,1,2
3,201392388,2170660915,55982,36895,2024-10-04 19:47:19,0,0,0,0,0,0
3,201392388,2170660915,58003,36895,2024-10-04 19:47:19,0,0,0,0,0,0
3,201392388,2170660915,0,0,2024-10-04 19:47:20,128,84,212,1,1,2
3,201392388,2170660915,55982,36895,2024-10-04 19:47:20,0,0,0,0,0,0
3,201392388,2170660915,58003,36895,2024-10-04 19:47:20,0,0,0,0,0,0
3,201392388,1145490692,63128,47873,2024-10-04 19:47:21,3026,32013,35039,21,31,52
3,201392388,2170660915,0,0,2024-10-04 19:47:21,0,84,84,0,1,1
3,201392388,2170660915,55982,36895,2024-10-04 19:47:21,0,0,0,0,0,0
3,201392388,2170660915,58003,36895,2024-10-04 19:47:21,0,0,0,0,0,0
3,201392388,1145490692,63128,47873,2024-10-04 19:47:22,0,0,0,0,0,0
3,201392388,2170660915,0,0,2024-10-04 19:47:22,0,0,0,0,0,0
3,201392388,2170660915,55982,36895,2024-10-04 19:47:22,0,0,0,0,0,0
3,201392388,2170660915,58003,36895,2024-10-04 19:47:22,0,0,0,0,0,0
3,201392388,1145490692,63128,47873,2024-10-04 19:47:23,0,0,0,0,0,0
3,201392388,2170660915,0,0,2024-10-04 19:47:23,0,0,0,0,0,0
3,201392388,2170660915,55982,36895,2024-10-04 19:47:23,0,0,0,0,0,0
3,201392388,2170660915,58003,36895,2024-10-04 19:47:23,0,0,0,0,0,0
3,201392388,1145490692,63128,47873,2024-10-04 19:47:24,3036,63285,66321,30,46,76
3,201392388,2170660915,0,0,2024-10-04 19:47:24,0,0,0,0,0,0
3,201392388,2170660915,55982,36895,2024-10-04 19:47:24,0,0,0,0,0,0
3,201392388,2170660915,58003,36895,2024-10-04 19:47:24,0,0,0,0,0,0
3,201392388,1145490692,63128,47873,2024-10-04 19:47:25,0,0,0,0,0,0
3,201392388,2170660915,0,0,2024-10-04 19:47:25,0,0,0,0,0,0
3,201392388,2170660915,55982,36895,2024-10-04 19:47:25,0,0,0,0,0,0
3,201392388,2170660915,58003,36895,2024-10-04 19:47:25,0,0,0,0,0,0
3,201392388,2170660915,0,0,2024-10-04 19:47:26,0,0,0,0,0,0
3,201392388,2170660915,55982,36895,2024-10-04 19:47:26,0,0,0,0,0,0
3,201392388,2170660915,58003,36895,2024-10-04 19:47:26,0,0,0,0,0,0
3,201392388,2170660915,0,0,2024-10-04 19:47:27,0,0,0,0,0,0
3,201392388,2170660915,55982,36895,2024-10-04 19:47:27,0,0,0,0,0,0
3,201392388,2170660915,58003,36895,2024-10-04 19:47:27,0,0,0,0,0,0
3,201392388,2170660915,0,0,2024-10-04 19:47:28,0,0,0,0,0,0
3,201392388,2170660915,55982,36895,2024-10-04 19:47:28,0,0,0,0,0,0
3,201392388,2170660915,58003,36895,2024-10-04 19:47:28,0,0,0,0,0,0
3,201392388,2170660915,0,0,2024-10-04 19:47:29,0,0,0,0,0,0
3,201392388,2170660915,55982,36895,2024-10-04 19:47:29,0,0,0,0,0,0
3,201392388,2170660915,58003,36895,2024-10-04 19:47:29,0,0,0,0,0,0
3,201392388,2170660915,0,0,2024-10-04 19:47:30,0,0,0,0,0,0
3,201392388,2170660915,55982,36895,2024-10-04 19:47:30,0,0,0,0,0,0
3,201392388,2170660915,58003,36895,2024-10-04 19:47:30,0,0,0,0,0,0
3,201392388,2170660915,0,0,2024-10-04 19:47:31,0,0,0,0,0,0
3,201392388,2170660915,55982,36895,2024-10-04 19:47:31,0,0,0,0,0,0
3,201392388,2170660915,58003,36895,2024-10-04 19:47:31,0,0,0,0,0,0
3,201392388,2170660915,0,0,2024-10-04 19:47:32,128,0,128,1,0,1
3,201392388,2170660915,55982,36895,2024-10-04 19:47:32,0,0,0,0,0,0
3,201392388,2170660915,58003,36895,2024-10-04 19:47:32,0,0,0,0,0,0
3,201392388,2170660915,0,0,2024-10-04 19:47:33,128,84,212,1,1,2
3,201392388,2170660915,55982,36895,2024-10-04 19:47:33,0,0,0,0,0,0
3,201392388,2170660915,58003,36895,2024-10-04 19:47:33,0,0,0,0,0,0
3,201392388,2170660915,0,0,2024-10-04 19:47:34,128,84,212,1,1,2
3,201392388,2170660915,55982,36895,2024-10-04 19:47:34,0,0,0,0,0,0
3,201392388,2170660915,58003,36895,2024-10-04 19:47:34,0,0,0,0,0,0
3,201392388,2170660915,0,0,2024-10-04 19:47:35,128,84,212,1,1,2
3,201392388,2170660915,55982,36895,2024-10-04 19:47:35,0,0,0,0,0,0
3,201392388,2170660915,58003,36895,2024-10-04 19:47:35,0,0,0,0,0,0
3,201392388,2170660915,0,0,2024-10-04 19:47:36,128,84,212,1,1,2
3,201392388,2170660915,55982,36895,2024-10-04 19:47:36,0,0,0,0,0,0
3,201392388,2170660915,58003,36895,2024-10-04 19:47:36,0,0,0,0,0,0
3,201392388,2170660915,0,0,2024-10-04 19:47:37,128,168,296,1,2,3
3,201392388,2170660915,55982,36895,2024-10-04 19:47:37,0,0,0,0,0,0
3,201392388,2170660915,58003,36895,2024-10-04 19:47:37,0,0,0,0,0,0
3,201392388,2170660915,0,0,2024-10-04 19:47:38,128,84,212,1,1,2
3,201392388,2170660915,55982,36895,2024-10-04 19:47:38,0,0,0,0,0,0
3,201392388,2170660915,58003,36895,2024-10-04 19:47:38,0,0,0,0,0,0
3,201392388,2170660915,0,0,2024-10-04 19:47:39,128,84,212,1,1,2
3,201392388,2170660915,55982,36895,2024-10-04 19:47:39,0,0,0,0,0,0
3,201392388,2170660915,58003,36895,2024-10-04 19:47:39,0,0,0,0,0,0
3,201392388,2170660915,0,0,2024-10-04 19:47:40,128,84,212,1,1,2
3,201392388,2170660915,55982,36895,2024-10-04 19:47:40,0,0,0,0,0,0
3,201392388,2170660915,58003,36895,2024-10-04 19:47:40,0,0,0,0,0,0
3,201392388,2170660915,0,0,2024-10-04 19:47:41,128,84,212,1,1,2
3,201392388,2170660915,55982,36895,2024-10-04 19:47:41,0,0,0,0,0,0
3,201392388,2170660915,58003,36895,2024-10-04 19:47:41,0,0,0,0,0,0
3,201392388,2170660915,0,0,2024-10-04 19:47:42,0,0,0,0,0,0
3,201392388,2170660915,55982,36895,2024-10-04 19:47:42,0,0,0,0,0,0
3,201392388,2170660915,58003,36895,2024-10-04 19:47:42,0,0,0,0,0,0
3,201392388,2170660915,49832,36895,2024-10-04 19:47:43,666,507,1173,6,6,12
3,201392388,2170660915,0,0,2024-10-04 19:47:43,0,0,0,0,0,0
3,201392388,2170660915,55982,36895,2024-10-04 19:47:43,0,0,0,0,0,0
3,201392388,2170660915,58003,36895,2024-10-04 19:47:43,0,0,0,0,0,0
3,201392388,2170660915,49832,36895,2024-10-04 19:47:44,0,0,0,0,0,0
3,201392388,2170660915,0,0,2024-10-04 19:47:44,128,84,212,1,1,2
3,201392388,2170660915,55982,36895,2024-10-04 19:47:44,0,0,0,0,0,0
3,201392388,2170660915,58003,36895,2024-10-04 19:47:44,0,0,0,0,0,0
3,201392388,2170660915,49832,36895,2024-10-04 19:47:45,0,0,0,0,0,0
3,201392388,2170660915,0,0,2024-10-04 19:47:45,128,84,212,1,1,2
3,201392388,2170660915,55982,36895,2024-10-04 19:47:45,0,0,0,0,0,0
3,201392388,2170660915,58003,36895,2024-10-04 19:47:45,0,0,0,0,0,0
3,201392388,2170660915,49832,36895,2024-10-04 19:47:46,0,0,0,0,0,0
3,201392388,2170660915,0,0,2024-10-04 19:47:46,128,84,212,1,1,2
3,201392388,2170660915,55982,36895,2024-10-04 19:47:46,0,0,0,0,0,0
3,201392388,2170660915,58003,36895,2024-10-04 19:47:46,0,0,0,0,0,0
3,201392388,2170660915,0,0,2024-10-04 19:47:47,0,0,0,0,0,0
3,201392388,2170660915,55982,36895,2024-10-04 19:47:47,0,0,0,0,0,0
3,201392388,2170660915,58003,36895,2024-10-04 19:47:47,0,0,0,0,0,0
3,201392388,2170660915,0,0,2024-10-04 19:47:48,0,0,0,0,0,0
3,201392388,2170660915,55982,36895,2024-10-04 19:47:48,0,0,0,0,0,0
3,201392388,2170660915,58003,36895,2024-10-04 19:47:48,0,0,0,0,0,0
3,201392388,2170660915,0,0,2024-10-04 19:47:49,128,0,128,1,0,1
3,201392388,2170660915,55982,36895,2024-10-04 19:47:49,0,0,0,0,0,0
3,201392388,2170660915,58003,36895,2024-10-04 19:47:49,0,0,0,0,0,0
3,201392388,2170660915,0,0,2024-10-04 19:47:50,128,84,212,1,1,2
3,201392388,2170660915,55982,36895,2024-10-04 19:47:50,0,0,0,0,0,0
3,201392388,2170660915,58003,36895,2024-10-04 19:47:50,0,0,0,0,0,0
3,201392388,2170660915,0,0,2024-10-04 19:47:51,128,84,212,1,1,2
3,201392388,2170660915,55982,36895,2024-10-04 19:47:51,0,0,0,0,0,0
3,201392388,2170660915,58003,36895,2024-10-04 19:47:51,0,0,0,0,0,0
3,201392388,1145490690,15583,47873,2024-10-04 19:47:52,4454,58187,62641,35,49,84
3,201392388,2170660915,0,0,2024-10-04 19:47:52,0,84,84,0,1,1
3,201392388,2170660915,55982,36895,2024-10-04 19:47:52,0,0,0,0,0,0
3,201392388,2170660915,58003,36895,2024-10-04 19:47:52,0,0,0,0,0,0
3,201392388,1145490690,15583,47873,2024-10-04 19:47:53,0,0,0,0,0,0
3,201392388,2170660915,0,0,2024-10-04 19:47:53,0,0,0,0,0,0
3,201392388,2170660915,55982,36895,2024-10-04 19:47:53,0,0,0,0,0,0
3,201392388,2170660915,58003,36895,2024-10-04 19:47:53,0,0,0,0,0,0
3,201392388,1145490690,15583,47873,2024-10-04 19:47:54,2028,43161,45189,20,30,50
3,201392388,2170660915,0,0,2024-10-04 19:47:54,0,0,0,0,0,0
3,201392388,2170660915,55982,36895,2024-10-04 19:47:54,0,0,0,0,0,0
3,201392388,2170660915,58003,36895,2024-10-04 19:47:54,0,0,0,0,0,0
3,201392388,1145490690,15583,47873,2024-10-04 19:47:55,0,0,0,0,0,0
3,201392388,2170660915,0,0,2024-10-04 19:47:55,0,0,0,0,0,0
3,201392388,2170660915,55982,36895,2024-10-04 19:47:55,0,0,0,0,0,0
3,201392388,2170660915,58003,36895,2024-10-04 19:47:55,0,0,0,0,0,0
3,201392388,1145490690,15583,47873,2024-10-04 19:47:56,0,0,0,0,0,0
3,201392388,2170660915,0,0,2024-10-04 19:47:56,0,0,0,0,0,0
3,201392388,2170660915,55982,36895,2024-10-04 19:47:56,0,0,0,0,0,0
3,201392388,2170660915,58003,36895,2024-10-04 19:47:56,0,0,0,0,0,0
3,201392388,2170660915,0,0,2024-10-04 19:47:57,0,0,0,0,0,0
3,201392388,2170660915,55982,36895,2024-10-04 19:47:57,0,0,0,0,0,0
3,201392388,2170660915,58003,36895,2024-10-04 19:47:57,0,0,0,0,0,0
3,201392388,2170660915,0,0,2024-10-04 19:47:58,0,0,0,0,0,0
3,201392388,2170660915,55982,36895,2024-10-04 19:47:58,0,0,0,0,0,0
3,201392388,2170660915,58003,36895,2024-10-04 19:47:58,0,0,0,0,0,0
3,201392388,2170660915,0,0,2024-10-04 19:47:59,0,0,0,0,0,0
3,201392388,2170660915,55982,36895,2024-10-04 19:47:59,0,0,0,0,0,0
3,201392388,2170660915,58003,36895,2024-10-04 19:47:59,0,0,0,0,0,0
3,201392388,2170660915,0,0,2024-10-04 19:48:00,0,0,0,0,0,0
3,201392388,2170660915,55982,36895,2024-10-04 19:48:00,0,0,0,0,0,0
3,201392388,2170660915,58003,36895,2024-10-04 19:48:00,0,0,0,0,0,0
3,201392388,2170660915,0,0,2024-10-04 19:48:01,0,0,0,0,0,0
3,201392388,2170660915,55982,36895,2024-10-04 19:48:01,0,0,0,0,0,0
3,201392388,2170660915,58003,36895,2024-10-04 19:48:01,0,0,0,0,0,0
3,201392388,2170660915,0,0,2024-10-04 19:48:02,0,0,0,0,0,0
3,201392388,2170660915,55982,36895,2024-10-04 19:48:02,0,0,0,0,0,0
3,201392388,2170660915,58003,36895,2024-10-04 19:48:02,0,0,0,0,0,0
3,201392388,2170660915,0,0,2024-10-04 19:48:03,128,0,128,1,0,1
3,201392388,2170660915,55982,36895,2024-10-04 19:48:03,0,0,0,0,0,0
3,201392388,2170660915,58003,36895,2024-10-04 19:48:03,0,0,0,0,0,0
3,201392388,2170660915,0,0,2024-10-04 19:48:04,128,84,212,1,1,2
3,201392388,2170660915,55982,36895,2024-10-04 19:48:04,0,0,0,0,0,0
3,201392388,2170660915,58003,36895,2024-10-04 19:48:04,0,0,0,0,0,0
3,201392388,2170660915,0,0,2024-10-04 19:48:05,128,84,212,1,1,2
3,201392388,2170660915,55982,36895,2024-10-04 19:48:05,0,0,0,0,0,0
3,201392388,2170660915,58003,36895,2024-10-04 19:48:05,0,0,0,0,0,0
3,201392388,2170660915,0,0,2024-10-04 19:48:06,128,84,212,1,1,2
3,201392388,2170660915,55982,36895,2024-10-04 19:48:06,0,0,0,0,0,0
3,201392388,2170660915,58003,36895,2024-10-04 19:48:06,0,0,0,0,0,0
3,201392388,2170660915,0,0,2024-10-04 19:48:07,128,84,212,1,1,2
3,201392388,2170660915,55982,36895,2024-10-04 19:48:07,0,0,0,0,0,0
3,201392388,2170660915,58003,36895,2024-10-04 19:48:07,0,0,0,0,0,0
3,201392388,2170660915,0,0,2024-10-04 19:48:08,128,84,212,1,1,2
3,201392388,2170660915,55982,36895,2024-10-04 19:48:08,0,0,0,0,0,0
3,201392388,2170660915,58003,36895,2024-10-04 19:48:08,0,0,0,0,0,0
3,201392388,2170660915,0,0,2024-10-04 19:48:09,0,84,84,0,1,1
3,201392388,2170660915,55982,36895,2024-10-04 19:48:09,0,0,0,0,0,0
3,201392388,2170660915,58003,36895,2024-10-04 19:48:09,0,0,0,0,0,0
3,201392388,2170660915,0,0,2024-10-04 19:48:10,128,84,212,1,1,2
3,201392388,2170660915,55982,36895,2024-10-04 19:48:10,0,0,0,0,0,0
3,201392388,2170660915,58003,36895,2024-10-04 19:48:10,0,0,0,0,0,0
2,201392387,2170660915,0,0,2024-10-04 19:18:51,128,84,212,1,1,2
2,201392387,2170660915,0,0,2024-10-04 19:18:52,128,84,212,1,1,2
2,201392387,2170660915,0,0,2024-10-04 19:18:53,128,84,212,1,1,2
2,201392387,2170660915,0,0,2024-10-04 19:18:54,128,84,212,1,1,2
2,201392387,2170660915,0,0,2024-10-04 19:18:55,128,84,212,1,1,2
2,201392387,2170660915,0,0,2024-10-04 19:18:56,128,84,212,1,1,2
2,201392387,2170660915,0,0,2024-10-04 19:18:57,128,84,212,1,1,2
2,201392387,2170660915,0,0,2024-10-04 19:18:58,128,84,212,1,1,2
2,201392387,2170660915,0,0,2024-10-04 19:18:59,128,84,212,1,1,2
2,201392387,2170660915,0,0,2024-10-04 19:19:00,128,84,212,1,1,2
2,201392387,2170660915,0,0,2024-10-04 19:19:01,0,0,0,0,0,0
2,201392387,2170660915,22663,36895,2024-10-04 19:19:02,666,507,1173,6,6,12
2,201392387,2170660915,0,0,2024-10-04 19:19:02,0,0,0,0,0,0
2,201392387,2170660915,22663,36895,2024-10-04 19:19:03,0,0,0,0,0,0
2,201392387,2170660915,0,0,2024-10-04 19:19:03,128,84,212,1,1,2
2,201392387,2170660915,22663,36895,2024-10-04 19:19:04,0,0,0,0,0,0
2,201392387,2170660915,0,0,2024-10-04 19:19:04,128,84,212,1,1,2
2,201392387,2170660915,22663,36895,2024-10-04 19:19:05,0,0,0,0,0,0
2,201392387,2170660915,0,0,2024-10-04 19:19:05,128,84,212,1,1,2
2,201392387,2170660915,22663,36895,2024-10-04 19:19:06,0,0,0,0,0,0
2,201392387,2170660915,0,0,2024-10-04 19:19:06,0,0,0,0,0,0
2,201392387,2170660915,22663,36895,2024-10-04 19:19:07,0,0,0,0,0,0
2,201392387,2170660915,0,0,2024-10-04 19:19:07,0,0,0,0,0,0
2,201392387,2170660915,22663,36895,2024-10-04 19:19:08,0,0,0,0,0,0
2,201392387,2170660915,0,0,2024-10-04 19:19:08,128,84,212,1,1,2
2,201392387,2170660915,22663,36895,2024-10-04 19:19:09,0,0,0,0,0,0
2,201392387,2170660915,0,0,2024-10-04 19:19:09,128,84,212,1,1,2
2,201392387,2170660915,22663,36895,2024-10-04 19:19:10,0,0,0,0,0,0
2,201392387,1145490692,54412,47873,2024-10-04 19:19:10,3844,52273,56117,29,43,72
2,201392387,2170660915,0,0,2024-10-04 19:19:10,128,84,212,1,1,2
2,201392387,2170660915,22663,36895,2024-10-04 19:19:11,0,0,0,0,0,0
2,201392387,1145490692,54412,47873,2024-10-04 19:19:11,1368,32698,34066,14,20,34
2,201392387,2170660915,0,0,2024-10-04 19:19:11,0,0,0,0,0,0
2,201392387,2170660915,22663,36895,2024-10-04 19:19:12,0,0,0,0,0,0
2,201392387,1145490692,54412,47873,2024-10-04 19:19:12,1896,26557,28453,19,21,40
2,201392387,2170660915,0,0,2024-10-04 19:19:12,0,0,0,0,0,0
2,201392387,2170660915,22663,36895,2024-10-04 19:19:13,0,0,0,0,0,0
2,201392387,1145490692,54412,47873,2024-10-04 19:19:13,0,0,0,0,0,0
2,201392387,2170660915,0,0,2024-10-04 19:19:13,0,0,0,0,0,0
2,201392387,2170660915,22663,36895,2024-10-04 19:19:14,0,0,0,0,0,0
2,201392387,1145490692,54412,47873,2024-10-04 19:19:14,0,0,0,0,0,0
2,201392387,2170660915,0,0,2024-10-04 19:19:14,0,0,0,0,0,0
2,201392387,2170660915,22663,36895,2024-10-04 19:19:15,0,0,0,0,0,0
2,201392387,1145490692,54412,47873,2024-10-04 19:19:15,0,0,0,0,0,0
2,201392387,2170660915,0,0,2024-10-04 19:19:15,0,0,0,0,0,0
2,201392387,2170660915,22663,36895,2024-10-04 19:19:16,0,0,0,0,0,0
2,201392387,1145490692,54412,47873,2024-10-04 19:19:16,0,0,0,0,0,0
2,201392387,2170660915,0,0,2024-10-04 19:19:16,0,0,0,0,0,0
2,201392387,2170660915,22663,36895,2024-10-04 19:19:17,0,0,0,0,0,0
2,201392387,1145490692,54412,47873,2024-10-04 19:19:17,0,0,0,0,0,0
2,201392387,2170660915,0,0,2024-10-04 19:19:17,0,0,0,0,0,0
2,201392387,2170660915,22663,36895,2024-10-04 19:19:18,0,0,0,0,0,0
2,201392387,1145490692,54412,47873,2024-10-04 19:19:18,0,0,0,0,0,0
2,201392387,2170660915,0,0,2024-10-04 19:19:18,0,0,0,0,0,0
2,201392387,2170660915,22663,36895,2024-10-04 19:19:19,0,0,0,0,0,0
2,201392387,1145490692,54412,47873,2024-10-04 19:19:19,0,0,0,0,0,0
2,201392387,2170660915,0,0,2024-10-04 19:19:19,0,0,0,0,0,0
2,201392387,2170660915,22663,36895,2024-10-04 19:19:20,0,0,0,0,0,0
2,201392387,1145490692,54412,47873,2024-10-04 19:19:20,0,0,0,0,0,0
2,201392387,2170660915,0,0,2024-10-04 19:19:20,0,0,0,0,0,0
2,201392387,2170660915,22663,36895,2024-10-04 19:19:21,0,0,0,0,0,0
2,201392387,1145490692,54412,47873,2024-10-04 19:19:21,0,0,0,0,0,0
2,201392387,2170660915,0,0,2024-10-04 19:19:21,0,0,0,0,0,0
2,201392387,2170660915,22663,36895,2024-10-04 19:19:22,0,0,0,0,0,0
2,201392387,1145490692,54412,47873,2024-10-04 19:19:22,0,0,0,0,0,0
2,201392387,2170660915,0,0,2024-10-04 19:19:22,0,0,0,0,0,0
2,201392387,2170660915,22663,36895,2024-10-04 19:19:23,0,0,0,0,0,0
2,201392387,1145490692,54412,47873,2024-10-04 19:19:23,0,0,0,0,0,0
2,201392387,2170660915,0,0,2024-10-04 19:19:23,256,168,424,2,2,4
2,201392387,2170660915,22663,36895,2024-10-04 19:19:24,0,0,0,0,0,0
2,201392387,1145490692,54412,47873,2024-10-04 19:19:24,0,0,0,0,0,0
2,201392387,2170660915,0,0,2024-10-04 19:19:24,0,0,0,0,0,0
2,201392387,2170660915,22663,36895,2024-10-04 19:19:25,0,0,0,0,0,0
2,201392387,1145490692,54412,47873,2024-10-04 19:19:25,0,0,0,0,0,0
2,201392387,2170660915,0,0,2024-10-04 19:19:25,128,84,212,1,1,2
2,201392387,2170660915,22663,36895,2024-10-04 19:19:26,0,0,0,0,0,0
2,201392387,1145490692,54412,47873,2024-10-04 19:19:26,0,0,0,0,0,0
2,201392387,2170660915,0,0,2024-10-04 19:19:26,128,84,212,1,1,2
2,201392387,2170660915,22663,36895,2024-10-04 19:19:27,0,0,0,0,0,0
2,201392387,1145490692,54412,47873,2024-10-04 19:19:27,0,0,0,0,0,0
2,201392387,2170660915,0,0,2024-10-04 19:19:27,128,84,212,1,1,2
2,201392387,2170660915,22663,36895,2024-10-04 19:19:28,0,0,0,0,0,0
2,201392387,1145490692,54412,47873,2024-10-04 19:19:28,0,0,0,0,0,0
2,201392387,2170660915,0,0,2024-10-04 19:19:28,128,84,212,1,1,2
2,201392387,2170660915,22663,36895,2024-10-04 19:19:29,0,0,0,0,0,0
2,201392387,1145490692,54412,47873,2024-10-04 19:19:29,0,0,0,0,0,0
2,201392387,2170660915,0,0,2024-10-04 19:19:29,128,84,212,1,1,2
2,201392387,2170660915,22663,36895,2024-10-04 19:19:30,0,0,0,0,0,0
2,201392387,1145490692,54412,47873,2024-10-04 19:19:30,0,0,0,0,0,0
2,201392387,2170660915,0,0,2024-10-04 19:19:30,128,84,212,1,1,2
2,201392387,2170660915,22663,36895,2024-10-04 19:19:31,0,0,0,0,0,0
2,201392387,1145490692,54412,47873,2024-10-04 19:19:31,0,0,0,0,0,0
2,201392387,2170660915,0,0,2024-10-04 19:19:31,128,84,212,1,1,2
2,201392387,2170660915,22663,36895,2024-10-04 19:19:32,0,0,0,0,0,0
2,201392387,1145490692,54412,47873,2024-10-04 19:19:32,0,0,0,0,0,0
2,201392387,2170660915,0,0,2024-10-04 19:19:32,128,84,212,1,1,2
2,201392387,2170660915,22663,36895,2024-10-04 19:19:33,0,0,0,0,0,0
2,201392387,2170660915,11496,36895,2024-10-04 19:19:33,666,507,1173,6,6,12
2,201392387,2170660915,0,0,2024-10-04 19:19:33,0,0,0,0,0,0
2,201392387,2170660915,22663,36895,2024-10-04 19:19:34,0,0,0,0,0,0
2,201392387,2170660915,11496,36895,2024-10-04 19:19:34,0,0,0,0,0,0
2,201392387,2170660915,0,0,2024-10-04 19:19:34,0,0,0,0,0,0
2,201392387,2170660915,22663,36895,2024-10-04 19:19:35,0,0,0,0,0,0
2,201392387,2170660915,11496,36895,2024-10-04 19:19:35,0,0,0,0,0,0
2,201392387,2170660915,0,0,2024-10-04 19:19:35,128,84,212,1,1,2
2,201392387,2170660915,22663,36895,2024-10-04 19:19:36,0,0,0,0,0,0
2,201392387,2170660915,11496,36895,2024-10-04 19:19:36,0,0,0,0,0,0
2,201392387,2170660915,0,0,2024-10-04 19:19:36,128,84,212,1,1,2
2,201392387,2170660915,22663,36895,2024-10-04 19:19:37,0,0,0,0,0,0
2,201392387,2170660915,11496,36895,2024-10-04 19:19:37,0,0,0,0,0,0
2,201392387,2170660915,0,0,2024-10-04 19:19:37,128,84,212,1,1,2
2,201392387,2170660915,22663,36895,2024-10-04 19:19:38,0,0,0,0,0,0
2,201392387,2170660915,11496,36895,2024-10-04 19:19:38,0,0,0,0,0,0
2,201392387,2170660915,0,0,2024-10-04 19:19:38,0,0,0,0,0,0
2,201392387,2170660915,22663,36895,2024-10-04 19:19:39,0,0,0,0,0,0
2,201392387,2170660915,11496,36895,2024-10-04 19:19:39,0,0,0,0,0,0
2,201392387,2170660915,0,0,2024-10-04 19:19:39,0,0,0,0,0,0
2,201392387,2170660915,22663,36895,2024-10-04 19:19:40,0,0,0,0,0,0
2,201392387,2170660915,11496,36895,2024-10-04 19:19:40,0,0,0,0,0,0
2,201392387,2170660915,0,0,2024-10-04 19:19:40,128,84,212,1,1,2
2,201392387,2170660915,22663,36895,2024-10-04 19:19:41,0,0,0,0,0,0
2,201392387,2170660915,11496,36895,2024-10-04 19:19:41,0,0,0,0,0,0
2,201392387,2170660915,0,0,2024-10-04 19:19:41,128,84,212,1,1,2
2,201392387,1145490689,691,47873,2024-10-04 19:19:42,3404,44293,47697,25,36,61
2,201392387,2170660915,22663,36895,2024-10-04 19:19:42,0,0,0,0,0,0
2,201392387,2170660915,11496,36895,2024-10-04 19:19:42,0,0,0,0,0,0
2,201392387,2170660915,0,0,2024-10-04 19:19:42,128,84,212,1,1,2
2,201392387,1145490689,691,47873,2024-10-04 19:19:43,2988,59678,62666,30,39,69
2,201392387,2170660915,22663,36895,2024-10-04 19:19:43,0,0,0,0,0,0
2,201392387,2170660915,11496,36895,2024-10-04 19:19:43,0,0,0,0,0,0
2,201392387,2170660915,0,0,2024-10-04 19:19:43,0,0,0,0,0,0
2,201392387,1145490689,691,47873,2024-10-04 19:19:44,0,0,0,0,0,0
2,201392387,2170660915,22663,36895,2024-10-04 19:19:44,0,0,0,0,0,0
2,201392387,2170660915,11496,36895,2024-10-04 19:19:44,0,0,0,0,0,0
2,201392387,2170660915,0,0,2024-10-04 19:19:44,0,0,0,0,0,0
2,201392387,1145490689,691,47873,2024-10-04 19:19:45,0,0,0,0,0,0
2,201392387,2170660915,22663,36895,2024-10-04 19:19:45,0,0,0,0,0,0
2,201392387,2170660915,11496,36895,2024-10-04 19:19:45,0,0,0,0,0,0
2,201392387,2170660915,0,0,2024-10-04 19:19:45,0,0,0,0,0,0
2,201392387,1145490689,691,47873,2024-10-04 19:19:46,0,0,0,0,0,0
2,201392387,2170660915,22663,36895,2024-10-04 19:19:46,0,0,0,0,0,0
2,201392387,2170660915,11496,36895,2024-10-04 19:19:46,0,0,0,0,0,0
2,201392387,2170660915,0,0,2024-10-04 19:19:46,0,0,0,0,0,0
2,201392387,1145490689,691,47873,2024-10-04 19:19:47,0,0,0,0,0,0
2,201392387,2170660915,22663,36895,2024-10-04 19:19:47,0,0,0,0,0,0
2,201392387,2170660915,11496,36895,2024-10-04 19:19:47,0,0,0,0,0,0
2,201392387,2170660915,0,0,2024-10-04 19:19:47,0,0,0,0,0,0
2,201392387,1145490689,691,47873,2024-10-04 19:19:48,0,0,0,0,0,0
2,201392387,2170660915,22663,36895,2024-10-04 19:19:48,0,0,0,0,0,0
2,201392387,2170660915,11496,36895,2024-10-04 19:19:48,0,0,0,0,0,0
2,201392387,2170660915,0,0,2024-10-04 19:19:48,0,0,0,0,0,0
2,201392387,1145490689,691,47873,2024-10-04 19:19:49,0,0,0,0,0,0
2,201392387,2170660915,22663,36895,2024-10-04 19:19:49,0,0,0,0,0,0
2,201392387,2170660915,11496,36895,2024-10-04 19:19:49,0,0,0,0,0,0
2,201392387,2170660915,0,0,2024-10-04 19:19:49,0,0,0,0,0,0
2,201392387,1145490689,691,47873,2024-10-04 19:19:50,0,0,0,0,0,0
2,201392387,2170660915,22663,36895,2024-10-04 19:19:50,0,0,0,0,0,0
2,201392387,2170660915,11496,36895,2024-10-04 19:19:50,0,0,0,0,0,0
2,201392387,2170660915,0,0,2024-10-04 19:19:50,0,0,0,0,0,0
2,201392387,1145490689,691,47873,2024-10-04 19:19:51,0,0,0,0,0,0
2,201392387,2170660915,22663,36895,2024-10-04 19:19:51,0,0,0,0,0,0
2,201392387,2170660915,11496,36895,2024-10-04 19:19:51,0,0,0,0,0,0
2,201392387,2170660915,0,0,2024-10-04 19:19:51,0,0,0,0,0,0
2,201392387,1145490689,691,47873,2024-10-04 19:19:52,720,5397,6117,7,6,13
2,201392387,2170660915,22663,36895,2024-10-04 19:19:52,0,0,0,0,0,0
2,201392387,2170660915,11496,36895,2024-10-04 19:19:52,0,0,0,0,0,0
2,201392387,2170660915,0,0,2024-10-04 19:19:52,0,0,0,0,0,0
2,201392387,1145490689,691,47873,2024-10-04 19:19:53,0,0,0,0,0,0
2,201392387,2170660915,22663,36895,2024-10-04 19:19:53,0,0,0,0,0,0
2,201392387,2170660915,11496,36895,2024-10-04 19:19:53,0,0,0,0,0,0
2,201392387,2170660915,0,0,2024-10-04 19:19:53,128,0,128,1,0,1
2,201392387,1145490689,691,47873,2024-10-04 19:19:54,0,0,0,0,0,0
2,201392387,2170660915,22663,36895,2024-10-04 19:19:54,0,0,0,0,0,0
2,201392387,2170660915,11496,36895,2024-10-04 19:19:54,0,0,0,0,0,0
2,201392387,2170660915,0,0,2024-10-04 19:19:54,128,84,212,1,1,2
2,201392387,1145490689,691,47873,2024-10-04 19:19:55,0,0,0,0,0,0
2,201392387,2170660915,22663,36895,2024-10-04 19:19:55,0,0,0,0,0,0
2,201392387,2170660915,11496,36895,2024-10-04 19:19:55,0,0,0,0,0,0
2,201392387,2170660915,0,0,2024-10-04 19:19:55,128,84,212,1,1,2
2,201392387,1145490689,691,47873,2024-10-04 19:19:56,0,0,0,0,0,0
2,201392387,2170660915,22663,36895,2024-10-04 19:19:56,0,0,0,0,0,0
2,201392387,2170660915,11496,36895,2024-10-04 19:19:56,0,0,0,0,0,0
2,201392387,2170660915,0,0,2024-10-04 19:19:56,128,84,212,1,1,2
2,201392387,1145490689,691,47873,2024-10-04 19:19:57,0,0,0,0,0,0
2,201392387,2170660915,22663,36895,2024-10-04 19:19:57,0,0,0,0,0,0
2,201392387,2170660915,11496,36895,2024-10-04 19:19:57,0,0,0,0,0,0
2,201392387,2170660915,0,0,2024-10-04 19:19:57,128,84,212,1,1,2
2,201392387,1145490689,691,47873,2024-10-04 19:19:58,0,0,0,0,0,0
2,201392387,2170660915,22663,36895,2024-10-04 19:19:58,0,0,0,0,0,0
2,201392387,2170660915,11496,36895,2024-10-04 19:19:58,0,0,0,0,0,0
2,201392387,2170660915,0,0,2024-10-04 19:19:58,128,84,212,1,1,2
2,201392387,1145490689,691,47873,2024-10-04 19:19:59,0,0,0,0,0,0
2,201392387,2170660915,22663,36895,2024-10-04 19:19:59,0,0,0,0,0,0
2,201392387,2170660915,11496,36895,2024-10-04 19:19:59,0,0,0,0,0,0
2,201392387,2170660915,0,0,2024-10-04 19:19:59,128,84,212,1,1,2
2,201392387,1145490689,691,47873,2024-10-04 19:20:00,0,0,0,0,0,0
2,201392387,2170660915,22663,36895,2024-10-04 19:20:00,0,0,0,0,0,0
2,201392387,2170660915,11496,36895,2024-10-04 19:20:00,0,0,0,0,0,0
2,201392387,2170660915,0,0,2024-10-04 19:20:00,128,84,212,1,1,2
2,201392387,1145490689,691,47873,2024-10-04 19:20:01,0,0,0,0,0,0
2,201392387,2170660915,22663,36895,2024-10-04 19:20:01,0,0,0,0,0,0
2,201392387,2170660915,11496,36895,2024-10-04 19:20:01,0,0,0,0,0,0
2,201392387,2170660915,0,0,2024-10-04 19:20:01,128,84,212,1,1,2
2,201392387,1145490689,691,47873,2024-10-04 19:20:02,0,0,0,0,0,0
2,201392387,2170660915,22663,36895,2024-10-04 19:20:02,0,0,0,0,0,0
2,201392387,2170660915,11496,36895,2024-10-04 19:20:02,0,0,0,0,0,0
2,201392387,2170660915,0,0,2024-10-04 19:20:02,128,84,212,1,1,2
2,201392387,1145490689,691,47873,2024-10-04 19:20:03,0,0,0,0,0,0
2,201392387,2170660915,22663,36895,2024-10-04 19:20:03,0,0,0,0,0,0
2,201392387,2170660915,11496,36895,2024-10-04 19:20:03,0,0,0,0,0,0
2,201392387,2170660915,0,0,2024-10-04 19:20:03,0,84,84,0,1,1
2,201392387,2170660915,39639,36895,2024-10-04 19:20:04,666,507,1173,6,6,12
2,201392387,2170660915,22663,36895,2024-10-04 19:20:04,0,0,0,0,0,0
2,201392387,2170660915,11496,36895,2024-10-04 19:20:04,0,0,0,0,0,0
2,201392387,2170660915,0,0,2024-10-04 19:20:04,0,0,0,0,0,0
2,201392387,2170660915,39639,36895,2024-10-04 19:20:05,0,0,0,0,0,0
2,201392387,2170660915,22663,36895,2024-10-04 19:20:05,0,0,0,0,0,0
2,201392387,2170660915,0,0,2024-10-04 19:20:05,128,84,212,1,1,2
2,201392387,2170660915,39639,36895,2024-10-04 19:20:06,0,0,0,0,0,0
2,201392387,2170660915,22663,36895,2024-10-04 19:20:06,0,0,0,0,0,0
2,201392387,2170660915,0,0,2024-10-04 19:20:06,128,84,212,1,1,2
2,201392387,2170660915,39639,36895,2024-10-04 19:20:07,0,0,0,0,0,0
2,201392387,2170660915,22663,36895,2024-10-04 19:20:07,0,0,0,0,0,0
2,201392387,2170660915,0,0,2024-10-04 19:20:07,128,84,212,1,1,2
2,201392387,2170660915,39639,36895,2024-10-04 19:20:08,0,0,0,0,0,0
2,201392387,2170660915,22663,36895,2024-10-04 19:20:08,0,0,0,0,0,0
2,201392387,2170660915,0,0,2024-10-04 19:20:08,0,0,0,0,0,0
2,201392387,2170660915,39639,36895,2024-10-04 19:20:09,0,0,0,0,0,0
2,201392387,2170660915,22663,36895,2024-10-04 19:20:09,0,0,0,0,0,0
2,201392387,2170660915,0,0,2024-10-04 19:20:09,0,0,0,0,0,0
2,201392387,2170660915,39639,36895,2024-10-04 19:20:10,0,0,0,0,0,0
2,201392387,2170660915,22663,36895,2024-10-04 19:20:10,0,0,0,0,0,0
2,201392387,2170660915,0,0,2024-10-04 19:20:10,128,0,128,1,0,1
2,201392387,2170660915,39639,36895,2024-10-04 19:20:11,0,0,0,0,0,0
2,201392387,2170660915,22663,36895,2024-10-04 19:20:11,0,0,0,0,0,0
2,201392387,2170660915,0,0,2024-10-04 19:20:11,128,84,212,1,1,2
2,201392387,2170660915,39639,36895,2024-10-04 19:20:12,0,0,0,0,0,0
2,201392387,2170660915,22663,36895,2024-10-04 19:20:12,0,0,0,0,0,0
2,201392387,2170660915,0,0,2024-10-04 19:20:12,0,84,84,0,1,1
2,201392387,2170660915,39639,36895,2024-10-04 19:20:13,0,0,0,0,0,0
2,201392387,2170660915,22663,36895,2024-10-04 19:20:13,0,0,0,0,0,0
2,201392387,1145490689,25758,47873,2024-10-04 19:20:13,3284,45713,48997,24,37,61
2,201392387,2170660915,0,0,2024-10-04 19:20:13,128,84,212,1,1,2
2,201392387,2170660915,39639,36895,2024-10-04 19:20:14,0,0,0,0,0,0
2,201392387,2170660915,22663,36895,2024-10-04 19:20:14,0,0,0,0,0,0
2,201392387,1145490689,25758,47873,2024-10-04 19:20:14,3228,61673,64901,32,44,76
2,201392387,2170660915,0,0,2024-10-04 19:20:14,0,0,0,0,0,0
2,201392387,2170660915,39639,36895,2024-10-04 19:20:15,0,0,0,0,0,0
2,201392387,2170660915,22663,36895,2024-10-04 19:20:15,0,0,0,0,0,0
2,201392387,1145490689,25758,47873,2024-10-04 19:20:15,0,0,0,0,0,0
2,201392387,2170660915,0,0,2024-10-04 19:20:15,0,0,0,0,0,0
2,201392387,2170660915,39639,36895,2024-10-04 19:20:16,0,0,0,0,0,0
2,201392387,2170660915,22663,36895,2024-10-04 19:20:16,0,0,0,0,0,0
2,201392387,1145490689,25758,47873,2024-10-04 19:20:16,0,0,0,0,0,0
2,201392387,2170660915,0,0,2024-10-04 19:20:16,0,0,0,0,0,0
2,201392387,2170660915,39639,36895,2024-10-04 19:20:17,0,0,0,0,0,0
2,201392387,2170660915,22663,36895,2024-10-04 19:20:17,0,0,0,0,0,0
2,201392387,1145490689,25758,47873,2024-10-04 19:20:17,0,0,0,0,0,0
2,201392387,2170660915,0,0,2024-10-04 19:20:17,0,0,0,0,0,0
2,201392387,2170660915,39639,36895,2024-10-04 19:20:18,0,0,0,0,0,0
2,201392387,2170660915,22663,36895,2024-10-04 19:20:18,0,0,0,0,0,0
2,201392387,1145490689,25758,47873,2024-10-04 19:20:18,0,0,0,0,0,0
2,201392387,2170660915,0,0,2024-10-04 19:20:18,0,0,0,0,0,0
2,201392387,2170660915,39639,36895,2024-10-04 19:20:19,0,0,0,0,0,0
2,201392387,2170660915,22663,36895,2024-10-04 19:20:19,0,0,0,0,0,0
2,201392387,1145490689,25758,47873,2024-10-04 19:20:19,0,0,0,0,0,0
2,201392387,2170660915,0,0,2024-10-04 19:20:19,0,0,0,0,0,0
2,201392387,2170660915,39639,36895,2024-10-04 19:20:20,0,0,0,0,0,0
2,201392387,2170660915,22663,36895,2024-10-04 19:20:20,0,0,0,0,0,0
2,201392387,1145490689,25758,47873,2024-10-04 19:20:20,0,0,0,0,0,0
2,201392387,2170660915,0,0,2024-10-04 19:20:20,0,0,0,0,0,0
2,201392387,2170660915,39639,36895,2024-10-04 19:20:21,0,0,0,0,0,0
2,201392387,2170660915,22663,36895,2024-10-04 19:20:21,0,0,0,0,0,0
2,201392387,1145490689,25758,47873,2024-10-04 19:20:21,0,0,0,0,0,0
2,201392387,2170660915,0,0,2024-10-04 19:20:21,0,0,0,0,0,0
2,201392387,2170660915,39639,36895,2024-10-04 19:20:22,0,0,0,0,0,0
2,201392387,2170660915,22663,36895,2024-10-04 19:20:22,0,0,0,0,0,0
2,201392387,1145490689,25758,47873,2024-10-04 19:20:22,0,0,0,0,0,0
2,201392387,2170660915,0,0,2024-10-04 19:20:22,0,0,0,0,0,0
2,201392387,2170660915,39639,36895,2024-10-04 19:20:23,0,0,0,0,0,0
2,201392387,2170660915,22663,36895,2024-10-04 19:20:23,0,0,0,0,0,0
2,201392387,1145490689,25758,47873,2024-10-04 19:20:23,0,0,0,0,0,0
2,201392387,2170660915,0,0,2024-10-04 19:20:23,0,0,0,0,0,0
2,201392387,2170660915,39639,36895,2024-10-04 19:20:24,0,0,0,0,0,0
2,201392387,2170660915,22663,36895,2024-10-04 19:20:24,0,0,0,0,0,0
2,201392387,1145490689,25758,47873,2024-10-04 19:20:24,0,0,0,0,0,0
2,201392387,2170660915,0,0,2024-10-04 19:20:24,128,84,212,1,1,2
2,201392387,2170660915,39639,36895,2024-10-04 19:20:25,0,0,0,0,0,0
2,201392387,2170660915,22663,36895,2024-10-04 19:20:25,0,0,0,0,0,0
2,201392387,1145490689,25758,47873,2024-10-04 19:20:25,0,0,0,0,0,0
2,201392387,2170660915,0,0,2024-10-04 19:20:25,128,84,212,1,1,2
2,201392387,2170660915,39639,36895,2024-10-04 19:20:26,0,0,0,0,0,0
2,201392387,2170660915,22663,36895,2024-10-04 19:20:26,0,0,0,0,0,0
2,201392387,1145490689,25758,47873,2024-10-04 19:20:26,0,0,0,0,0,0
2,201392387,2170660915,0,0,2024-10-04 19:20:26,128,84,212,1,1,2
2,201392387,2170660915,39639,36895,2024-10-04 19:20:27,0,0,0,0,0,0
2,201392387,2170660915,22663,36895,2024-10-04 19:20:27,0,0,0,0,0,0
2,201392387,1145490689,25758,47873,2024-10-04 19:20:27,0,0,0,0,0,0
2,201392387,2170660915,0,0,2024-10-04 19:20:27,128,84,212,1,1,2
2,201392387,2170660915,39639,36895,2024-10-04 19:20:28,0,0,0,0,0,0
2,201392387,2170660915,22663,36895,2024-10-04 19:20:28,0,0,0,0,0,0
2,201392387,1145490689,25758,47873,2024-10-04 19:20:28,0,0,0,0,0,0
2,201392387,2170660915,0,0,2024-10-04 19:20:28,128,84,212,1,1,2
2,201392387,2170660915,39639,36895,2024-10-04 19:20:29,0,0,0,0,0,0
2,201392387,2170660915,22663,36895,2024-10-04 19:20:29,0,0,0,0,0,0
2,201392387,1145490689,25758,47873,2024-10-04 19:20:29,0,0,0,0,0,0
2,201392387,2170660915,0,0,2024-10-04 19:20:29,128,84,212,1,1,2
2,201392387,2170660915,39639,36895,2024-10-04 19:20:30,0,0,0,0,0,0
2,201392387,2170660915,22663,36895,2024-10-04 19:20:30,0,0,0,0,0,0
2,201392387,1145490689,25758,47873,2024-10-04 19:20:30,0,0,0,0,0,0
2,201392387,2170660915,0,0,2024-10-04 19:20:30,128,84,212,1,1,2
2,201392387,2170660915,39639,36895,2024-10-04 19:20:31,0,0,0,0,0,0
2,201392387,2170660915,22663,36895,2024-10-04 19:20:31,0,0,0,0,0,0
2,201392387,1145490689,25758,47873,2024-10-04 19:20:31,0,0,0,0,0,0
2,201392387,2170660915,0,0,2024-10-04 19:20:31,128,84,212,1,1,2
2,201392387,2170660915,39639,36895,2024-10-04 19:20:32,0,0,0,0,0,0
2,201392387,2170660915,22663,36895,2024-10-04 19:20:32,0,0,0,0,0,0
2,201392387,1145490689,25758,47873,2024-10-04 19:20:32,0,0,0,0,0,0
2,201392387,2170660915,0,0,2024-10-04 19:20:32,128,84,212,1,1,2
2,201392387,2170660915,39639,36895,2024-10-04 19:20:33,0,0,0,0,0,0
2,201392387,2170660915,22663,36895,2024-10-04 19:20:33,0,0,0,0,0,0
2,201392387,1145490689,25758,47873,2024-10-04 19:20:33,0,0,0,0,0,0
2,201392387,2170660915,0,0,2024-10-04 19:20:33,128,0,128,1,0,1
2,201392387,2170660915,39639,36895,2024-10-04 19:20:34,0,0,0,0,0,0
2,201392387,2170660915,22663,36895,2024-10-04 19:20:34,0,0,0,0,0,0
2,201392387,2170660915,0,0,2024-10-04 19:20:34,0,84,84,0,1,1
2,201392387,2170660915,39639,36895,2024-10-04 19:20:35,0,0,0,0,0,0
2,201392387,2170660915,22663,36895,2024-10-04 19:20:35,0,0,0,0,0,0
2,201392387,2170660915,45740,36895,2024-10-04 19:20:35,666,507,1173,6,6,12
2,201392387,2170660915,0,0,2024-10-04 19:20:35,0,0,0,0,0,0
2,201392387,2170660915,39639,36895,2024-10-04 19:20:36,0,0,0,0,0,0
2,201392387,2170660915,22663,36895,2024-10-04 19:20:36,0,0,0,0,0,0
2,201392387,2170660915,45740,36895,2024-10-04 19:20:36,0,0,0,0,0,0
2,201392387,2170660915,0,0,2024-10-04 19:20:36,128,84,212,1,1,2
2,201392387,2170660915,39639,36895,2024-10-04 19:20:37,0,0,0,0,0,0
2,201392387,2170660915,22663,36895,2024-10-04 19:20:37,0,0,0,0,0,0
2,201392387,2170660915,45740,36895,2024-10-04 19:20:37,0,0,0,0,0,0
2,201392387,2170660915,0,0,2024-10-04 19:20:37,128,84,212,1,1,2
2,201392387,2170660915,39639,36895,2024-10-04 19:20:38,0,0,0,0,0,0
2,201392387,2170660915,22663,36895,2024-10-04 19:20:38,0,0,0,0,0,0
2,201392387,2170660915,45740,36895,2024-10-04 19:20:38,0,0,0,0,0,0
2,201392387,2170660915,0,0,2024-10-04 19:20:38,128,84,212,1,1,2
2,201392387,2170660915,39639,36895,2024-10-04 19:20:39,0,0,0,0,0,0
2,201392387,2170660915,22663,36895,2024-10-04 19:20:39,0,0,0,0,0,0
2,201392387,2170660915,45740,36895,2024-10-04 19:20:39,0,0,0,0,0,0
2,201392387,2170660915,0,0,2024-10-04 19:20:39,0,0,0,0,0,0
2,201392387,2170660915,39639,36895,2024-10-04 19:20:40,0,0,0,0,0,0
2,201392387,2170660915,22663,36895,2024-10-04 19:20:40,0,0,0,0,0,0
2,201392387,2170660915,45740,36895,2024-10-04 19:20:40,0,0,0,0,0,0
2,201392387,2170660915,0,0,2024-10-04 19:20:40,0,0,0,0,0,0
2,201392387,2170660915,39639,36895,2024-10-04 19:20:41,0,0,0,0,0,0
2,201392387,2170660915,22663,36895,2024-10-04 19:20:41,0,0,0,0,0,0
2,201392387,2170660915,45740,36895,2024-10-04 19:20:41,0,0,0,0,0,0
2,201392387,2170660915,0,0,2024-10-04 19:20:41,128,0,128,1,0,1
2,201392387,2170660915,39639,36895,2024-10-04 19:20:42,0,0,0,0,0,0
2,201392387,2170660915,22663,36895,2024-10-04 19:20:42,0,0,0,0,0,0
2,201392387,2170660915,45740,36895,2024-10-04 19:20:42,0,0,0,0,0,0
2,201392387,2170660915,0,0,2024-10-04 19:20:42,128,84,212,1,1,2
2,201392387,2170660915,39639,36895,2024-10-04 19:20:43,0,0,0,0,0,0
2,201392387,2170660915,22663,36895,2024-10-04 19:20:43,0,0,0,0,0,0
2,201392387,2170660915,45740,36895,2024-10-04 19:20:43,0,0,0,0,0,0
2,201392387,2170660915,0,0,2024-10-04 19:20:43,128,84,212,1,1,2
2,201392387,2170660915,39639,36895,2024-10-04 19:20:44,0,0,0,0,0,0
2,201392387,2170660915,22663,36895,2024-10-04 19:20:44,0,0,0,0,0,0
2,201392387,2170660915,45740,36895,2024-10-04 19:20:44,0,0,0,0,0,0
2,201392387,1145490692,53916,47873,2024-10-04 19:20:44,6336,97216,103552,52,76,128
2,201392387,2170660915,0,0,2024-10-04 19:20:44,0,84,84,0,1,1
2,201392387,2170660915,39639,36895,2024-10-04 19:20:45,0,0,0,0,0,0
2,201392387,2170660915,22663,36895,2024-10-04 19:20:45,0,0,0,0,0,0
2,201392387,2170660915,45740,36895,2024-10-04 19:20:45,0,0,0,0,0,0
2,201392387,1145490692,53916,47873,2024-10-04 19:20:45,0,0,0,0,0,0
2,201392387,2170660915,0,0,2024-10-04 19:20:45,0,0,0,0,0,0
2,201392387,2170660915,39639,36895,2024-10-04 19:20:46,0,0,0,0,0,0
2,201392387,2170660915,22663,36895,2024-10-04 19:20:46,0,0,0,0,0,0
2,201392387,2170660915,45740,36895,2024-10-04 19:20:46,0,0,0,0,0,0
2,201392387,1145490692,53916,47873,2024-10-04 19:20:46,0,0,0,0,0,0
2,201392387,2170660915,0,0,2024-10-04 19:20:46,0,0,0,0,0,0
2,201392387,2170660915,39639,36895,2024-10-04 19:20:47,0,0,0,0,0,0
2,201392387,2170660915,22663,36895,2024-10-04 19:20:47,0,0,0,0,0,0
2,201392387,2170660915,45740,36895,2024-10-04 19:20:47,0,0,0,0,0,0
2,201392387,1145490692,53916,47873,2024-10-04 19:20:47,0,0,0,0,0,0
2,201392387,2170660915,0,0,2024-10-04 19:20:47,0,0,0,0,0,0
2,201392387,2170660915,39639,36895,2024-10-04 19:20:48,0,0,0,0,0,0
2,201392387,2170660915,22663,36895,2024-10-04 19:20:48,0,0,0,0,0,0
2,201392387,2170660915,45740,36895,2024-10-04 19:20:48,0,0,0,0,0,0
2,201392387,1145490692,53916,47873,2024-10-04 19:20:48,0,0,0,0,0,0
2,201392387,2170660915,0,0,2024-10-04 19:20:48,0,0,0,0,0,0
2,201392387,2170660915,39639,36895,2024-10-04 19:20:49,0,0,0,0,0,0
2,201392387,2170660915,22663,36895,2024-10-04 19:20:49,0,0,0,0,0,0
2,201392387,2170660915,45740,36895,2024-10-04 19:20:49,0,0,0,0,0,0
2,201392387,1145490692,53916,47873,2024-10-04 19:20:49,0,0,0,0,0,0
2,201392387,2170660915,0,0,2024-10-04 19:20:49,0,0,0,0,0,0
2,201392387,2170660915,39639,36895,2024-10-04 19:20:50,0,0,0,0,0,0
2,201392387,2170660915,22663,36895,2024-10-04 19:20:50,0,0,0,0,0,0
2,201392387,2170660915,45740,36895,2024-10-04 19:20:50,0,0,0,0,0,0
2,201392387,1145490692,53916,47873,2024-10-04 19:20:50,0,0,0,0,0,0
2,201392387,2170660915,0,0,2024-10-04 19:20:50,0,0,0,0,0,0
2,201392387,2170660915,39639,36895,2024-10-04 19:20:51,0,0,0,0,0,0
2,201392387,2170660915,22663,36895,2024-10-04 19:20:51,0,0,0,0,0,0
2,201392387,2170660915,45740,36895,2024-10-04 19:20:51,0,0,0,0,0,0
2,201392387,1145490692,53916,47873,2024-10-04 19:20:51,0,0,0,0,0,0
2,201392387,2170660915,0,0,2024-10-04 19:20:51,0,0,0,0,0,0
2,201392387,2170660915,39639,36895,2024-10-04 19:20:52,0,0,0,0,0,0
2,201392387,2170660915,22663,36895,2024-10-04 19:20:52,0,0,0,0,0,0
2,201392387,2170660915,45740,36895,2024-10-04 19:20:52,0,0,0,0,0,0
2,201392387,1145490692,53916,47873,2024-10-04 19:20:52,0,0,0,0,0,0
2,201392387,2170660915,0,0,2024-10-04 19:20:52,0,0,0,0,0,0
2,201392387,2170660915,39639,36895,2024-10-04 19:20:53,0,0,0,0,0,0
2,201392387,2170660915,22663,36895,2024-10-04 19:20:53,0,0,0,0,0,0
2,201392387,2170660915,45740,36895,2024-10-04 19:20:53,0,0,0,0,0,0
2,201392387,1145490692,53916,47873,2024-10-04 19:20:53,0,0,0,0,0,0
2,201392387,2170660915,0,0,2024-10-04 19:20:53,0,0,0,0,0,0
2,201392387,2170660915,39639,36895,2024-10-04 19:20:54,0,0,0,0,0,0
2,201392387,2170660915,22663,36895,2024-10-04 19:20:54,0,0,0,0,0,0
2,201392387,2170660915,45740,36895,2024-10-04 19:20:54,0,0,0,0,0,0
2,201392387,1145490692,53916,47873,2024-10-04 19:20:54,0,0,0,0,0,0
2,201392387,2170660915,0,0,2024-10-04 19:20:54,128,84,212,1,1,2
2,201392387,2170660915,39639,36895,2024-10-04 19:20:55,0,0,0,0,0,0
2,201392387,2170660915,22663,36895,2024-10-04 19:20:55,0,0,0,0,0,0
2,201392387,2170660915,45740,36895,2024-10-04 19:20:55,0,0,0,0,0,0
2,201392387,1145490692,53916,47873,2024-10-04 19:20:55,0,0,0,0,0,0
2,201392387,2170660915,0,0,2024-10-04 19:20:55,128,84,212,1,1,2
2,201392387,2170660915,39639,36895,2024-10-04 19:20:56,0,0,0,0,0,0
2,201392387,2170660915,22663,36895,2024-10-04 19:20:56,0,0,0,0,0,0
2,201392387,2170660915,45740,36895,2024-10-04 19:20:56,0,0,0,0,0,0
2,201392387,1145490692,53916,47873,2024-10-04 19:20:56,0,0,0,0,0,0
2,201392387,2170660915,0,0,2024-10-04 19:20:56,128,84,212,1,1,2
2,201392387,2170660915,39639,36895,2024-10-04 19:20:57,0,0,0,0,0,0
2,201392387,2170660915,22663,36895,2024-10-04 19:20:57,0,0,0,0,0,0
2,201392387,2170660915,45740,36895,2024-10-04 19:20:57,0,0,0,0,0,0
2,201392387,1145490692,53916,47873,2024-10-04 19:20:57,0,0,0,0,0,0
2,201392387,2170660915,0,0,2024-10-04 19:20:57,128,84,212,1,1,2
2,201392387,2170660915,39639,36895,2024-10-04 19:20:58,0,0,0,0,0,0
2,201392387,2170660915,22663,36895,2024-10-04 19:20:58,0,0,0,0,0,0
2,201392387,2170660915,45740,36895,2024-10-04 19:20:58,0,0,0,0,0,0
2,201392387,1145490692,53916,47873,2024-10-04 19:20:58,0,0,0,0,0,0
2,201392387,2170660915,0,0,2024-10-04 19:20:58,128,84,212,1,1,2
2,201392387,2170660915,39639,36895,2024-10-04 19:20:59,0,0,0,0,0,0
2,201392387,2170660915,22663,36895,2024-10-04 19:20:59,0,0,0,0,0,0
2,201392387,2170660915,45740,36895,2024-10-04 19:20:59,0,0,0,0,0,0
2,201392387,1145490692,53916,47873,2024-10-04 19:20:59,0,0,0,0,0,0
2,201392387,2170660915,0,0,2024-10-04 19:20:59,128,84,212,1,1,2
2,201392387,2170660915,39639,36895,2024-10-04 19:21:00,0,0,0,0,0,0
2,201392387,2170660915,22663,36895,2024-10-04 19:21:00,0,0,0,0,0,0
2,201392387,2170660915,45740,36895,2024-10-04 19:21:00,0,0,0,0,0,0
2,201392387,1145490692,53916,47873,2024-10-04 19:21:00,0,0,0,0,0,0
2,201392387,2170660915,0,0,2024-10-04 19:21:00,128,84,212,1,1,2
2,201392387,2170660915,39639,36895,2024-10-04 19:21:01,0,0,0,0,0,0
2,201392387,2170660915,22663,36895,2024-10-04 19:21:01,0,0,0,0,0,0
2,201392387,2170660915,45740,36895,2024-10-04 19:21:01,0,0,0,0,0,0
2,201392387,1145490692,53916,47873,2024-10-04 19:21:01,0,0,0,0,0,0
2,201392387,2170660915,0,0,2024-10-04 19:21:01,128,84,212,1,1,2
2,201392387,2170660915,39639,36895,2024-10-04 19:21:02,0,0,0,0,0,0
2,201392387,2170660915,22663,36895,2024-10-04 19:21:02,0,0,0,0,0,0
2,201392387,2170660915,45740,36895,2024-10-04 19:21:02,0,0,0,0,0,0
2,201392387,1145490692,53916,47873,2024-10-04 19:21:02,0,0,0,0,0,0
2,201392387,2170660915,0,0,2024-10-04 19:21:02,128,84,212,1,1,2
2,201392387,2170660915,39639,36895,2024-10-04 19:21:03,0,0,0,0,0,0
2,201392387,2170660915,22663,36895,2024-10-04 19:21:03,0,0,0,0,0,0
2,201392387,2170660915,45740,36895,2024-10-04 19:21:03,0,0,0,0,0,0
2,201392387,1145490692,53916,47873,2024-10-04 19:21:03,0,0,0,0,0,0
2,201392387,2170660915,0,0,2024-10-04 19:21:03,128,84,212,1,1,2
2,201392387,2170660915,39639,36895,2024-10-04 19:21:04,0,0,0,0,0,0
2,201392387,2170660915,22663,36895,2024-10-04 19:21:04,0,0,0,0,0,0
2,201392387,2170660915,45740,36895,2024-10-04 19:21:04,0,0,0,0,0,0
2,201392387,1145490692,53916,47873,2024-10-04 19:21:04,0,0,0,0,0,0
2,201392387,2170660915,0,0,2024-10-04 19:21:04,0,0,0,0,0,0
2,201392387,2170660915,39639,36895,2024-10-04 19:21:05,0,0,0,0,0,0
2,201392387,2170660915,22663,36895,2024-10-04 19:21:05,0,0,0,0,0,0
2,201392387,2170660915,45740,36895,2024-10-04 19:21:05,0,0,0,0,0,0
2,201392387,1145490692,53916,47873,2024-10-04 19:21:05,0,0,0,0,0,0
2,201392387,2170660915,0,0,2024-10-04 19:21:05,0,0,0,0,0,0
2,201392387,2170660915,39639,36895,2024-10-04 19:21:06,0,0,0,0,0,0
2,201392387,2170660915,48836,36895,2024-10-04 19:21:06,666,507,1173,6,6,12
2,201392387,2170660915,22663,36895,2024-10-04 19:21:06,0,0,0,0,0,0
2,201392387,2170660915,45740,36895,2024-10-04 19:21:06,0,0,0,0,0,0
2,201392387,2170660915,0,0,2024-10-04 19:21:06,0,0,0,0,0,0
2,201392387,2170660915,39639,36895,2024-10-04 19:21:07,0,0,0,0,0,0
2,201392387,2170660915,48836,36895,2024-10-04 19:21:07,0,0,0,0,0,0
2,201392387,2170660915,22663,36895,2024-10-04 19:21:07,0,0,0,0,0,0
2,201392387,2170660915,45740,36895,2024-10-04 19:21:07,0,0,0,0,0,0
2,201392387,2170660915,0,0,2024-10-04 19:21:07,128,84,212,1,1,2
2,201392387,2170660915,39639,36895,2024-10-04 19:21:08,0,0,0,0,0,0
2,201392387,2170660915,48836,36895,2024-10-04 19:21:08,0,0,0,0,0,0
2,201392387,2170660915,22663,36895,2024-10-04 19:21:08,0,0,0,0,0,0
2,201392387,2170660915,45740,36895,2024-10-04 19:21:08,0,0,0,0,0,0
2,201392387,2170660915,0,0,2024-10-04 19:21:08,128,84,212,1,1,2
2,201392387,2170660915,39639,36895,2024-10-04 19:21:09,0,0,0,0,0,0
2,201392387,2170660915,48836,36895,2024-10-04 19:21:09,0,0,0,0,0,0
2,201392387,2170660915,22663,36895,2024-10-04 19:21:09,0,0,0,0,0,0
2,201392387,2170660915,45740,36895,2024-10-04 19:21:09,0,0,0,0,0,0
2,201392387,2170660915,0,0,2024-10-04 19:21:09,0,0,0,0,0,0
2,201392387,2170660915,39639,36895,2024-10-04 19:21:10,0,0,0,0,0,0
2,201392387,2170660915,22663,36895,2024-10-04 19:21:10,0,0,0,0,0,0
2,201392387,2170660915,45740,36895,2024-10-04 19:21:10,0,0,0,0,0,0
2,201392387,2170660915,0,0,2024-10-04 19:21:10,128,84,212,1,1,2
2,201392387,2170660915,39639,36895,2024-10-04 19:21:11,0,0,0,0,0,0
2,201392387,2170660915,22663,36895,2024-10-04 19:21:11,0,0,0,0,0,0
2,201392387,2170660915,45740,36895,2024-10-04 19:21:11,0,0,0,0,0,0
2,201392387,2170660915,0,0,2024-10-04 19:21:11,0,0,0,0,0,0
2,201392387,2170660915,39639,36895,2024-10-04 19:21:12,0,0,0,0,0,0
2,201392387,2170660915,22663,36895,2024-10-04 19:21:12,0,0,0,0,0,0
2,201392387,2170660915,45740,36895,2024-10-04 19:21:12,0,0,0,0,0,0
2,201392387,2170660915,0,0,2024-10-04 19:21:12,128,84,212,1,1,2
2,201392387,2170660915,39639,36895,2024-10-04 19:21:13,0,0,0,0,0,0
2,201392387,2170660915,22663,36895,2024-10-04 19:21:13,0,0,0,0,0,0
2,201392387,2170660915,45740,36895,2024-10-04 19:21:13,0,0,0,0,0,0
2,201392387,2170660915,0,0,2024-10-04 19:21:13,128,84,212,1,1,2
2,201392387,2170660915,39639,36895,2024-10-04 19:21:14,0,0,0,0,0,0
2,201392387,2170660915,22663,36895,2024-10-04 19:21:14,0,0,0,0,0,0
2,201392387,2170660915,45740,36895,2024-10-04 19:21:14,0,0,0,0,0,0
2,201392387,1145490691,50924,47873,2024-10-04 19:21:14,2952,38073,41025,21,33,54
2,201392387,2170660915,0,0,2024-10-04 19:21:14,128,84,212,1,1,2
2,201392387,2170660915,39639,36895,2024-10-04 19:21:15,0,0,0,0,0,0
2,201392387,2170660915,22663,36895,2024-10-04 19:21:15,0,0,0,0,0,0
2,201392387,2170660915,45740,36895,2024-10-04 19:21:15,0,0,0,0,0,0
2,201392387,1145490691,50924,47873,2024-10-04 19:21:15,0,0,0,0,0,0
2,201392387,2170660915,0,0,2024-10-04 19:21:15,0,0,0,0,0,0
2,201392387,2170660915,39639,36895,2024-10-04 19:21:16,0,0,0,0,0,0
2,201392387,2170660915,22663,36895,2024-10-04 19:21:16,0,0,0,0,0,0
2,201392387,2170660915,45740,36895,2024-10-04 19:21:16,0,0,0,0,0,0
2,201392387,1145490691,50924,47873,2024-10-04 19:21:16,0,0,0,0,0,0
2,201392387,2170660915,0,0,2024-10-04 19:21:16,0,0,0,0,0,0
2,201392387,2170660915,39639,36895,2024-10-04 19:21:17,0,0,0,0,0,0
2,201392387,2170660915,22663,36895,2024-10-04 19:21:17,0,0,0,0,0,0
2,201392387,2170660915,45740,36895,2024-10-04 19:21:17,0,0,0,0,0,0
2,201392387,1145490691,50924,47873,2024-10-04 19:21:17,0,0,0,0,0,0
2,201392387,2170660915,0,0,2024-10-04 19:21:17,0,0,0,0,0,0
2,201392387,2170660915,39639,36895,2024-10-04 19:21:18,0,0,0,0,0,0
2,201392387,2170660915,22663,36895,2024-10-04 19:21:18,0,0,0,0,0,0
2,201392387,2170660915,45740,36895,2024-10-04 19:21:18,0,0,0,0,0,0
2,201392387,1145490691,50924,47873,2024-10-04 19:21:18,0,0,0,0,0,0
2,201392387,2170660915,0,0,2024-10-04 19:21:18,0,0,0,0,0,0
2,201392387,2170660915,39639,36895,2024-10-04 19:21:19,0,0,0,0,0,0
2,201392387,2170660915,22663,36895,2024-10-04 19:21:19,0,0,0,0,0,0
2,201392387,2170660915,45740,36895,2024-10-04 19:21:19,0,0,0,0,0,0
2,201392387,1145490691,50924,47873,2024-10-04 19:21:19,0,0,0,0,0,0
2,201392387,2170660915,0,0,2024-10-04 19:21:19,0,0,0,0,0,0
2,201392387,2170660915,39639,36895,2024-10-04 19:21:20,0,0,0,0,0,0
2,201392387,2170660915,22663,36895,2024-10-04 19:21:20,0,0,0,0,0,0
2,201392387,2170660915,45740,36895,2024-10-04 19:21:20,0,0,0,0,0,0
2,201392387,1145490691,50924,47873,2024-10-04 19:21:20,0,0,0,0,0,0
2,201392387,2170660915,0,0,2024-10-04 19:21:20,0,0,0,0,0,0
2,201392387,2170660915,39639,36895,2024-10-04 19:21:21,0,0,0,0,0,0
2,201392387,2170660915,22663,36895,2024-10-04 19:21:21,0,0,0,0,0,0
2,201392387,2170660915,45740,36895,2024-10-04 19:21:21,0,0,0,0,0,0
2,201392387,1145490691,50924,47873,2024-10-04 19:21:21,0,0,0,0,0,0
2,201392387,2170660915,0,0,2024-10-04 19:21:21,0,0,0,0,0,0
2,201392387,2170660915,39639,36895,2024-10-04 19:21:22,0,0,0,0,0,0
2,201392387,2170660915,22663,36895,2024-10-04 19:21:22,0,0,0,0,0,0
2,201392387,2170660915,45740,36895,2024-10-04 19:21:22,0,0,0,0,0,0
2,201392387,1145490691,50924,47873,2024-10-04 19:21:22,0,0,0,0,0,0
2,201392387,2170660915,0,0,2024-10-04 19:21:22,0,0,0,0,0,0
2,201392387,2170660915,39639,36895,2024-10-04 19:21:23,0,0,0,0,0,0
2,201392387,2170660915,22663,36895,2024-10-04 19:21:23,0,0,0,0,0,0
2,201392387,2170660915,45740,36895,2024-10-04 19:21:23,0,0,0,0,0,0
2,201392387,1145490691,50924,47873,2024-10-04 19:21:23,0,0,0,0,0,0
2,201392387,2170660915,0,0,2024-10-04 19:21:23,0,0,0,0,0,0
2,201392387,2170660915,39639,36895,2024-10-04 19:21:24,0,0,0,0,0,0
2,201392387,2170660915,22663,36895,2024-10-04 19:21:24,0,0,0,0,0,0
2,201392387,2170660915,45740,36895,2024-10-04 19:21:24,0,0,0,0,0,0
2,201392387,1145490691,50924,47873,2024-10-04 19:21:24,3708,65267,68975,36,46,82
2,201392387,2170660915,0,0,2024-10-04 19:21:24,0,0,0,0,0,0
2,201392387,2170660915,39639,36895,2024-10-04 19:21:25,0,0,0,0,0,0
2,201392387,2170660915,22663,36895,2024-10-04 19:21:25,0,0,0,0,0,0
2,201392387,2170660915,45740,36895,2024-10-04 19:21:25,0,0,0,0,0,0
2,201392387,1145490691,50924,47873,2024-10-04 19:21:25,0,0,0,0,0,0
2,201392387,2170660915,0,0,2024-10-04 19:21:25,128,84,212,1,1,2
2,201392387,2170660915,39639,36895,2024-10-04 19:21:26,0,0,0,0,0,0
2,201392387,2170660915,22663,36895,2024-10-04 19:21:26,0,0,0,0,0,0
2,201392387,2170660915,45740,36895,2024-10-04 19:21:26,0,0,0,0,0,0
2,201392387,1145490691,50924,47873,2024-10-04 19:21:26,0,0,0,0,0,0
2,201392387,2170660915,0,0,2024-10-04 19:21:26,128,84,212,1,1,2
2,201392387,2170660915,39639,36895,2024-10-04 19:21:27,0,0,0,0,0,0
2,201392387,2170660915,22663,36895,2024-10-04 19:21:27,0,0,0,0,0,0
2,201392387,2170660915,45740,36895,2024-10-04 19:21:27,0,0,0,0,0,0
2,201392387,1145490691,50924,47873,2024-10-04 19:21:27,0,0,0,0,0,0
2,201392387,2170660915,0,0,2024-10-04 19:21:27,128,84,212,1,1,2
2,201392387,2170660915,39639,36895,2024-10-04 19:21:28,0,0,0,0,0,0
2,201392387,2170660915,22663,36895,2024-10-04 19:21:28,0,0,0,0,0,0
2,201392387,2170660915,45740,36895,2024-10-04 19:21:28,0,0,0,0,0,0
2,201392387,1145490691,50924,47873,2024-10-04 19:21:28,0,0,0,0,0,0
2,201392387,2170660915,0,0,2024-10-04 19:21:28,128,84,212,1,1,2
2,201392387,2170660915,39639,36895,2024-10-04 19:21:29,0,0,0,0,0,0
2,201392387,2170660915,22663,36895,2024-10-04 19:21:29,0,0,0,0,0,0
2,201392387,2170660915,45740,36895,2024-10-04 19:21:29,0,0,0,0,0,0
2,201392387,1145490691,50924,47873,2024-10-04 19:21:29,0,0,0,0,0,0
2,201392387,2170660915,0,0,2024-10-04 19:21:29,128,84,212,1,1,2
2,201392387,2170660915,39639,36895,2024-10-04 19:21:30,0,0,0,0,0,0
2,201392387,2170660915,22663,36895,2024-10-04 19:21:30,0,0,0,0,0,0
2,201392387,2170660915,45740,36895,2024-10-04 19:21:30,0,0,0,0,0,0
2,201392387,1145490691,50924,47873,2024-10-04 19:21:30,0,0,0,0,0,0
2,201392387,2170660915,0,0,2024-10-04 19:21:30,128,84,212,1,1,2
2,201392387,2170660915,39639,36895,2024-10-04 19:21:31,0,0,0,0,0,0
2,201392387,2170660915,22663,36895,2024-10-04 19:21:31,0,0,0,0,0,0
2,201392387,2170660915,45740,36895,2024-10-04 19:21:31,0,0,0,0,0,0
2,201392387,1145490691,50924,47873,2024-10-04 19:21:31,0,0,0,0,0,0
2,201392387,2170660915,0,0,2024-10-04 19:21:31,128,84,212,1,1,2
2,201392387,2170660915,39639,36895,2024-10-04 19:21:32,0,0,0,0,0,0
2,201392387,2170660915,22663,36895,2024-10-04 19:21:32,0,0,0,0,0,0
2,201392387,2170660915,45740,36895,2024-10-04 19:21:32,0,0,0,0,0,0
2,201392387,1145490691,50924,47873,2024-10-04 19:21:32,0,0,0,0,0,0
2,201392387,2170660915,0,0,2024-10-04 19:21:32,128,84,212,1,1,2
2,201392387,2170660915,39639,36895,2024-10-04 19:21:33,0,0,0,0,0,0
2,201392387,2170660915,22663,36895,2024-10-04 19:21:33,0,0,0,0,0,0
2,201392387,2170660915,45740,36895,2024-10-04 19:21:33,0,0,0,0,0,0
2,201392387,1145490691,50924,47873,2024-10-04 19:21:33,0,0,0,0,0,0
2,201392387,2170660915,0,0,2024-10-04 19:21:33,128,84,212,1,1,2
2,201392387,2170660915,39639,36895,2024-10-04 19:21:34,0,0,0,0,0,0
2,201392387,2170660915,22663,36895,2024-10-04 19:21:34,0,0,0,0,0,0
2,201392387,2170660915,45740,36895,2024-10-04 19:21:34,0,0,0,0,0,0
2,201392387,2170660915,0,0,2024-10-04 19:21:34,128,84,212,1,1,2
2,201392387,2170660915,39639,36895,2024-10-04 19:21:35,0,0,0,0,0,0
2,201392387,2170660915,22663,36895,2024-10-04 19:21:35,0,0,0,0,0,0
2,201392387,2170660915,0,0,2024-10-04 19:21:35,0,0,0,0,0,0
2,201392387,2170660915,39639,36895,2024-10-04 19:21:36,0,0,0,0,0,0
2,201392387,2170660915,22663,36895,2024-10-04 19:21:36,0,0,0,0,0,0
2,201392387,2170660915,39585,36895,2024-10-04 19:21:36,666,507,1173,6,6,12
2,201392387,2170660915,0,0,2024-10-04 19:21:36,128,0,128,1,0,1
2,201392387,2170660915,39639,36895,2024-10-04 19:21:37,0,0,0,0,0,0
2,201392387,2170660915,22663,36895,2024-10-04 19:21:37,0,0,0,0,0,0
2,201392387,2170660915,39585,36895,2024-10-04 19:21:37,0,0,0,0,0,0
2,201392387,2170660915,0,0,2024-10-04 19:21:37,128,84,212,1,1,2
2,201392387,2170660915,39639,36895,2024-10-04 19:21:38,0,0,0,0,0,0
2,201392387,2170660915,22663,36895,2024-10-04 19:21:38,0,0,0,0,0,0
2,201392387,2170660915,39585,36895,2024-10-04 19:21:38,0,0,0,0,0,0
2,201392387,2170660915,0,0,2024-10-04 19:21:38,128,84,212,1,1,2
2,201392387,2170660915,39639,36895,2024-10-04 19:21:39,0,0,0,0,0,0
2,201392387,2170660915,22663,36895,2024-10-04 19:21:39,0,0,0,0,0,0
2,201392387,2170660915,39585,36895,2024-10-04 19:21:39,0,0,0,0,0,0
2,201392387,2170660915,0,0,2024-10-04 19:21:39,0,0,0,0,0,0
2,201392387,2170660915,39639,36895,2024-10-04 19:21:40,0,0,0,0,0,0
2,201392387,2170660915,22663,36895,2024-10-04 19:21:40,0,0,0,0,0,0
2,201392387,2170660915,39585,36895,2024-10-04 19:21:40,0,0,0,0,0,0
2,201392387,2170660915,0,0,2024-10-04 19:21:40,0,0,0,0,0,0
2,201392387,2170660915,39639,36895,2024-10-04 19:21:41,0,0,0,0,0,0
2,201392387,2170660915,22663,36895,2024-10-04 19:21:41,0,0,0,0,0,0
2,201392387,2170660915,39585,36895,2024-10-04 19:21:41,0,0,0,0,0,0
2,201392387,2170660915,0,0,2024-10-04 19:21:41,0,84,84,0,1,1
2,201392387,2170660915,39639,36895,2024-10-04 19:21:42,0,0,0,0,0,0
2,201392387,2170660915,22663,36895,2024-10-04 19:21:42,0,0,0,0,0,0
2,201392387,2170660915,39585,36895,2024-10-04 19:21:42,0,0,0,0,0,0
2,201392387,2170660915,0,0,2024-10-04 19:21:42,128,84,212,1,1,2
2,201392387,2170660915,39639,36895,2024-10-04 19:21:43,0,0,0,0,0,0
2,201392387,2170660915,22663,36895,2024-10-04 19:21:43,0,0,0,0,0,0
2,201392387,2170660915,39585,36895,2024-10-04 19:21:43,0,0,0,0,0,0
2,201392387,2170660915,0,0,2024-10-04 19:21:43,128,84,212,1,1,2
2,201392387,2170660915,39639,36895,2024-10-04 19:21:44,0,0,0,0,0,0
2,201392387,2170660915,22663,36895,2024-10-04 19:21:44,0,0,0,0,0,0
2,201392387,2170660915,39585,36895,2024-10-04 19:21:44,0,0,0,0,0,0
2,201392387,1145490692,30848,47873,2024-10-04 19:21:44,921,2589,3510,4,4,8
2,201392387,2170660915,0,0,2024-10-04 19:21:44,128,84,212,1,1,2
2,201392387,2170660915,39639,36895,2024-10-04 19:21:45,0,0,0,0,0,0
2,201392387,2170660915,22663,36895,2024-10-04 19:21:45,0,0,0,0,0,0
2,201392387,2170660915,39585,36895,2024-10-04 19:21:45,0,0,0,0,0,0
2,201392387,1145490692,30848,47873,2024-10-04 19:21:45,0,0,0,0,0,0
2,201392387,2170660915,0,0,2024-10-04 19:21:45,0,0,0,0,0,0
2,201392387,2170660915,39639,36895,2024-10-04 19:21:46,0,0,0,0,0,0
2,201392387,2170660915,22663,36895,2024-10-04 19:21:46,0,0,0,0,0,0
2,201392387,2170660915,39585,36895,2024-10-04 19:21:46,0,0,0,0,0,0
2,201392387,1145490692,30848,47873,2024-10-04 19:21:46,0,0,0,0,0,0
2,201392387,2170660915,0,0,2024-10-04 19:21:46,0,0,0,0,0,0
2,201392387,2170660915,39639,36895,2024-10-04 19:21:47,0,0,0,0,0,0
2,201392387,2170660915,22663,36895,2024-10-04 19:21:47,0,0,0,0,0,0
2,201392387,2170660915,39585,36895,2024-10-04 19:21:47,0,0,0,0,0,0
2,201392387,1145490692,30848,47873,2024-10-04 19:21:47,0,0,0,0,0,0
2,201392387,2170660915,0,0,2024-10-04 19:21:47,0,0,0,0,0,0
2,201392387,2170660915,39639,36895,2024-10-04 19:21:48,0,0,0,0,0,0
2,201392387,2170660915,22663,36895,2024-10-04 19:21:48,0,0,0,0,0,0
2,201392387,2170660915,39585,36895,2024-10-04 19:21:48,0,0,0,0,0,0
2,201392387,1145490692,30848,47873,2024-10-04 19:21:48,0,0,0,0,0,0
2,201392387,2170660915,0,0,2024-10-04 19:21:48,0,0,0,0,0,0
2,201392387,2170660915,39639,36895,2024-10-04 19:21:49,0,0,0,0,0,0
2,201392387,2170660915,22663,36895,2024-10-04 19:21:49,0,0,0,0,0,0
2,201392387,2170660915,39585,36895,2024-10-04 19:21:49,0,0,0,0,0,0
2,201392387,1145490692,30848,47873,2024-10-04 19:21:49,0,0,0,0,0,0
2,201392387,2170660915,0,0,2024-10-04 19:21:49,0,0,0,0,0,0
2,201392387,2170660915,39639,36895,2024-10-04 19:21:50,0,0,0,0,0,0
2,201392387,2170660915,22663,36895,2024-10-04 19:21:50,0,0,0,0,0,0
2,201392387,2170660915,39585,36895,2024-10-04 19:21:50,0,0,0,0,0,0
2,201392387,1145490692,30848,47873,2024-10-04 19:21:50,0,0,0,0,0,0
2,201392387,2170660915,0,0,2024-10-04 19:21:50,0,0,0,0,0,0
2,201392387,2170660915,39639,36895,2024-10-04 19:21:51,0,0,0,0,0,0
2,201392387,2170660915,22663,36895,2024-10-04 19:21:51,0,0,0,0,0,0
2,201392387,2170660915,39585,36895,2024-10-04 19:21:51,0,0,0,0,0,0
2,201392387,1145490692,30848,47873,2024-10-04 19:21:51,0,0,0,0,0,0
2,201392387,2170660915,0,0,2024-10-04 19:21:51,0,0,0,0,0,0
2,201392387,2170660915,39639,36895,2024-10-04 19:21:52,0,0,0,0,0,0
2,201392387,2170660915,22663,36895,2024-10-04 19:21:52,0,0,0,0,0,0
2,201392387,2170660915,39585,36895,2024-10-04 19:21:52,0,0,0,0,0,0
2,201392387,1145490692,30848,47873,2024-10-04 19:21:52,0,0,0,0,0,0
2,201392387,2170660915,0,0,2024-10-04 19:21:52,0,0,0,0,0,0
2,201392387,2170660915,39639,36895,2024-10-04 19:21:53,0,0,0,0,0,0
2,201392387,2170660915,22663,36895,2024-10-04 19:21:53,0,0,0,0,0,0
2,201392387,2170660915,39585,36895,2024-10-04 19:21:53,0,0,0,0,0,0
2,201392387,1145490692,30848,47873,2024-10-04 19:21:53,0,0,0,0,0,0
2,201392387,2170660915,0,0,2024-10-04 19:21:53,0,0,0,0,0,0
2,201392387,2170660915,39639,36895,2024-10-04 19:21:54,0,0,0,0,0,0
2,201392387,2170660915,22663,36895,2024-10-04 19:21:54,0,0,0,0,0,0
2,201392387,2170660915,39585,36895,2024-10-04 19:21:54,0,0,0,0,0,0
2,201392387,1145490692,30848,47873,2024-10-04 19:21:54,0,0,0,0,0,0
2,201392387,2170660915,0,0,2024-10-04 19:21:54,0,0,0,0,0,0
2,201392387,2170660915,39639,36895,2024-10-04 19:21:55,0,0,0,0,0,0
2,201392387,2170660915,22663,36895,2024-10-04 19:21:55,0,0,0,0,0,0
2,201392387,2170660915,39585,36895,2024-10-04 19:21:55,0,0,0,0,0,0
2,201392387,1145490692,30848,47873,2024-10-04 19:21:55,5355,92541,97896,50,70,120
2,201392387,2170660915,0,0,2024-10-04 19:21:55,0,0,0,0,0,0
2,201392387,2170660915,39639,36895,2024-10-04 19:21:56,0,0,0,0,0,0
2,201392387,2170660915,22663,36895,2024-10-04 19:21:56,0,0,0,0,0,0
2,201392387,2170660915,39585,36895,2024-10-04 19:21:56,0,0,0,0,0,0
2,201392387,1145490692,30848,47873,2024-10-04 19:21:56,0,0,0,0,0,0
2,201392387,2170660915,0,0,2024-10-04 19:21:56,128,84,212,1,1,2
2,201392387,2170660915,39639,36895,2024-10-04 19:21:57,0,0,0,0,0,0
2,201392387,2170660915,22663,36895,2024-10-04 19:21:57,0,0,0,0,0,0
2,201392387,2170660915,39585,36895,2024-10-04 19:21:57,0,0,0,0,0,0
2,201392387,1145490692,30848,47873,2024-10-04 19:21:57,0,0,0,0,0,0
2,201392387,2170660915,0,0,2024-10-04 19:21:57,128,84,212,1,1,2
2,201392387,2170660915,39639,36895,2024-10-04 19:21:58,0,0,0,0,0,0
2,201392387,2170660915,22663,36895,2024-10-04 19:21:58,0,0,0,0,0,0
2,201392387,2170660915,39585,36895,2024-10-04 19:21:58,0,0,0,0,0,0
2,201392387,1145490692,30848,47873,2024-10-04 19:21:58,0,0,0,0,0,0
2,201392387,2170660915,0,0,2024-10-04 19:21:58,128,84,212,1,1,2
2,201392387,2170660915,39639,36895,2024-10-04 19:21:59,0,0,0,0,0,0
2,201392387,2170660915,22663,36895,2024-10-04 19:21:59,0,0,0,0,0,0
2,201392387,2170660915,39585,36895,2024-10-04 19:21:59,0,0,0,0,0,0
2,201392387,1145490692,30848,47873,2024-10-04 19:21:59,0,0,0,0,0,0
2,201392387,2170660915,0,0,2024-10-04 19:21:59,128,84,212,1,1,2
2,201392387,2170660915,39639,36895,2024-10-04 19:22:00,0,0,0,0,0,0
2,201392387,2170660915,22663,36895,2024-10-04 19:22:00,0,0,0,0,0,0
2,201392387,2170660915,39585,36895,2024-10-04 19:22:00,0,0,0,0,0,0
2,201392387,1145490692,30848,47873,2024-10-04 19:22:00,0,0,0,0,0,0
2,201392387,2170660915,0,0,2024-10-04 19:22:00,256,84,340,2,1,3
2,201392387,2170660915,39639,36895,2024-10-04 19:22:01,0,0,0,0,0,0
2,201392387,2170660915,22663,36895,2024-10-04 19:22:01,0,0,0,0,0,0
2,201392387,2170660915,39585,36895,2024-10-04 19:22:01,0,0,0,0,0,0
2,201392387,1145490692,30848,47873,2024-10-04 19:22:01,0,0,0,0,0,0
2,201392387,2170660915,0,0,2024-10-04 19:22:01,128,84,212,1,1,2
2,201392387,2170660915,39639,36895,2024-10-04 19:22:02,0,0,0,0,0,0
2,201392387,2170660915,22663,36895,2024-10-04 19:22:02,0,0,0,0,0,0
2,201392387,2170660915,39585,36895,2024-10-04 19:22:02,0,0,0,0,0,0
2,201392387,1145490692,30848,47873,2024-10-04 19:22:02,0,0,0,0,0,0
2,201392387,2170660915,0,0,2024-10-04 19:22:02,128,84,212,1,1,2
2,201392387,2170660915,39639,36895,2024-10-04 19:22:03,0,0,0,0,0,0
2,201392387,2170660915,22663,36895,2024-10-04 19:22:03,0,0,0,0,0,0
2,201392387,2170660915,39585,36895,2024-10-04 19:22:03,0,0,0,0,0,0
2,201392387,1145490692,30848,47873,2024-10-04 19:22:03,0,0,0,0,0,0
2,201392387,2170660915,0,0,2024-10-04 19:22:03,128,84,212,1,1,2
2,201392387,2170660915,39639,36895,2024-10-04 19:22:04,0,0,0,0,0,0
2,201392387,2170660915,22663,36895,2024-10-04 19:22:04,0,0,0,0,0,0
2,201392387,2170660915,39585,36895,2024-10-04 19:22:04,0,0,0,0,0,0
2,201392387,1145490692,30848,47873,2024-10-04 19:22:04,0,0,0,0,0,0
2,201392387,2170660915,0,0,2024-10-04 19:22:04,128,84,212,1,1,2
2,201392387,2170660915,39639,36895,2024-10-04 19:22:05,0,0,0,0,0,0
2,201392387,2170660915,22663,36895,2024-10-04 19:22:05,0,0,0,0,0,0
2,201392387,2170660915,39585,36895,2024-10-04 19:22:05,0,0,0,0,0,0
2,201392387,2170660915,0,0,2024-10-04 19:22:05,0,84,84,0,1,1
2,201392387,2170660915,39639,36895,2024-10-04 19:22:06,0,0,0,0,0,0
2,201392387,2170660915,22663,36895,2024-10-04 19:22:06,0,0,0,0,0,0
2,201392387,2170660915,6334,36895,2024-10-04 19:22:06,666,507,1173,6,6,12
2,201392387,2170660915,0,0,2024-10-04 19:22:06,0,0,0,0,0,0
2,201392387,2170660915,39639,36895,2024-10-04 19:22:07,0,0,0,0,0,0
2,201392387,2170660915,22663,36895,2024-10-04 19:22:07,0,0,0,0,0,0
2,201392387,2170660915,6334,36895,2024-10-04 19:22:07,0,0,0,0,0,0
2,201392387,2170660915,0,0,2024-10-04 19:22:07,128,84,212,1,1,2
2,201392387,2170660915,39639,36895,2024-10-04 19:22:08,0,0,0,0,0,0
2,201392387,2170660915,22663,36895,2024-10-04 19:22:08,0,0,0,0,0,0
2,201392387,2170660915,6334,36895,2024-10-04 19:22:08,0,0,0,0,0,0
2,201392387,2170660915,0,0,2024-10-04 19:22:08,128,84,212,1,1,2
2,201392387,2170660915,39639,36895,2024-10-04 19:22:09,0,0,0,0,0,0
2,201392387,2170660915,22663,36895,2024-10-04 19:22:09,0,0,0,0,0,0
2,201392387,2170660915,6334,36895,2024-10-04 19:22:09,0,0,0,0,0,0
2,201392387,2170660915,0,0,2024-10-04 19:22:09,0,0,0,0,0,0
2,201392387,2170660915,39639,36895,2024-10-04 19:22:10,0,0,0,0,0,0
2,201392387,2170660915,22663,36895,2024-10-04 19:22:10,0,0,0,0,0,0
2,201392387,2170660915,6334,36895,2024-10-04 19:22:10,0,0,0,0,0,0
2,201392387,2170660915,0,0,2024-10-04 19:22:10,0,0,0,0,0,0
2,201392387,2170660915,39639,36895,2024-10-04 19:22:11,0,0,0,0,0,0
2,201392387,2170660915,22663,36895,2024-10-04 19:22:11,0,0,0,0,0,0
2,201392387,2170660915,6334,36895,2024-10-04 19:22:11,0,0,0,0,0,0
2,201392387,2170660915,0,0,2024-10-04 19:22:11,0,0,0,0,0,0
2,201392387,2170660915,39639,36895,2024-10-04 19:22:12,0,0,0,0,0,0
2,201392387,2170660915,22663,36895,2024-10-04 19:22:12,0,0,0,0,0,0
2,201392387,2170660915,6334,36895,2024-10-04 19:22:12,0,0,0,0,0,0
2,201392387,2170660915,0,0,2024-10-04 19:22:12,256,84,340,2,1,3
2,201392387,2170660915,39639,36895,2024-10-04 19:22:13,0,0,0,0,0,0
2,201392387,2170660915,22663,36895,2024-10-04 19:22:13,0,0,0,0,0,0
2,201392387,2170660915,6334,36895,2024-10-04 19:22:13,0,0,0,0,0,0
2,201392387,2170660915,0,0,2024-10-04 19:22:13,128,84,212,1,1,2
2,201392387,2170660915,39639,36895,2024-10-04 19:22:14,0,0,0,0,0,0
2,201392387,2170660915,22663,36895,2024-10-04 19:22:14,0,0,0,0,0,0
2,201392387,2170660915,6334,36895,2024-10-04 19:22:14,0,0,0,0,0,0
2,201392387,2170660915,0,0,2024-10-04 19:22:14,0,84,84,0,1,1
2,201392387,2170660915,39639,36895,2024-10-04 19:22:15,0,0,0,0,0,0
2,201392387,2170660915,22663,36895,2024-10-04 19:22:15,0,0,0,0,0,0
2,201392387,2170660915,6334,36895,2024-10-04 19:22:15,0,0,0,0,0,0
2,201392387,2170660915,0,0,2024-10-04 19:22:15,128,84,212,1,1,2
2,201392387,1145490691,27817,47873,2024-10-04 19:22:15,3648,49551,53199,28,41,69
2,201392387,2170660915,39639,36895,2024-10-04 19:22:16,0,0,0,0,0,0
2,201392387,2170660915,22663,36895,2024-10-04 19:22:16,0,0,0,0,0,0
2,201392387,2170660915,6334,36895,2024-10-04 19:22:16,0,0,0,0,0,0
2,201392387,2170660915,0,0,2024-10-04 19:22:16,0,0,0,0,0,0
2,201392387,1145490691,27817,47873,2024-10-04 19:22:16,0,0,0,0,0,0
2,201392387,2170660915,39639,36895,2024-10-04 19:22:17,0,0,0,0,0,0
2,201392387,2170660915,22663,36895,2024-10-04 19:22:17,0,0,0,0,0,0
2,201392387,2170660915,6334,36895,2024-10-04 19:22:17,0,0,0,0,0,0
2,201392387,2170660915,0,0,2024-10-04 19:22:17,0,0,0,0,0,0
2,201392387,1145490691,27817,47873,2024-10-04 19:22:17,0,0,0,0,0,0
2,201392387,2170660915,39639,36895,2024-10-04 19:22:18,0,0,0,0,0,0
2,201392387,2170660915,22663,36895,2024-10-04 19:22:18,0,0,0,0,0,0
2,201392387,2170660915,6334,36895,2024-10-04 19:22:18,0,0,0,0,0,0
2,201392387,2170660915,0,0,2024-10-04 19:22:18,0,0,0,0,0,0
2,201392387,1145490691,27817,47873,2024-10-04 19:22:18,0,0,0,0,0,0
2,201392387,2170660915,39639,36895,2024-10-04 19:22:19,0,0,0,0,0,0
2,201392387,2170660915,22663,36895,2024-10-04 19:22:19,0,0,0,0,0,0
2,201392387,2170660915,6334,36895,2024-10-04 19:22:19,0,0,0,0,0,0
2,201392387,2170660915,0,0,2024-10-04 19:22:19,0,0,0,0,0,0
2,201392387,1145490691,27817,47873,2024-10-04 19:22:19,0,0,0,0,0,0
2,201392387,2170660915,39639,36895,2024-10-04 19:22:20,0,0,0,0,0,0
2,201392387,2170660915,22663,36895,2024-10-04 19:22:20,0,0,0,0,0,0
2,201392387,2170660915,6334,36895,2024-10-04 19:22:20,0,0,0,0,0,0
2,201392387,2170660915,0,0,2024-10-04 19:22:20,0,0,0,0,0,0
2,201392387,1145490691,27817,47873,2024-10-04 19:22:20,0,0,0,0,0,0
2,201392387,2170660915,39639,36895,2024-10-04 19:22:21,0,0,0,0,0,0
2,201392387,2170660915,22663,36895,2024-10-04 19:22:21,0,0,0,0,0,0
2,201392387,2170660915,6334,36895,2024-10-04 19:22:21,0,0,0,0,0,0
2,201392387,2170660915,0,0,2024-10-04 19:22:21,0,0,0,0,0,0
2,201392387,1145490691,27817,47873,2024-10-04 19:22:21,0,0,0,0,0,0
2,201392387,2170660915,39639,36895,2024-10-04 19:22:22,0,0,0,0,0,0
2,201392387,2170660915,22663,36895,2024-10-04 19:22:22,0,0,0,0,0,0
2,201392387,2170660915,6334,36895,2024-10-04 19:22:22,0,0,0,0,0,0
2,201392387,2170660915,0,0,2024-10-04 19:22:22,0,0,0,0,0,0
2,201392387,1145490691,27817,47873,2024-10-04 19:22:22,0,0,0,0,0,0
2,201392387,2170660915,39639,36895,2024-10-04 19:22:23,0,0,0,0,0,0
2,201392387,2170660915,22663,36895,2024-10-04 19:22:23,0,0,0,0,0,0
2,201392387,2170660915,6334,36895,2024-10-04 19:22:23,0,0,0,0,0,0
2,201392387,2170660915,0,0,2024-10-04 19:22:23,0,0,0,0,0,0
2,201392387,1145490691,27817,47873,2024-10-04 19:22:23,0,0,0,0,0,0
2,201392387,2170660915,39639,36895,2024-10-04 19:22:24,0,0,0,0,0,0
2,201392387,2170660915,22663,36895,2024-10-04 19:22:24,0,0,0,0,0,0
2,201392387,2170660915,6334,36895,2024-10-04 19:22:24,0,0,0,0,0,0
2,201392387,2170660915,0,0,2024-10-04 19:22:24,0,0,0,0,0,0
2,201392387,1145490691,27817,47873,2024-10-04 19:22:24,0,0,0,0,0,0
2,201392387,2170660915,39639,36895,2024-10-04 19:22:25,0,0,0,0,0,0
2,201392387,2170660915,22663,36895,2024-10-04 19:22:25,0,0,0,0,0,0
2,201392387,2170660915,6334,36895,2024-10-04 19:22:25,0,0,0,0,0,0
2,201392387,2170660915,0,0,2024-10-04 19:22:25,0,0,0,0,0,0
2,201392387,1145490691,27817,47873,2024-10-04 19:22:25,2532,45631,48163,25,34,59
2,201392387,2170660915,39639,36895,2024-10-04 19:22:26,0,0,0,0,0,0
2,201392387,2170660915,22663,36895,2024-10-04 19:22:26,0,0,0,0,0,0
2,201392387,2170660915,6334,36895,2024-10-04 19:22:26,0,0,0,0,0,0
2,201392387,2170660915,0,0,2024-10-04 19:22:26,0,0,0,0,0,0
2,201392387,1145490691,27817,47873,2024-10-04 19:22:26,0,0,0,0,0,0
2,201392387,2170660915,39639,36895,2024-10-04 19:22:27,0,0,0,0,0,0
2,201392387,2170660915,22663,36895,2024-10-04 19:22:27,0,0,0,0,0,0
2,201392387,2170660915,6334,36895,2024-10-04 19:22:27,0,0,0,0,0,0
2,201392387,2170660915,0,0,2024-10-04 19:22:27,128,84,212,1,1,2
2,201392387,1145490691,27817,47873,2024-10-04 19:22:27,0,0,0,0,0,0
2,201392387,2170660915,39639,36895,2024-10-04 19:22:28,0,0,0,0,0,0
2,201392387,2170660915,22663,36895,2024-10-04 19:22:28,0,0,0,0,0,0
2,201392387,2170660915,6334,36895,2024-10-04 19:22:28,0,0,0,0,0,0
2,201392387,2170660915,0,0,2024-10-04 19:22:28,128,84,212,1,1,2
2,201392387,1145490691,27817,47873,2024-10-04 19:22:28,0,0,0,0,0,0
2,201392387,2170660915,39639,36895,2024-10-04 19:22:29,0,0,0,0,0,0
2,201392387,2170660915,22663,36895,2024-10-04 19:22:29,0,0,0,0,0,0
2,201392387,2170660915,6334,36895,2024-10-04 19:22:29,0,0,0,0,0,0
2,201392387,2170660915,0,0,2024-10-04 19:22:29,128,84,212,1,1,2
2,201392387,1145490691,27817,47873,2024-10-04 19:22:29,0,0,0,0,0,0
2,201392387,2170660915,39639,36895,2024-10-04 19:22:30,0,0,0,0,0,0
2,201392387,2170660915,22663,36895,2024-10-04 19:22:30,0,0,0,0,0,0
2,201392387,2170660915,6334,36895,2024-10-04 19:22:30,0,0,0,0,0,0
2,201392387,2170660915,0,0,2024-10-04 19:22:30,128,84,212,1,1,2
2,201392387,1145490691,27817,47873,2024-10-04 19:22:30,0,0,0,0,0,0
2,201392387,2170660915,39639,36895,2024-10-04 19:22:31,0,0,0,0,0,0
2,201392387,2170660915,22663,36895,2024-10-04 19:22:31,0,0,0,0,0,0
2,201392387,2170660915,6334,36895,2024-10-04 19:22:31,0,0,0,0,0,0
2,201392387,2170660915,0,0,2024-10-04 19:22:31,128,84,212,1,1,2
2,201392387,1145490691,27817,47873,2024-10-04 19:22:31,0,0,0,0,0,0
2,201392387,2170660915,39639,36895,2024-10-04 19:22:32,0,0,0,0,0,0
2,201392387,2170660915,22663,36895,2024-10-04 19:22:32,0,0,0,0,0,0
2,201392387,2170660915,6334,36895,2024-10-04 19:22:32,0,0,0,0,0,0
2,201392387,2170660915,0,0,2024-10-04 19:22:32,256,168,424,2,2,4
2,201392387,1145490691,27817,47873,2024-10-04 19:22:32,0,0,0,0,0,0
2,201392387,2170660915,39639,36895,2024-10-04 19:22:33,0,0,0,0,0,0
2,201392387,2170660915,22663,36895,2024-10-04 19:22:33,0,0,0,0,0,0
2,201392387,2170660915,6334,36895,2024-10-04 19:22:33,0,0,0,0,0,0
2,201392387,2170660915,0,0,2024-10-04 19:22:33,128,84,212,1,1,2
2,201392387,1145490691,27817,47873,2024-10-04 19:22:33,0,0,0,0,0,0
2,201392387,2170660915,39639,36895,2024-10-04 19:22:34,0,0,0,0,0,0
2,201392387,2170660915,22663,36895,2024-10-04 19:22:34,0,0,0,0,0,0
2,201392387,2170660915,6334,36895,2024-10-04 19:22:34,0,0,0,0,0,0
2,201392387,2170660915,0,0,2024-10-04 19:22:34,128,84,212,1,1,2
2,201392387,1145490691,27817,47873,2024-10-04 19:22:34,0,0,0,0,0,0
2,201392387,2170660915,39639,36895,2024-10-04 19:22:35,0,0,0,0,0,0
2,201392387,2170660915,22663,36895,2024-10-04 19:22:35,0,0,0,0,0,0
2,201392387,2170660915,6334,36895,2024-10-04 19:22:35,0,0,0,0,0,0
2,201392387,2170660915,0,0,2024-10-04 19:22:35,128,84,212,1,1,2
2,201392387,2170660915,39639,36895,2024-10-04 19:22:36,0,0,0,0,0,0
2,201392387,2170660915,22663,36895,2024-10-04 19:22:36,0,0,0,0,0,0
2,201392387,2170660915,6334,36895,2024-10-04 19:22:36,0,0,0,0,0,0
2,201392387,2170660915,0,0,2024-10-04 19:22:36,0,0,0,0,0,0
2,201392387,2170660915,39639,36895,2024-10-04 19:22:37,0,0,0,0,0,0
2,201392387,2170660915,22663,36895,2024-10-04 19:22:37,0,0,0,0,0,0
2,201392387,2170660915,20099,36895,2024-10-04 19:22:37,666,507,1173,6,6,12
2,201392387,2170660915,0,0,2024-10-04 19:22:37,0,0,0,0,0,0
2,201392387,2170660915,39639,36895,2024-10-04 19:22:38,0,0,0,0,0,0
2,201392387,2170660915,22663,36895,2024-10-04 19:22:38,0,0,0,0,0,0
2,201392387,2170660915,20099,36895,2024-10-04 19:22:38,0,0,0,0,0,0
2,201392387,2170660915,0,0,2024-10-04 19:22:38,128,84,212,1,1,2
2,201392387,2170660915,39639,36895,2024-10-04 19:22:39,0,0,0,0,0,0
2,201392387,2170660915,22663,36895,2024-10-04 19:22:39,0,0,0,0,0,0
2,201392387,2170660915,20099,36895,2024-10-04 19:22:39,0,0,0,0,0,0
2,201392387,2170660915,0,0,2024-10-04 19:22:39,128,84,212,1,1,2
2,201392387,2170660915,39639,36895,2024-10-04 19:22:40,0,0,0,0,0,0
2,201392387,2170660915,22663,36895,2024-10-04 19:22:40,0,0,0,0,0,0
2,201392387,2170660915,20099,36895,2024-10-04 19:22:40,0,0,0,0,0,0
2,201392387,2170660915,0,0,2024-10-04 19:22:40,0,0,0,0,0,0
2,201392387,2170660915,39639,36895,2024-10-04 19:22:41,0,0,0,0,0,0
2,201392387,2170660915,22663,36895,2024-10-04 19:22:41,0,0,0,0,0,0
2,201392387,2170660915,20099,36895,2024-10-04 19:22:41,0,0,0,0,0,0
2,201392387,2170660915,0,0,2024-10-04 19:22:41,0,0,0,0,0,0
2,201392387,2170660915,39639,36895,2024-10-04 19:22:42,0,0,0,0,0,0
2,201392387,2170660915,22663,36895,2024-10-04 19:22:42,0,0,0,0,0,0
2,201392387,2170660915,20099,36895,2024-10-04 19:22:42,0,0,0,0,0,0
2,201392387,2170660915,0,0,2024-10-04 19:22:42,0,0,0,0,0,0
2,201392387,2170660915,39639,36895,2024-10-04 19:22:43,0,0,0,0,0,0
2,201392387,2170660915,22663,36895,2024-10-04 19:22:43,0,0,0,0,0,0
2,201392387,2170660915,20099,36895,2024-10-04 19:22:43,0,0,0,0,0,0
2,201392387,2170660915,0,0,2024-10-04 19:22:43,128,84,212,1,1,2
2,201392387,2170660915,39639,36895,2024-10-04 19:22:44,0,0,0,0,0,0
2,201392387,2170660915,22663,36895,2024-10-04 19:22:44,0,0,0,0,0,0
2,201392387,2170660915,20099,36895,2024-10-04 19:22:44,0,0,0,0,0,0
2,201392387,2170660915,0,0,2024-10-04 19:22:44,128,84,212,1,1,2
2,201392387,2170660915,39639,36895,2024-10-04 19:22:45,0,0,0,0,0,0
2,201392387,2170660915,22663,36895,2024-10-04 19:22:45,0,0,0,0,0,0
2,201392387,2170660915,20099,36895,2024-10-04 19:22:45,0,0,0,0,0,0
2,201392387,1145490690,3811,47873,2024-10-04 19:22:45,2100,14487,16587,13,19,32
2,201392387,2170660915,0,0,2024-10-04 19:22:45,256,168,424,2,2,4
2,201392387,2170660915,39639,36895,2024-10-04 19:22:46,0,0,0,0,0,0
2,201392387,2170660915,22663,36895,2024-10-04 19:22:46,0,0,0,0,0,0
2,201392387,2170660915,20099,36895,2024-10-04 19:22:46,0,0,0,0,0,0
2,201392387,1145490690,3811,47873,2024-10-04 19:22:46,4320,80747,85067,42,57,99
2,201392387,2170660915,0,0,2024-10-04 19:22:46,0,0,0,0,0,0
2,201392387,2170660915,39639,36895,2024-10-04 19:22:47,0,0,0,0,0,0
2,201392387,2170660915,22663,36895,2024-10-04 19:22:47,0,0,0,0,0,0
2,201392387,2170660915,20099,36895,2024-10-04 19:22:47,0,0,0,0,0,0
2,201392387,1145490690,3811,47873,2024-10-04 19:22:47,0,0,0,0,0,0
2,201392387,2170660915,0,0,2024-10-04 19:22:47,0,0,0,0,0,0
2,201392387,2170660915,39639,36895,2024-10-04 19:22:48,0,0,0,0,0,0
2,201392387,2170660915,22663,36895,2024-10-04 19:22:48,0,0,0,0,0,0
2,201392387,2170660915,20099,36895,2024-10-04 19:22:48,0,0,0,0,0,0
2,201392387,1145490690,3811,47873,2024-10-04 19:22:48,0,0,0,0,0,0
2,201392387,2170660915,0,0,2024-10-04 19:22:48,0,0,0,0,0,0
2,201392387,2170660915,39639,36895,2024-10-04 19:22:49,0,0,0,0,0,0
2,201392387,2170660915,22663,36895,2024-10-04 19:22:49,0,0,0,0,0,0
2,201392387,2170660915,20099,36895,2024-10-04 19:22:49,0,0,0,0,0,0
2,201392387,1145490690,3811,47873,2024-10-04 19:22:49,0,0,0,0,0,0
2,201392387,2170660915,0,0,2024-10-04 19:22:49,0,0,0,0,0,0
2,201392387,2170660915,39639,36895,2024-10-04 19:22:50,0,0,0,0,0,0
2,201392387,2170660915,22663,36895,2024-10-04 19:22:50,0,0,0,0,0,0
2,201392387,2170660915,20099,36895,2024-10-04 19:22:50,0,0,0,0,0,0
2,201392387,1145490690,3811,47873,2024-10-04 19:22:50,0,0,0,0,0,0
2,201392387,2170660915,0,0,2024-10-04 19:22:50,0,0,0,0,0,0
2,201392387,2170660915,39639,36895,2024-10-04 19:22:51,0,0,0,0,0,0
2,201392387,2170660915,22663,36895,2024-10-04 19:22:51,0,0,0,0,0,0
2,201392387,2170660915,20099,36895,2024-10-04 19:22:51,0,0,0,0,0,0
2,201392387,1145490690,3811,47873,2024-10-04 19:22:51,0,0,0,0,0,0
2,201392387,2170660915,0,0,2024-10-04 19:22:51,0,0,0,0,0,0
2,201392387,2170660915,39639,36895,2024-10-04 19:22:52,0,0,0,0,0,0
2,201392387,2170660915,22663,36895,2024-10-04 19:22:52,0,0,0,0,0,0
2,201392387,2170660915,20099,36895,2024-10-04 19:22:52,0,0,0,0,0,0
2,201392387,1145490690,3811,47873,2024-10-04 19:22:52,0,0,0,0,0,0
2,201392387,2170660915,0,0,2024-10-04 19:22:52,0,0,0,0,0,0
2,201392387,2170660915,39639,36895,2024-10-04 19:22:53,0,0,0,0,0,0
2,201392387,2170660915,22663,36895,2024-10-04 19:22:53,0,0,0,0,0,0
2,201392387,2170660915,20099,36895,2024-10-04 19:22:53,0,0,0,0,0,0
2,201392387,1145490690,3811,47873,2024-10-04 19:22:53,0,0,0,0,0,0
2,201392387,2170660915,0,0,2024-10-04 19:22:53,0,0,0,0,0,0
2,201392387,2170660915,39639,36895,2024-10-04 19:22:54,0,0,0,0,0,0
2,201392387,2170660915,22663,36895,2024-10-04 19:22:54,0,0,0,0,0,0
2,201392387,2170660915,20099,36895,2024-10-04 19:22:54,0,0,0,0,0,0
2,201392387,1145490690,3811,47873,2024-10-04 19:22:54,0,0,0,0,0,0
2,201392387,2170660915,0,0,2024-10-04 19:22:54,0,0,0,0,0,0
2,201392387,2170660915,39639,36895,2024-10-04 19:22:55,0,0,0,0,0,0
2,201392387,2170660915,22663,36895,2024-10-04 19:22:55,0,0,0,0,0,0
2,201392387,2170660915,20099,36895,2024-10-04 19:22:55,0,0,0,0,0,0
2,201392387,1145490690,3811,47873,2024-10-04 19:22:55,0,0,0,0,0,0
2,201392387,2170660915,0,0,2024-10-04 19:22:55,0,0,0,0,0,0
2,201392387,2170660915,39639,36895,2024-10-04 19:22:56,0,0,0,0,0,0
2,201392387,2170660915,22663,36895,2024-10-04 19:22:56,0,0,0,0,0,0
2,201392387,2170660915,20099,36895,2024-10-04 19:22:56,0,0,0,0,0,0
2,201392387,1145490690,3811,47873,2024-10-04 19:22:56,0,0,0,0,0,0
2,201392387,2170660915,0,0,2024-10-04 19:22:56,128,0,128,1,0,1
2,201392387,2170660915,39639,36895,2024-10-04 19:22:57,0,0,0,0,0,0
2,201392387,2170660915,22663,36895,2024-10-04 19:22:57,0,0,0,0,0,0
2,201392387,2170660915,20099,36895,2024-10-04 19:22:57,0,0,0,0,0,0
2,201392387,1145490690,3811,47873,2024-10-04 19:22:57,0,0,0,0,0,0
2,201392387,2170660915,0,0,2024-10-04 19:22:57,128,168,296,1,2,3
2,201392387,2170660915,39639,36895,2024-10-04 19:22:58,0,0,0,0,0,0
2,201392387,2170660915,22663,36895,2024-10-04 19:22:58,0,0,0,0,0,0
2,201392387,2170660915,20099,36895,2024-10-04 19:22:58,0,0,0,0,0,0
2,201392387,1145490690,3811,47873,2024-10-04 19:22:58,0,0,0,0,0,0
2,201392387,2170660915,0,0,2024-10-04 19:22:58,128,84,212,1,1,2
2,201392387,2170660915,39639,36895,2024-10-04 19:22:59,0,0,0,0,0,0
2,201392387,2170660915,22663,36895,2024-10-04 19:22:59,0,0,0,0,0,0
2,201392387,2170660915,20099,36895,2024-10-04 19:22:59,0,0,0,0,0,0
2,201392387,1145490690,3811,47873,2024-10-04 19:22:59,0,0,0,0,0,0
2,201392387,2170660915,0,0,2024-10-04 19:22:59,128,84,212,1,1,2
2,201392387,2170660915,39639,36895,2024-10-04 19:23:00,0,0,0,0,0,0
2,201392387,2170660915,22663,36895,2024-10-04 19:23:00,0,0,0,0,0,0
2,201392387,2170660915,20099,36895,2024-10-04 19:23:00,0,0,0,0,0,0
2,201392387,1145490690,3811,47873,2024-10-04 19:23:00,0,0,0,0,0,0
2,201392387,2170660915,0,0,2024-10-04 19:23:00,128,84,212,1,1,2
2,201392387,2170660915,39639,36895,2024-10-04 19:23:01,0,0,0,0,0,0
2,201392387,2170660915,22663,36895,2024-10-04 19:23:01,0,0,0,0,0,0
2,201392387,2170660915,20099,36895,2024-10-04 19:23:01,0,0,0,0,0,0
2,201392387,1145490690,3811,47873,2024-10-04 19:23:01,0,0,0,0,0,0
2,201392387,2170660915,0,0,2024-10-04 19:23:01,128,0,128,1,0,1
2,201392387,2170660915,39639,36895,2024-10-04 19:23:02,0,0,0,0,0,0
2,201392387,2170660915,22663,36895,2024-10-04 19:23:02,0,0,0,0,0,0
2,201392387,2170660915,20099,36895,2024-10-04 19:23:02,0,0,0,0,0,0
2,201392387,1145490690,3811,47873,2024-10-04 19:23:02,0,0,0,0,0,0
2,201392387,2170660915,0,0,2024-10-04 19:23:02,128,84,212,1,1,2
2,201392387,2170660915,39639,36895,2024-10-04 19:23:03,0,0,0,0,0,0
2,201392387,2170660915,22663,36895,2024-10-04 19:23:03,0,0,0,0,0,0
2,201392387,2170660915,20099,36895,2024-10-04 19:23:03,0,0,0,0,0,0
2,201392387,1145490690,3811,47873,2024-10-04 19:23:03,0,0,0,0,0,0
2,201392387,2170660915,0,0,2024-10-04 19:23:03,128,84,212,1,1,2
2,201392387,2170660915,39639,36895,2024-10-04 19:23:04,0,0,0,0,0,0
2,201392387,2170660915,22663,36895,2024-10-04 19:23:04,0,0,0,0,0,0
2,201392387,2170660915,20099,36895,2024-10-04 19:23:04,0,0,0,0,0,0
2,201392387,1145490690,3811,47873,2024-10-04 19:23:04,0,0,0,0,0,0
2,201392387,2170660915,0,0,2024-10-04 19:23:04,128,84,212,1,1,2
2,201392387,2170660915,39639,36895,2024-10-04 19:23:05,0,0,0,0,0,0
2,201392387,2170660915,22663,36895,2024-10-04 19:23:05,0,0,0,0,0,0
2,201392387,2170660915,20099,36895,2024-10-04 19:23:05,0,0,0,0,0,0
2,201392387,1145490690,3811,47873,2024-10-04 19:23:05,0,0,0,0,0,0
2,201392387,2170660915,0,0,2024-10-04 19:23:05,128,84,212,1,1,2
2,201392387,2170660915,39639,36895,2024-10-04 19:23:06,0,0,0,0,0,0
2,201392387,2170660915,22663,36895,2024-10-04 19:23:06,0,0,0,0,0,0
2,201392387,2170660915,20099,36895,2024-10-04 19:23:06,0,0,0,0,0,0
2,201392387,1145490690,3811,47873,2024-10-04 19:23:06,0,0,0,0,0,0
2,201392387,2170660915,0,0,2024-10-04 19:23:06,0,84,84,0,1,1
2,201392387,2170660915,39639,36895,2024-10-04 19:23:07,0,0,0,0,0,0
2,201392387,2170660915,22663,36895,2024-10-04 19:23:07,0,0,0,0,0,0
2,201392387,2170660915,8833,36895,2024-10-04 19:23:07,666,507,1173,6,6,12
2,201392387,2170660915,20099,36895,2024-10-04 19:23:07,0,0,0,0,0,0
2,201392387,2170660915,0,0,2024-10-04 19:23:07,0,0,0,0,0,0
2,201392387,2170660915,39639,36895,2024-10-04 19:23:08,0,0,0,0,0,0
2,201392387,2170660915,22663,36895,2024-10-04 19:23:08,0,0,0,0,0,0
2,201392387,2170660915,8833,36895,2024-10-04 19:23:08,0,0,0,0,0,0
2,201392387,2170660915,0,0,2024-10-04 19:23:08,128,84,212,1,1,2
2,201392387,2170660915,39639,36895,2024-10-04 19:23:09,0,0,0,0,0,0
2,201392387,2170660915,22663,36895,2024-10-04 19:23:09,0,0,0,0,0,0
2,201392387,2170660915,8833,36895,2024-10-04 19:23:09,0,0,0,0,0,0
2,201392387,2170660915,0,0,2024-10-04 19:23:09,128,84,212,1,1,2
2,201392387,2170660915,39639,36895,2024-10-04 19:23:10,0,0,0,0,0,0
2,201392387,2170660915,22663,36895,2024-10-04 19:23:10,0,0,0,0,0,0
2,201392387,2170660915,8833,36895,2024-10-04 19:23:10,0,0,0,0,0,0
2,201392387,2170660915,0,0,2024-10-04 19:23:10,128,84,212,1,1,2
2,201392387,2170660915,39639,36895,2024-10-04 19:23:11,0,0,0,0,0,0
2,201392387,2170660915,22663,36895,2024-10-04 19:23:11,0,0,0,0,0,0
2,201392387,2170660915,8833,36895,2024-10-04 19:23:11,0,0,0,0,0,0
2,201392387,2170660915,0,0,2024-10-04 19:23:11,0,0,0,0,0,0
2,201392387,2170660915,39639,36895,2024-10-04 19:23:12,0,0,0,0,0,0
2,201392387,2170660915,22663,36895,2024-10-04 19:23:12,0,0,0,0,0,0
2,201392387,2170660915,8833,36895,2024-10-04 19:23:12,0,0,0,0,0,0
2,201392387,2170660915,0,0,2024-10-04 19:23:12,0,0,0,0,0,0
2,201392387,2170660915,39639,36895,2024-10-04 19:23:13,0,0,0,0,0,0
2,201392387,2170660915,22663,36895,2024-10-04 19:23:13,0,0,0,0,0,0
2,201392387,2170660915,8833,36895,2024-10-04 19:23:13,0,0,0,0,0,0
2,201392387,2170660915,0,0,2024-10-04 19:23:13,128,0,128,1,0,1
2,201392387,2170660915,39639,36895,2024-10-04 19:23:14,0,0,0,0,0,0
2,201392387,2170660915,22663,36895,2024-10-04 19:23:14,0,0,0,0,0,0
2,201392387,2170660915,8833,36895,2024-10-04 19:23:14,0,0,0,0,0,0
2,201392387,2170660915,0,0,2024-10-04 19:23:14,128,84,212,1,1,2
2,201392387,2170660915,39639,36895,2024-10-04 19:23:15,0,0,0,0,0,0
2,201392387,2170660915,22663,36895,2024-10-04 19:23:15,0,0,0,0,0,0
2,201392387,2170660915,8833,36895,2024-10-04 19:23:15,0,0,0,0,0,0
2,201392387,2170660915,0,0,2024-10-04 19:23:15,128,84,212,1,1,2
2,201392387,2170660915,39639,36895,2024-10-04 19:23:16,0,0,0,0,0,0
2,201392387,1145490691,17637,47873,2024-10-04 19:23:16,5580,86893,92473,47,66,113
2,201392387,2170660915,22663,36895,2024-10-04 19:23:16,0,0,0,0,0,0
2,201392387,2170660915,8833,36895,2024-10-04 19:23:16,0,0,0,0,0,0
2,201392387,2170660915,0,0,2024-10-04 19:23:16,0,84,84,0,1,1
2,201392387,2170660915,39639,36895,2024-10-04 19:23:17,0,0,0,0,0,0
2,201392387,1145490691,17637,47873,2024-10-04 19:23:17,1008,10271,11279,10,9,19
2,201392387,2170660915,22663,36895,2024-10-04 19:23:17,0,0,0,0,0,0
2,201392387,2170660915,8833,36895,2024-10-04 19:23:17,0,0,0,0,0,0
2,201392387,2170660915,0,0,2024-10-04 19:23:17,0,0,0,0,0,0
2,201392387,2170660915,39639,36895,2024-10-04 19:23:18,0,0,0,0,0,0
2,201392387,1145490691,17637,47873,2024-10-04 19:23:18,0,0,0,0,0,0
2,201392387,2170660915,22663,36895,2024-10-04 19:23:18,0,0,0,0,0,0
2,201392387,2170660915,8833,36895,2024-10-04 19:23:18,0,0,0,0,0,0
2,201392387,2170660915,0,0,2024-10-04 19:23:18,0,0,0,0,0,0
2,201392387,2170660915,39639,36895,2024-10-04 19:23:19,0,0,0,0,0,0
2,201392387,1145490691,17637,47873,2024-10-04 19:23:19,0,0,0,0,0,0
2,201392387,2170660915,22663,36895,2024-10-04 19:23:19,0,0,0,0,0,0
2,201392387,2170660915,8833,36895,2024-10-04 19:23:19,0,0,0,0,0,0
2,201392387,2170660915,0,0,2024-10-04 19:23:19,0,0,0,0,0,0
2,201392387,2170660915,39639,36895,2024-10-04 19:23:20,0,0,0,0,0,0
2,201392387,1145490691,17637,47873,2024-10-04 19:23:20,0,0,0,0,0,0
2,201392387,2170660915,22663,36895,2024-10-04 19:23:20,0,0,0,0,0,0
2,201392387,2170660915,8833,36895,2024-10-04 19:23:20,0,0,0,0,0,0
2,201392387,2170660915,0,0,2024-10-04 19:23:20,0,0,0,0,0,0
2,201392387,2170660915,39639,36895,2024-10-04 19:23:21,0,0,0,0,0,0
2,201392387,1145490691,17637,47873,2024-10-04 19:23:21,0,0,0,0,0,0
2,201392387,2170660915,22663,36895,2024-10-04 19:23:21,0,0,0,0,0,0
2,201392387,2170660915,8833,36895,2024-10-04 19:23:21,0,0,0,0,0,0
2,201392387,2170660915,0,0,2024-10-04 19:23:21,0,0,0,0,0,0
2,201392387,2170660915,39639,36895,2024-10-04 19:23:22,0,0,0,0,0,0
2,201392387,1145490691,17637,47873,2024-10-04 19:23:22,0,0,0,0,0,0
2,201392387,2170660915,22663,36895,2024-10-04 19:23:22,0,0,0,0,0,0
2,201392387,2170660915,8833,36895,2024-10-04 19:23:22,0,0,0,0,0,0
2,201392387,2170660915,0,0,2024-10-04 19:23:22,0,0,0,0,0,0
2,201392387,2170660915,39639,36895,2024-10-04 19:23:23,0,0,0,0,0,0
2,201392387,1145490691,17637,47873,2024-10-04 19:23:23,0,0,0,0,0,0
2,201392387,2170660915,22663,36895,2024-10-04 19:23:23,0,0,0,0,0,0
2,201392387,2170660915,8833,36895,2024-10-04 19:23:23,0,0,0,0,0,0
2,201392387,2170660915,0,0,2024-10-04 19:23:23,0,0,0,0,0,0
2,201392387,2170660915,39639,36895,2024-10-04 19:23:24,0,0,0,0,0,0
2,201392387,1145490691,17637,47873,2024-10-04 19:23:24,0,0,0,0,0,0
2,201392387,2170660915,22663,36895,2024-10-04 19:23:24,0,0,0,0,0,0
2,201392387,2170660915,8833,36895,2024-10-04 19:23:24,0,0,0,0,0,0
2,201392387,2170660915,0,0,2024-10-04 19:23:24,0,0,0,0,0,0
2,201392387,2170660915,39639,36895,2024-10-04 19:23:25,0,0,0,0,0,0
2,201392387,1145490691,17637,47873,2024-10-04 19:23:25,0,0,0,0,0,0
2,201392387,2170660915,22663,36895,2024-10-04 19:23:25,0,0,0,0,0,0
2,201392387,2170660915,8833,36895,2024-10-04 19:23:25,0,0,0,0,0,0
2,201392387,2170660915,0,0,2024-10-04 19:23:25,0,0,0,0,0,0
2,201392387,2170660915,39639,36895,2024-10-04 19:23:26,0,0,0,0,0,0
2,201392387,1145490691,17637,47873,2024-10-04 19:23:26,0,0,0,0,0,0
2,201392387,2170660915,22663,36895,2024-10-04 19:23:26,0,0,0,0,0,0
2,201392387,2170660915,8833,36895,2024-10-04 19:23:26,0,0,0,0,0,0
2,201392387,2170660915,0,0,2024-10-04 19:23:26,128,0,128,1,0,1
2,201392387,2170660915,39639,36895,2024-10-04 19:23:27,0,0,0,0,0,0
2,201392387,1145490691,17637,47873,2024-10-04 19:23:27,0,0,0,0,0,0
2,201392387,2170660915,22663,36895,2024-10-04 19:23:27,0,0,0,0,0,0
2,201392387,2170660915,8833,36895,2024-10-04 19:23:27,0,0,0,0,0,0
2,201392387,2170660915,0,0,2024-10-04 19:23:27,0,84,84,0,1,1
2,201392387,2170660915,39639,36895,2024-10-04 19:23:28,0,0,0,0,0,0
2,201392387,1145490691,17637,47873,2024-10-04 19:23:28,0,0,0,0,0,0
2,201392387,2170660915,22663,36895,2024-10-04 19:23:28,0,0,0,0,0,0
2,201392387,2170660915,8833,36895,2024-10-04 19:23:28,0,0,0,0,0,0
2,201392387,2170660915,0,0,2024-10-04 19:23:28,128,84,212,1,1,2
2,201392387,2170660915,39639,36895,2024-10-04 19:23:29,0,0,0,0,0,0
2,201392387,1145490691,17637,47873,2024-10-04 19:23:29,0,0,0,0,0,0
2,201392387,2170660915,22663,36895,2024-10-04 19:23:29,0,0,0,0,0,0
2,201392387,2170660915,8833,36895,2024-10-04 19:23:29,0,0,0,0,0,0
2,201392387,2170660915,0,0,2024-10-04 19:23:29,128,84,212,1,1,2
2,201392387,2170660915,39639,36895,2024-10-04 19:23:30,0,0,0,0,0,0
2,201392387,1145490691,17637,47873,2024-10-04 19:23:30,0,0,0,0,0,0
2,201392387,2170660915,22663,36895,2024-10-04 19:23:30,0,0,0,0,0,0
2,201392387,2170660915,8833,36895,2024-10-04 19:23:30,0,0,0,0,0,0
2,201392387,2170660915,0,0,2024-10-04 19:23:30,128,84,212,1,1,2
2,201392387,2170660915,39639,36895,2024-10-04 19:23:31,0,0,0,0,0,0
2,201392387,1145490691,17637,47873,2024-10-04 19:23:31,0,0,0,0,0,0
2,201392387,2170660915,22663,36895,2024-10-04 19:23:31,0,0,0,0,0,0
2,201392387,2170660915,8833,36895,2024-10-04 19:23:31,0,0,0,0,0,0
2,201392387,2170660915,0,0,2024-10-04 19:23:31,128,84,212,1,1,2
2,201392387,2170660915,39639,36895,2024-10-04 19:23:32,0,0,0,0,0,0
2,201392387,1145490691,17637,47873,2024-10-04 19:23:32,0,0,0,0,0,0
2,201392387,2170660915,22663,36895,2024-10-04 19:23:32,0,0,0,0,0,0
2,201392387,2170660915,8833,36895,2024-10-04 19:23:32,0,0,0,0,0,0
2,201392387,2170660915,0,0,2024-10-04 19:23:32,128,84,212,1,1,2
2,201392387,2170660915,39639,36895,2024-10-04 19:23:33,0,0,0,0,0,0
2,201392387,1145490691,17637,47873,2024-10-04 19:23:33,0,0,0,0,0,0
2,201392387,2170660915,22663,36895,2024-10-04 19:23:33,0,0,0,0,0,0
2,201392387,2170660915,8833,36895,2024-10-04 19:23:33,0,0,0,0,0,0
2,201392387,2170660915,0,0,2024-10-04 19:23:33,128,84,212,1,1,2
2,201392387,2170660915,39639,36895,2024-10-04 19:23:34,0,0,0,0,0,0
2,201392387,1145490691,17637,47873,2024-10-04 19:23:34,0,0,0,0,0,0
2,201392387,2170660915,22663,36895,2024-10-04 19:23:34,0,0,0,0,0,0
2,201392387,2170660915,8833,36895,2024-10-04 19:23:34,0,0,0,0,0,0
2,201392387,2170660915,0,0,2024-10-04 19:23:34,128,84,212,1,1,2
2,201392387,2170660915,39639,36895,2024-10-04 19:23:35,0,0,0,0,0,0
2,201392387,1145490691,17637,47873,2024-10-04 19:23:35,0,0,0,0,0,0
2,201392387,2170660915,22663,36895,2024-10-04 19:23:35,0,0,0,0,0,0
2,201392387,2170660915,8833,36895,2024-10-04 19:23:35,0,0,0,0,0,0
2,201392387,2170660915,0,0,2024-10-04 19:23:35,128,84,212,1,1,2
2,201392387,2170660915,39639,36895,2024-10-04 19:23:36,0,0,0,0,0,0
2,201392387,1145490691,17637,47873,2024-10-04 19:23:36,0,0,0,0,0,0
2,201392387,2170660915,22663,36895,2024-10-04 19:23:36,0,0,0,0,0,0
2,201392387,2170660915,8833,36895,2024-10-04 19:23:36,0,0,0,0,0,0
2,201392387,2170660915,0,0,2024-10-04 19:23:36,128,84,212,1,1,2
2,201392387,2170660915,39639,36895,2024-10-04 19:23:37,0,0,0,0,0,0
2,201392387,1145490691,17637,47873,2024-10-04 19:23:37,0,0,0,0,0,0
2,201392387,2170660915,22663,36895,2024-10-04 19:23:37,0,0,0,0,0,0
2,201392387,2170660915,8833,36895,2024-10-04 19:23:37,0,0,0,0,0,0
2,201392387,2170660915,0,0,2024-10-04 19:23:37,0,0,0,0,0,0
2,201392387,2170660915,39639,36895,2024-10-04 19:23:38,0,0,0,0,0,0
2,201392387,2170660915,41158,36895,2024-10-04 19:23:38,570,455,1025,5,5,10
2,201392387,2170660915,22663,36895,2024-10-04 19:23:38,0,0,0,0,0,0
2,201392387,2170660915,0,0,2024-10-04 19:23:38,0,0,0,0,0,0
2,201392387,2170660915,39639,36895,2024-10-04 19:23:39,0,0,0,0,0,0
2,201392387,2170660915,41158,36895,2024-10-04 19:23:39,0,0,0,0,0,0
2,201392387,2170660915,22663,36895,2024-10-04 19:23:39,0,0,0,0,0,0
2,201392387,2170660915,0,0,2024-10-04 19:23:39,256,84,340,2,1,3
2,201392387,2170660915,39639,36895,2024-10-04 19:23:40,0,0,0,0,0,0
2,201392387,2170660915,41158,36895,2024-10-04 19:23:40,0,0,0,0,0,0
2,201392387,2170660915,22663,36895,2024-10-04 19:23:40,0,0,0,0,0,0
2,201392387,2170660915,0,0,2024-10-04 19:23:40,128,84,212,1,1,2
2,201392387,2170660915,39639,36895,2024-10-04 19:23:41,0,0,0,0,0,0
2,201392387,2170660915,41158,36895,2024-10-04 19:23:41,0,0,0,0,0,0
2,201392387,2170660915,22663,36895,2024-10-04 19:23:41,0,0,0,0,0,0
2,201392387,2170660915,0,0,2024-10-04 19:23:41,0,84,84,0,1,1
2,201392387,2170660915,39639,36895,2024-10-04 19:23:42,0,0,0,0,0,0
2,201392387,2170660915,41158,36895,2024-10-04 19:23:42,0,0,0,0,0,0
2,201392387,2170660915,22663,36895,2024-10-04 19:23:42,0,0,0,0,0,0
2,201392387,2170660915,0,0,2024-10-04 19:23:42,0,0,0,0,0,0
2,201392387,2170660915,39639,36895,2024-10-04 19:23:43,0,0,0,0,0,0
2,201392387,2170660915,41158,36895,2024-10-04 19:23:43,0,0,0,0,0,0
2,201392387,2170660915,22663,36895,2024-10-04 19:23:43,0,0,0,0,0,0
2,201392387,2170660915,0,0,2024-10-04 19:23:43,0,0,0,0,0,0
2,201392387,2170660915,39639,36895,2024-10-04 19:23:44,0,0,0,0,0,0
2,201392387,2170660915,41158,36895,2024-10-04 19:23:44,0,0,0,0,0,0
2,201392387,2170660915,22663,36895,2024-10-04 19:23:44,0,0,0,0,0,0
2,201392387,2170660915,0,0,2024-10-04 19:23:44,128,0,128,1,0,1
2,201392387,2170660915,39639,36895,2024-10-04 19:23:45,0,0,0,0,0,0
2,201392387,2170660915,41158,36895,2024-10-04 19:23:45,0,0,0,0,0,0
2,201392387,2170660915,22663,36895,2024-10-04 19:23:45,0,0,0,0,0,0
2,201392387,2170660915,0,0,2024-10-04 19:23:45,128,168,296,1,2,3
2,201392387,2170660915,39639,36895,2024-10-04 19:23:46,0,0,0,0,0,0
2,201392387,2170660915,41158,36895,2024-10-04 19:23:46,0,0,0,0,0,0
2,201392387,2170660915,22663,36895,2024-10-04 19:23:46,0,0,0,0,0,0
2,201392387,1145490690,3276,47873,2024-10-04 19:23:46,2960,30268,33228,21,29,50
2,201392387,2170660915,0,0,2024-10-04 19:23:46,128,84,212,1,1,2
2,201392387,2170660915,39639,36895,2024-10-04 19:23:47,0,0,0,0,0,0
2,201392387,2170660915,22663,36895,2024-10-04 19:23:47,0,0,0,0,0,0
2,201392387,1145490690,3276,47873,2024-10-04 19:23:47,3492,73020,76512,34,49,83
2,201392387,2170660915,0,0,2024-10-04 19:23:47,0,0,0,0,0,0
2,201392387,2170660915,39639,36895,2024-10-04 19:23:48,0,0,0,0,0,0
2,201392387,2170660915,22663,36895,2024-10-04 19:23:48,0,0,0,0,0,0
2,201392387,1145490690,3276,47873,2024-10-04 19:23:48,96,0,96,1,0,1
2,201392387,2170660915,0,0,2024-10-04 19:23:48,0,0,0,0,0,0
2,201392387,2170660915,39639,36895,2024-10-04 19:23:49,0,0,0,0,0,0
2,201392387,2170660915,22663,36895,2024-10-04 19:23:49,0,0,0,0,0,0
2,201392387,1145490690,3276,47873,2024-10-04 19:23:49,0,0,0,0,0,0
2,201392387,2170660915,0,0,2024-10-04 19:23:49,0,0,0,0,0,0
2,201392387,2170660915,39639,36895,2024-10-04 19:23:50,0,0,0,0,0,0
2,201392387,2170660915,22663,36895,2024-10-04 19:23:50,0,0,0,0,0,0
2,201392387,1145490690,3276,47873,2024-10-04 19:23:50,0,0,0,0,0,0
2,201392387,2170660915,0,0,2024-10-04 19:23:50,0,0,0,0,0,0
2,201392387,2170660915,39639,36895,2024-10-04 19:23:51,0,0,0,0,0,0
2,201392387,2170660915,22663,36895,2024-10-04 19:23:51,0,0,0,0,0,0
2,201392387,1145490690,3276,47873,2024-10-04 19:23:51,0,0,0,0,0,0
2,201392387,2170660915,0,0,2024-10-04 19:23:51,0,0,0,0,0,0
2,201392387,2170660915,39639,36895,2024-10-04 19:23:52,0,0,0,0,0,0
2,201392387,2170660915,22663,36895,2024-10-04 19:23:52,0,0,0,0,0,0
2,201392387,1145490690,3276,47873,2024-10-04 19:23:52,0,0,0,0,0,0
2,201392387,2170660915,0,0,2024-10-04 19:23:52,0,0,0,0,0,0
2,201392387,2170660915,39639,36895,2024-10-04 19:23:53,0,0,0,0,0,0
2,201392387,2170660915,22663,36895,2024-10-04 19:23:53,0,0,0,0,0,0
2,201392387,1145490690,3276,47873,2024-10-04 19:23:53,0,0,0,0,0,0
2,201392387,2170660915,0,0,2024-10-04 19:23:53,0,0,0,0,0,0
2,201392387,2170660915,39639,36895,2024-10-04 19:23:54,0,0,0,0,0,0
2,201392387,2170660915,22663,36895,2024-10-04 19:23:54,0,0,0,0,0,0
2,201392387,1145490690,3276,47873,2024-10-04 19:23:54,0,0,0,0,0,0
2,201392387,2170660915,0,0,2024-10-04 19:23:54,0,0,0,0,0,0
2,201392387,2170660915,39639,36895,2024-10-04 19:23:55,0,0,0,0,0,0
2,201392387,2170660915,22663,36895,2024-10-04 19:23:55,0,0,0,0,0,0
2,201392387,1145490690,3276,47873,2024-10-04 19:23:55,0,0,0,0,0,0
2,201392387,2170660915,0,0,2024-10-04 19:23:55,0,0,0,0,0,0
2,201392387,2170660915,39639,36895,2024-10-04 19:23:56,0,0,0,0,0,0
2,201392387,2170660915,22663,36895,2024-10-04 19:23:56,0,0,0,0,0,0
2,201392387,1145490690,3276,47873,2024-10-04 19:23:56,0,0,0,0,0,0
2,201392387,2170660915,0,0,2024-10-04 19:23:56,0,0,0,0,0,0
2,201392387,2170660915,39639,36895,2024-10-04 19:23:57,0,0,0,0,0,0
2,201392387,2170660915,22663,36895,2024-10-04 19:23:57,0,0,0,0,0,0
2,201392387,1145490690,3276,47873,2024-10-04 19:23:57,0,0,0,0,0,0
2,201392387,2170660915,0,0,2024-10-04 19:23:57,128,0,128,1,0,1
2,201392387,2170660915,39639,36895,2024-10-04 19:23:58,0,0,0,0,0,0
2,201392387,2170660915,22663,36895,2024-10-04 19:23:58,0,0,0,0,0,0
2,201392387,1145490690,3276,47873,2024-10-04 19:23:58,0,0,0,0,0,0
2,201392387,2170660915,0,0,2024-10-04 19:23:58,128,168,296,1,2,3
2,201392387,2170660915,39639,36895,2024-10-04 19:23:59,0,0,0,0,0,0
2,201392387,2170660915,22663,36895,2024-10-04 19:23:59,0,0,0,0,0,0
2,201392387,1145490690,3276,47873,2024-10-04 19:23:59,0,0,0,0,0,0
2,201392387,2170660915,0,0,2024-10-04 19:23:59,128,84,212,1,1,2
2,201392387,2170660915,39639,36895,2024-10-04 19:24:00,0,0,0,0,0,0
2,201392387,2170660915,22663,36895,2024-10-04 19:24:00,0,0,0,0,0,0
2,201392387,1145490690,3276,47873,2024-10-04 19:24:00,0,0,0,0,0,0
2,201392387,2170660915,0,0,2024-10-04 19:24:00,128,0,128,1,0,1
2,201392387,2170660915,39639,36895,2024-10-04 19:24:01,0,0,0,0,0,0
2,201392387,2170660915,22663,36895,2024-10-04 19:24:01,0,0,0,0,0,0
2,201392387,1145490690,3276,47873,2024-10-04 19:24:01,0,0,0,0,0,0
2,201392387,2170660915,0,0,2024-10-04 19:24:01,128,84,212,1,1,2
2,201392387,2170660915,39639,36895,2024-10-04 19:24:02,0,0,0,0,0,0
2,201392387,2170660915,22663,36895,2024-10-04 19:24:02,0,0,0,0,0,0
2,201392387,1145490690,3276,47873,2024-10-04 19:24:02,0,0,0,0,0,0
2,201392387,2170660915,0,0,2024-10-04 19:24:02,128,84,212,1,1,2
2,201392387,2170660915,39639,36895,2024-10-04 19:24:03,0,0,0,0,0,0
2,201392387,2170660915,22663,36895,2024-10-04 19:24:03,0,0,0,0,0,0
2,201392387,1145490690,3276,47873,2024-10-04 19:24:03,0,0,0,0,0,0
2,201392387,2170660915,0,0,2024-10-04 19:24:03,128,84,212,1,1,2
2,201392387,2170660915,39639,36895,2024-10-04 19:24:04,0,0,0,0,0,0
2,201392387,2170660915,22663,36895,2024-10-04 19:24:04,0,0,0,0,0,0
2,201392387,1145490690,3276,47873,2024-10-04 19:24:04,0,0,0,0,0,0
2,201392387,2170660915,0,0,2024-10-04 19:24:04,128,84,212,1,1,2
2,201392387,2170660915,39639,36895,2024-10-04 19:24:05,0,0,0,0,0,0
2,201392387,2170660915,22663,36895,2024-10-04 19:24:05,0,0,0,0,0,0
2,201392387,1145490690,3276,47873,2024-10-04 19:24:05,0,0,0,0,0,0
2,201392387,2170660915,0,0,2024-10-04 19:24:05,128,84,212,1,1,2
2,201392387,2170660915,39639,36895,2024-10-04 19:24:06,0,0,0,0,0,0
2,201392387,2170660915,22663,36895,2024-10-04 19:24:06,0,0,0,0,0,0
2,201392387,1145490690,3276,47873,2024-10-04 19:24:06,0,0,0,0,0,0
2,201392387,2170660915,0,0,2024-10-04 19:24:06,128,84,212,1,1,2
2,201392387,2170660915,39639,36895,2024-10-04 19:24:07,0,0,0,0,0,0
2,201392387,2170660915,22663,36895,2024-10-04 19:24:07,0,0,0,0,0,0
2,201392387,1145490690,3276,47873,2024-10-04 19:24:07,0,0,0,0,0,0
2,201392387,2170660915,0,0,2024-10-04 19:24:07,0,84,84,0,1,1
2,201392387,2170660915,39639,36895,2024-10-04 19:24:08,0,0,0,0,0,0
2,201392387,2170660915,22663,36895,2024-10-04 19:24:08,0,0,0,0,0,0
2,201392387,2170660915,53909,36895,2024-10-04 19:24:08,666,507,1173,6,6,12
2,201392387,2170660915,0,0,2024-10-04 19:24:08,0,0,0,0,0,0
2,201392387,2170660915,39639,36895,2024-10-04 19:24:09,0,0,0,0,0,0
2,201392387,2170660915,22663,36895,2024-10-04 19:24:09,0,0,0,0,0,0
2,201392387,2170660915,53909,36895,2024-10-04 19:24:09,0,0,0,0,0,0
2,201392387,2170660915,0,0,2024-10-04 19:24:09,128,84,212,1,1,2
2,201392387,2170660915,39639,36895,2024-10-04 19:24:10,0,0,0,0,0,0
2,201392387,2170660915,22663,36895,2024-10-04 19:24:10,0,0,0,0,0,0
2,201392387,2170660915,53909,36895,2024-10-04 19:24:10,0,0,0,0,0,0
2,201392387,2170660915,0,0,2024-10-04 19:24:10,128,84,212,1,1,2
2,201392387,2170660915,39639,36895,2024-10-04 19:24:11,0,0,0,0,0,0
2,201392387,2170660915,22663,36895,2024-10-04 19:24:11,0,0,0,0,0,0
2,201392387,2170660915,53909,36895,2024-10-04 19:24:11,0,0,0,0,0,0
2,201392387,2170660915,0,0,2024-10-04 19:24:11,128,84,212,1,1,2
2,201392387,2170660915,39639,36895,2024-10-04 19:24:12,0,0,0,0,0,0
2,201392387,2170660915,22663,36895,2024-10-04 19:24:12,0,0,0,0,0,0
2,201392387,2170660915,53909,36895,2024-10-04 19:24:12,0,0,0,0,0,0
2,201392387,2170660915,0,0,2024-10-04 19:24:12,0,0,0,0,0,0
2,201392387,2170660915,39639,36895,2024-10-04 19:24:13,0,0,0,0,0,0
2,201392387,2170660915,22663,36895,2024-10-04 19:24:13,0,0,0,0,0,0
2,201392387,2170660915,53909,36895,2024-10-04 19:24:13,0,0,0,0,0,0
2,201392387,2170660915,0,0,2024-10-04 19:24:13,0,0,0,0,0,0
2,201392387,2170660915,39639,36895,2024-10-04 19:24:14,0,0,0,0,0,0
2,201392387,2170660915,22663,36895,2024-10-04 19:24:14,0,0,0,0,0,0
2,201392387,2170660915,53909,36895,2024-10-04 19:24:14,0,0,0,0,0,0
2,201392387,2170660915,0,0,2024-10-04 19:24:14,0,0,0,0,0,0
2,201392387,2170660915,39639,36895,2024-10-04 19:24:15,0,0,0,0,0,0
2,201392387,2170660915,22663,36895,2024-10-04 19:24:15,0,0,0,0,0,0
2,201392387,2170660915,53909,36895,2024-10-04 19:24:15,0,0,0,0,0,0
2,201392387,2170660915,0,0,2024-10-04 19:24:15,128,0,128,1,0,1
2,201392387,2170660915,39639,36895,2024-10-04 19:24:16,0,0,0,0,0,0
2,201392387,2170660915,22663,36895,2024-10-04 19:24:16,0,0,0,0,0,0
2,201392387,2170660915,53909,36895,2024-10-04 19:24:16,0,0,0,0,0,0
2,201392387,2170660915,0,0,2024-10-04 19:24:16,128,84,212,1,1,2
2,201392387,2170660915,39639,36895,2024-10-04 19:24:17,0,0,0,0,0,0
2,201392387,2170660915,22663,36895,2024-10-04 19:24:17,0,0,0,0,0,0
2,201392387,1145490690,28803,47873,2024-10-04 19:24:17,2856,30529,33385,20,29,49
2,201392387,2170660915,53909,36895,2024-10-04 19:24:17,0,0,0,0,0,0
2,201392387,2170660915,0,0,2024-10-04 19:24:17,128,168,296,1,2,3
2,201392387,2170660915,39639,36895,2024-10-04 19:24:18,0,0,0,0,0,0
2,201392387,2170660915,22663,36895,2024-10-04 19:24:18,0,0,0,0,0,0
2,201392387,1145490690,28803,47873,2024-10-04 19:24:18,1932,49124,51056,19,32,51
2,201392387,2170660915,53909,36895,2024-10-04 19:24:18,0,0,0,0,0,0
2,201392387,2170660915,0,0,2024-10-04 19:24:18,0,0,0,0,0,0
2,201392387,2170660915,39639,36895,2024-10-04 19:24:19,0,0,0,0,0,0
2,201392387,2170660915,22663,36895,2024-10-04 19:24:19,0,0,0,0,0,0
2,201392387,1145490690,28803,47873,2024-10-04 19:24:19,0,0,0,0,0,0
2,201392387,2170660915,53909,36895,2024-10-04 19:24:19,0,0,0,0,0,0
2,201392387,2170660915,0,0,2024-10-04 19:24:19,0,0,0,0,0,0
2,201392387,2170660915,39639,36895,2024-10-04 19:24:20,0,0,0,0,0,0
2,201392387,2170660915,22663,36895,2024-10-04 19:24:20,0,0,0,0,0,0
2,201392387,1145490690,28803,47873,2024-10-04 19:24:20,0,0,0,0,0,0
2,201392387,2170660915,53909,36895,2024-10-04 19:24:20,0,0,0,0,0,0
2,201392387,2170660915,0,0,2024-10-04 19:24:20,0,0,0,0,0,0
2,201392387,2170660915,39639,36895,2024-10-04 19:24:21,0,0,0,0,0,0
2,201392387,2170660915,22663,36895,2024-10-04 19:24:21,0,0,0,0,0,0
2,201392387,1145490690,28803,47873,2024-10-04 19:24:21,0,0,0,0,0,0
2,201392387,2170660915,53909,36895,2024-10-04 19:24:21,0,0,0,0,0,0
2,201392387,2170660915,0,0,2024-10-04 19:24:21,0,0,0,0,0,0
2,201392387,2170660915,39639,36895,2024-10-04 19:24:22,0,0,0,0,0,0
2,201392387,2170660915,22663,36895,2024-10-04 19:24:22,0,0,0,0,0,0
2,201392387,1145490690,28803,47873,2024-10-04 19:24:22,0,0,0,0,0,0
2,201392387,2170660915,53909,36895,2024-10-04 19:24:22,0,0,0,0,0,0
2,201392387,2170660915,0,0,2024-10-04 19:24:22,0,0,0,0,0,0
2,201392387,2170660915,39639,36895,2024-10-04 19:24:23,0,0,0,0,0,0
2,201392387,2170660915,22663,36895,2024-10-04 19:24:23,0,0,0,0,0,0
2,201392387,1145490690,28803,47873,2024-10-04 19:24:23,0,0,0,0,0,0
2,201392387,2170660915,53909,36895,2024-10-04 19:24:23,0,0,0,0,0,0
2,201392387,2170660915,0,0,2024-10-04 19:24:23,0,0,0,0,0,0
2,201392387,2170660915,39639,36895,2024-10-04 19:24:24,0,0,0,0,0,0
2,201392387,2170660915,22663,36895,2024-10-04 19:24:24,0,0,0,0,0,0
2,201392387,1145490690,28803,47873,2024-10-04 19:24:24,0,0,0,0,0,0
2,201392387,2170660915,53909,36895,2024-10-04 19:24:24,0,0,0,0,0,0
2,201392387,2170660915,0,0,2024-10-04 19:24:24,0,0,0,0,0,0
2,201392387,2170660915,39639,36895,2024-10-04 19:24:25,0,0,0,0,0,0
2,201392387,2170660915,22663,36895,2024-10-04 19:24:25,0,0,0,0,0,0
2,201392387,1145490690,28803,47873,2024-10-04 19:24:25,0,0,0,0,0,0
2,201392387,2170660915,53909,36895,2024-10-04 19:24:25,0,0,0,0,0,0
2,201392387,2170660915,0,0,2024-10-04 19:24:25,0,0,0,0,0,0
2,201392387,2170660915,39639,36895,2024-10-04 19:24:26,0,0,0,0,0,0
2,201392387,2170660915,22663,36895,2024-10-04 19:24:26,0,0,0,0,0,0
2,201392387,1145490690,28803,47873,2024-10-04 19:24:26,0,0,0,0,0,0
2,201392387,2170660915,53909,36895,2024-10-04 19:24:26,0,0,0,0,0,0
2,201392387,2170660915,0,0,2024-10-04 19:24:26,0,0,0,0,0,0
2,201392387,2170660915,39639,36895,2024-10-04 19:24:27,0,0,0,0,0,0
2,201392387,2170660915,22663,36895,2024-10-04 19:24:27,0,0,0,0,0,0
2,201392387,1145490690,28803,47873,2024-10-04 19:24:27,0,0,0,0,0,0
2,201392387,2170660915,53909,36895,2024-10-04 19:24:27,0,0,0,0,0,0
2,201392387,2170660915,0,0,2024-10-04 19:24:27,0,0,0,0,0,0
2,201392387,2170660915,39639,36895,2024-10-04 19:24:28,0,0,0,0,0,0
2,201392387,2170660915,22663,36895,2024-10-04 19:24:28,0,0,0,0,0,0
2,201392387,1145490690,28803,47873,2024-10-04 19:24:28,1308,23717,25025,13,19,32
2,201392387,2170660915,53909,36895,2024-10-04 19:24:28,0,0,0,0,0,0
2,201392387,2170660915,0,0,2024-10-04 19:24:28,0,0,0,0,0,0
2,201392387,2170660915,39639,36895,2024-10-04 19:24:29,0,0,0,0,0,0
2,201392387,2170660915,22663,36895,2024-10-04 19:24:29,0,0,0,0,0,0
2,201392387,1145490690,28803,47873,2024-10-04 19:24:29,0,0,0,0,0,0
2,201392387,2170660915,53909,36895,2024-10-04 19:24:29,0,0,0,0,0,0
2,201392387,2170660915,0,0,2024-10-04 19:24:29,128,84,212,1,1,2
2,201392387,2170660915,39639,36895,2024-10-04 19:24:30,0,0,0,0,0,0
2,201392387,2170660915,22663,36895,2024-10-04 19:24:30,0,0,0,0,0,0
2,201392387,1145490690,28803,47873,2024-10-04 19:24:30,0,0,0,0,0,0
2,201392387,2170660915,53909,36895,2024-10-04 19:24:30,0,0,0,0,0,0
2,201392387,2170660915,0,0,2024-10-04 19:24:30,128,84,212,1,1,2
2,201392387,2170660915,39639,36895,2024-10-04 19:24:31,0,0,0,0,0,0
2,201392387,2170660915,22663,36895,2024-10-04 19:24:31,0,0,0,0,0,0
2,201392387,1145490690,28803,47873,2024-10-04 19:24:31,0,0,0,0,0,0
2,201392387,2170660915,53909,36895,2024-10-04 19:24:31,0,0,0,0,0,0
2,201392387,2170660915,0,0,2024-10-04 19:24:31,128,84,212,1,1,2
2,201392387,2170660915,39639,36895,2024-10-04 19:24:32,0,0,0,0,0,0
2,201392387,2170660915,22663,36895,2024-10-04 19:24:32,0,0,0,0,0,0
2,201392387,1145490690,28803,47873,2024-10-04 19:24:32,0,0,0,0,0,0
2,201392387,2170660915,53909,36895,2024-10-04 19:24:32,0,0,0,0,0,0
2,201392387,2170660915,0,0,2024-10-04 19:24:32,128,84,212,1,1,2
2,201392387,2170660915,39639,36895,2024-10-04 19:24:33,0,0,0,0,0,0
2,201392387,2170660915,22663,36895,2024-10-04 19:24:33,0,0,0,0,0,0
2,201392387,1145490690,28803,47873,2024-10-04 19:24:33,0,0,0,0,0,0
2,201392387,2170660915,53909,36895,2024-10-04 19:24:33,0,0,0,0,0,0
2,201392387,2170660915,0,0,2024-10-04 19:24:33,128,84,212,1,1,2
2,201392387,2170660915,39639,36895,2024-10-04 19:24:34,0,0,0,0,0,0
2,201392387,2170660915,22663,36895,2024-10-04 19:24:34,0,0,0,0,0,0
2,201392387,1145490690,28803,47873,2024-10-04 19:24:34,0,0,0,0,0,0
2,201392387,2170660915,53909,36895,2024-10-04 19:24:34,0,0,0,0,0,0
2,201392387,2170660915,0,0,2024-10-04 19:24:34,128,84,212,1,1,2
2,201392387,2170660915,39639,36895,2024-10-04 19:24:35,0,0,0,0,0,0
2,201392387,2170660915,22663,36895,2024-10-04 19:24:35,0,0,0,0,0,0
2,201392387,1145490690,28803,47873,2024-10-04 19:24:35,0,0,0,0,0,0
2,201392387,2170660915,53909,36895,2024-10-04 19:24:35,0,0,0,0,0,0
2,201392387,2170660915,0,0,2024-10-04 19:24:35,128,84,212,1,1,2
2,201392387,2170660915,39639,36895,2024-10-04 19:24:36,0,0,0,0,0,0
2,201392387,2170660915,22663,36895,2024-10-04 19:24:36,0,0,0,0,0,0
2,201392387,1145490690,28803,47873,2024-10-04 19:24:36,0,0,0,0,0,0
2,201392387,2170660915,53909,36895,2024-10-04 19:24:36,0,0,0,0,0,0
2,201392387,2170660915,0,0,2024-10-04 19:24:36,128,84,212,1,1,2
2,201392387,2170660915,39639,36895,2024-10-04 19:24:37,0,0,0,0,0,0
2,201392387,2170660915,22663,36895,2024-10-04 19:24:37,0,0,0,0,0,0
2,201392387,1145490690,28803,47873,2024-10-04 19:24:37,0,0,0,0,0,0
2,201392387,2170660915,53909,36895,2024-10-04 19:24:37,0,0,0,0,0,0
2,201392387,2170660915,0,0,2024-10-04 19:24:37,128,84,212,1,1,2
2,201392387,2170660915,39639,36895,2024-10-04 19:24:38,0,0,0,0,0,0
2,201392387,2170660915,22663,36895,2024-10-04 19:24:38,0,0,0,0,0,0
2,201392387,1145490690,28803,47873,2024-10-04 19:24:38,0,0,0,0,0,0
2,201392387,2170660915,53909,36895,2024-10-04 19:24:38,0,0,0,0,0,0
2,201392387,2170660915,0,0,2024-10-04 19:24:38,128,84,212,1,1,2
2,201392387,2170660915,39639,36895,2024-10-04 19:24:39,0,0,0,0,0,0
2,201392387,2170660915,22663,36895,2024-10-04 19:24:39,0,0,0,0,0,0
2,201392387,2170660915,53909,36895,2024-10-04 19:24:39,0,0,0,0,0,0
2,201392387,2170660915,0,0,2024-10-04 19:24:39,0,0,0,0,0,0
2,201392387,2170660915,39639,36895,2024-10-04 19:24:40,0,0,0,0,0,0
2,201392387,2170660915,22663,36895,2024-10-04 19:24:40,0,0,0,0,0,0
2,201392387,2170660915,53909,36895,2024-10-04 19:24:40,0,0,0,0,0,0
2,201392387,2170660915,0,0,2024-10-04 19:24:40,0,0,0,0,0,0
2,201392387,2170660915,39639,36895,2024-10-04 19:24:41,0,0,0,0,0,0
2,201392387,2170660915,22663,36895,2024-10-04 19:24:41,0,0,0,0,0,0
2,201392387,2170660915,53926,36895,2024-10-04 19:24:41,666,507,1173,6,6,12
2,201392387,2170660915,0,0,2024-10-04 19:24:41,128,0,128,1,0,1
2,201392387,2170660915,39639,36895,2024-10-04 19:24:42,0,0,0,0,0,0
2,201392387,2170660915,22663,36895,2024-10-04 19:24:42,0,0,0,0,0,0
2,201392387,2170660915,53926,36895,2024-10-04 19:24:42,0,0,0,0,0,0
2,201392387,2170660915,0,0,2024-10-04 19:24:42,128,84,212,1,1,2
2,201392387,2170660915,39639,36895,2024-10-04 19:24:43,0,0,0,0,0,0
2,201392387,2170660915,22663,36895,2024-10-04 19:24:43,0,0,0,0,0,0
2,201392387,2170660915,53926,36895,2024-10-04 19:24:43,0,0,0,0,0,0
2,201392387,2170660915,0,0,2024-10-04 19:24:43,128,84,212,1,1,2
2,201392387,2170660915,39639,36895,2024-10-04 19:24:44,0,0,0,0,0,0
2,201392387,2170660915,22663,36895,2024-10-04 19:24:44,0,0,0,0,0,0
2,201392387,2170660915,53926,36895,2024-10-04 19:24:44,0,0,0,0,0,0
2,201392387,2170660915,0,0,2024-10-04 19:24:44,0,0,0,0,0,0
2,201392387,2170660915,39639,36895,2024-10-04 19:24:45,0,0,0,0,0,0
2,201392387,2170660915,22663,36895,2024-10-04 19:24:45,0,0,0,0,0,0
2,201392387,2170660915,53926,36895,2024-10-04 19:24:45,0,0,0,0,0,0
2,201392387,2170660915,0,0,2024-10-04 19:24:45,0,0,0,0,0,0
2,201392387,2170660915,39639,36895,2024-10-04 19:24:46,0,0,0,0,0,0
2,201392387,2170660915,22663,36895,2024-10-04 19:24:46,0,0,0,0,0,0
2,201392387,2170660915,53926,36895,2024-10-04 19:24:46,0,0,0,0,0,0
2,201392387,2170660915,0,0,2024-10-04 19:24:46,0,84,84,0,1,1
2,201392387,2170660915,39639,36895,2024-10-04 19:24:47,0,0,0,0,0,0
2,201392387,2170660915,22663,36895,2024-10-04 19:24:47,0,0,0,0,0,0
2,201392387,2170660915,53926,36895,2024-10-04 19:24:47,0,0,0,0,0,0
2,201392387,2170660915,0,0,2024-10-04 19:24:47,128,84,212,1,1,2
2,201392387,2170660915,39639,36895,2024-10-04 19:24:48,0,0,0,0,0,0
2,201392387,2170660915,22663,36895,2024-10-04 19:24:48,0,0,0,0,0,0
2,201392387,1145490689,25803,47873,2024-10-04 19:24:48,104,0,104,1,0,1
2,201392387,2170660915,53926,36895,2024-10-04 19:24:48,0,0,0,0,0,0
2,201392387,2170660915,0,0,2024-10-04 19:24:48,256,168,424,2,2,4
2,201392387,2170660915,39639,36895,2024-10-04 19:24:49,0,0,0,0,0,0
2,201392387,2170660915,22663,36895,2024-10-04 19:24:49,0,0,0,0,0,0
2,201392387,1145490689,25803,47873,2024-10-04 19:24:49,0,0,0,0,0,0
2,201392387,2170660915,53926,36895,2024-10-04 19:24:49,0,0,0,0,0,0
2,201392387,2170660915,0,0,2024-10-04 19:24:49,0,0,0,0,0,0
2,201392387,2170660915,39639,36895,2024-10-04 19:24:50,0,0,0,0,0,0
2,201392387,2170660915,22663,36895,2024-10-04 19:24:50,0,0,0,0,0,0
2,201392387,1145490689,25803,47873,2024-10-04 19:24:50,0,0,0,0,0,0
2,201392387,2170660915,53926,36895,2024-10-04 19:24:50,0,0,0,0,0,0
2,201392387,2170660915,0,0,2024-10-04 19:24:50,0,0,0,0,0,0
2,201392387,2170660915,39639,36895,2024-10-04 19:24:51,0,0,0,0,0,0
2,201392387,2170660915,22663,36895,2024-10-04 19:24:51,0,0,0,0,0,0
2,201392387,1145490689,25803,47873,2024-10-04 19:24:51,0,0,0,0,0,0
2,201392387,2170660915,53926,36895,2024-10-04 19:24:51,0,0,0,0,0,0
2,201392387,2170660915,0,0,2024-10-04 19:24:51,0,0,0,0,0,0
2,201392387,2170660915,39639,36895,2024-10-04 19:24:52,0,0,0,0,0,0
2,201392387,2170660915,22663,36895,2024-10-04 19:24:52,0,0,0,0,0,0
2,201392387,1145490689,25803,47873,2024-10-04 19:24:52,0,0,0,0,0,0
2,201392387,2170660915,53926,36895,2024-10-04 19:24:52,0,0,0,0,0,0
2,201392387,2170660915,0,0,2024-10-04 19:24:52,0,0,0,0,0,0
2,201392387,2170660915,39639,36895,2024-10-04 19:24:53,0,0,0,0,0,0
2,201392387,2170660915,22663,36895,2024-10-04 19:24:53,0,0,0,0,0,0
2,201392387,1145490689,25803,47873,2024-10-04 19:24:53,0,0,0,0,0,0
2,201392387,2170660915,53926,36895,2024-10-04 19:24:53,0,0,0,0,0,0
2,201392387,2170660915,0,0,2024-10-04 19:24:53,0,0,0,0,0,0
2,201392387,2170660915,39639,36895,2024-10-04 19:24:54,0,0,0,0,0,0
2,201392387,2170660915,22663,36895,2024-10-04 19:24:54,0,0,0,0,0,0
2,201392387,1145490689,25803,47873,2024-10-04 19:24:54,0,0,0,0,0,0
2,201392387,2170660915,53926,36895,2024-10-04 19:24:54,0,0,0,0,0,0
2,201392387,2170660915,0,0,2024-10-04 19:24:54,0,0,0,0,0,0
2,201392387,2170660915,39639,36895,2024-10-04 19:24:55,0,0,0,0,0,0
2,201392387,2170660915,22663,36895,2024-10-04 19:24:55,0,0,0,0,0,0
2,201392387,1145490689,25803,47873,2024-10-04 19:24:55,0,0,0,0,0,0
2,201392387,2170660915,53926,36895,2024-10-04 19:24:55,0,0,0,0,0,0
2,201392387,2170660915,0,0,2024-10-04 19:24:55,0,0,0,0,0,0
2,201392387,2170660915,39639,36895,2024-10-04 19:24:56,0,0,0,0,0,0
2,201392387,2170660915,22663,36895,2024-10-04 19:24:56,0,0,0,0,0,0
2,201392387,1145490689,25803,47873,2024-10-04 19:24:56,0,0,0,0,0,0
2,201392387,2170660915,53926,36895,2024-10-04 19:24:56,0,0,0,0,0,0
2,201392387,2170660915,0,0,2024-10-04 19:24:56,0,0,0,0,0,0
2,201392387,2170660915,39639,36895,2024-10-04 19:24:57,0,0,0,0,0,0
2,201392387,2170660915,22663,36895,2024-10-04 19:24:57,0,0,0,0,0,0
2,201392387,1145490689,25803,47873,2024-10-04 19:24:57,0,0,0,0,0,0
2,201392387,2170660915,53926,36895,2024-10-04 19:24:57,0,0,0,0,0,0
2,201392387,2170660915,0,0,2024-10-04 19:24:57,0,0,0,0,0,0
2,201392387,2170660915,39639,36895,2024-10-04 19:24:58,0,0,0,0,0,0
2,201392387,2170660915,22663,36895,2024-10-04 19:24:58,0,0,0,0,0,0
2,201392387,1145490689,25803,47873,2024-10-04 19:24:58,0,0,0,0,0,0
2,201392387,2170660915,53926,36895,2024-10-04 19:24:58,0,0,0,0,0,0
2,201392387,2170660915,0,0,2024-10-04 19:24:58,0,0,0,0,0,0
2,201392387,2170660915,39639,36895,2024-10-04 19:24:59,0,0,0,0,0,0
2,201392387,2170660915,22663,36895,2024-10-04 19:24:59,0,0,0,0,0,0
2,201392387,1145490689,25803,47873,2024-10-04 19:24:59,6580,97164,103744,56,75,131
2,201392387,2170660915,53926,36895,2024-10-04 19:24:59,0,0,0,0,0,0
2,201392387,2170660915,0,0,2024-10-04 19:24:59,0,0,0,0,0,0
2,201392387,2170660915,39639,36895,2024-10-04 19:25:00,0,0,0,0,0,0
2,201392387,2170660915,22663,36895,2024-10-04 19:25:00,0,0,0,0,0,0
2,201392387,1145490689,25803,47873,2024-10-04 19:25:00,0,0,0,0,0,0
2,201392387,2170660915,53926,36895,2024-10-04 19:25:00,0,0,0,0,0,0
2,201392387,2170660915,0,0,2024-10-04 19:25:00,128,84,212,1,1,2
2,201392387,2170660915,39639,36895,2024-10-04 19:25:01,0,0,0,0,0,0
2,201392387,2170660915,22663,36895,2024-10-04 19:25:01,0,0,0,0,0,0
2,201392387,1145490689,25803,47873,2024-10-04 19:25:01,0,0,0,0,0,0
2,201392387,2170660915,53926,36895,2024-10-04 19:25:01,0,0,0,0,0,0
2,201392387,2170660915,0,0,2024-10-04 19:25:01,128,84,212,1,1,2
2,201392387,2170660915,39639,36895,2024-10-04 19:25:02,0,0,0,0,0,0
2,201392387,2170660915,22663,36895,2024-10-04 19:25:02,0,0,0,0,0,0
2,201392387,1145490689,25803,47873,2024-10-04 19:25:02,0,0,0,0,0,0
2,201392387,2170660915,53926,36895,2024-10-04 19:25:02,0,0,0,0,0,0
2,201392387,2170660915,0,0,2024-10-04 19:25:02,128,84,212,1,1,2
2,201392387,2170660915,39639,36895,2024-10-04 19:25:03,0,0,0,0,0,0
2,201392387,2170660915,22663,36895,2024-10-04 19:25:03,0,0,0,0,0,0
2,201392387,1145490689,25803,47873,2024-10-04 19:25:03,0,0,0,0,0,0
2,201392387,2170660915,53926,36895,2024-10-04 19:25:03,0,0,0,0,0,0
2,201392387,2170660915,0,0,2024-10-04 19:25:03,128,84,212,1,1,2
2,201392387,2170660915,39639,36895,2024-10-04 19:25:04,0,0,0,0,0,0
2,201392387,2170660915,22663,36895,2024-10-04 19:25:04,0,0,0,0,0,0
2,201392387,1145490689,25803,47873,2024-10-04 19:25:04,0,0,0,0,0,0
2,201392387,2170660915,53926,36895,2024-10-04 19:25:04,0,0,0,0,0,0
2,201392387,2170660915,0,0,2024-10-04 19:25:04,128,84,212,1,1,2
2,201392387,2170660915,39639,36895,2024-10-04 19:25:05,0,0,0,0,0,0
2,201392387,2170660915,22663,36895,2024-10-04 19:25:05,0,0,0,0,0,0
2,201392387,1145490689,25803,47873,2024-10-04 19:25:05,0,0,0,0,0,0
2,201392387,2170660915,53926,36895,2024-10-04 19:25:05,0,0,0,0,0,0
2,201392387,2170660915,0,0,2024-10-04 19:25:05,128,84,212,1,1,2
2,201392387,2170660915,39639,36895,2024-10-04 19:25:06,0,0,0,0,0,0
2,201392387,2170660915,22663,36895,2024-10-04 19:25:06,0,0,0,0,0,0
2,201392387,1145490689,25803,47873,2024-10-04 19:25:06,0,0,0,0,0,0
2,201392387,2170660915,53926,36895,2024-10-04 19:25:06,0,0,0,0,0,0
2,201392387,2170660915,0,0,2024-10-04 19:25:06,128,84,212,1,1,2
2,201392387,2170660915,39639,36895,2024-10-04 19:25:07,0,0,0,0,0,0
2,201392387,2170660915,22663,36895,2024-10-04 19:25:07,0,0,0,0,0,0
2,201392387,1145490689,25803,47873,2024-10-04 19:25:07,0,0,0,0,0,0
2,201392387,2170660915,53926,36895,2024-10-04 19:25:07,0,0,0,0,0,0
2,201392387,2170660915,0,0,2024-10-04 19:25:07,128,84,212,1,1,2
2,201392387,2170660915,39639,36895,2024-10-04 19:25:08,0,0,0,0,0,0
2,201392387,2170660915,22663,36895,2024-10-04 19:25:08,0,0,0,0,0,0
2,201392387,1145490689,25803,47873,2024-10-04 19:25:08,0,0,0,0,0,0
2,201392387,2170660915,53926,36895,2024-10-04 19:25:08,0,0,0,0,0,0
2,201392387,2170660915,0,0,2024-10-04 19:25:08,128,84,212,1,1,2
2,201392387,2170660915,39639,36895,2024-10-04 19:25:09,0,0,0,0,0,0
2,201392387,2170660915,22663,36895,2024-10-04 19:25:09,0,0,0,0,0,0
2,201392387,2170660915,53926,36895,2024-10-04 19:25:09,0,0,0,0,0,0
2,201392387,2170660915,0,0,2024-10-04 19:25:09,128,84,212,1,1,2
2,201392387,2170660915,39639,36895,2024-10-04 19:25:10,0,0,0,0,0,0
2,201392387,2170660915,22663,36895,2024-10-04 19:25:10,0,0,0,0,0,0
2,201392387,2170660915,53926,36895,2024-10-04 19:25:10,0,0,0,0,0,0
2,201392387,2170660915,0,0,2024-10-04 19:25:10,0,0,0,0,0,0
2,201392387,2170660915,39639,36895,2024-10-04 19:25:11,0,0,0,0,0,0
2,201392387,2170660915,41643,36895,2024-10-04 19:25:11,666,507,1173,6,6,12
2,201392387,2170660915,22663,36895,2024-10-04 19:25:11,0,0,0,0,0,0
2,201392387,2170660915,53926,36895,2024-10-04 19:25:11,0,0,0,0,0,0
2,201392387,2170660915,0,0,2024-10-04 19:25:11,0,0,0,0,0,0
2,201392387,2170660915,39639,36895,2024-10-04 19:25:12,0,0,0,0,0,0
2,201392387,2170660915,41643,36895,2024-10-04 19:25:12,0,0,0,0,0,0
2,201392387,2170660915,22663,36895,2024-10-04 19:25:12,0,0,0,0,0,0
2,201392387,2170660915,53926,36895,2024-10-04 19:25:12,0,0,0,0,0,0
2,201392387,2170660915,0,0,2024-10-04 19:25:12,128,84,212,1,1,2
2,201392387,2170660915,39639,36895,2024-10-04 19:25:13,0,0,0,0,0,0
2,201392387,2170660915,41643,36895,2024-10-04 19:25:13,0,0,0,0,0,0
2,201392387,2170660915,22663,36895,2024-10-04 19:25:13,0,0,0,0,0,0
2,201392387,2170660915,53926,36895,2024-10-04 19:25:13,0,0,0,0,0,0
2,201392387,2170660915,0,0,2024-10-04 19:25:13,128,84,212,1,1,2
2,201392387,2170660915,39639,36895,2024-10-04 19:25:14,0,0,0,0,0,0
2,201392387,2170660915,41643,36895,2024-10-04 19:25:14,0,0,0,0,0,0
2,201392387,2170660915,22663,36895,2024-10-04 19:25:14,0,0,0,0,0,0
2,201392387,2170660915,53926,36895,2024-10-04 19:25:14,0,0,0,0,0,0
2,201392387,2170660915,0,0,2024-10-04 19:25:14,0,0,0,0,0,0
2,201392387,2170660915,39639,36895,2024-10-04 19:25:15,0,0,0,0,0,0
2,201392387,2170660915,41643,36895,2024-10-04 19:25:15,0,0,0,0,0,0
2,201392387,2170660915,22663,36895,2024-10-04 19:25:15,0,0,0,0,0,0
2,201392387,2170660915,53926,36895,2024-10-04 19:25:15,0,0,0,0,0,0
2,201392387,2170660915,0,0,2024-10-04 19:25:15,0,0,0,0,0,0
2,201392387,2170660915,39639,36895,2024-10-04 19:25:16,0,0,0,0,0,0
2,201392387,2170660915,41643,36895,2024-10-04 19:25:16,0,0,0,0,0,0
2,201392387,2170660915,22663,36895,2024-10-04 19:25:16,0,0,0,0,0,0
2,201392387,2170660915,53926,36895,2024-10-04 19:25:16,0,0,0,0,0,0
2,201392387,2170660915,0,0,2024-10-04 19:25:16,128,84,212,1,1,2
2,201392387,2170660915,39639,36895,2024-10-04 19:25:17,0,0,0,0,0,0
2,201392387,2170660915,41643,36895,2024-10-04 19:25:17,0,0,0,0,0,0
2,201392387,2170660915,22663,36895,2024-10-04 19:25:17,0,0,0,0,0,0
2,201392387,2170660915,53926,36895,2024-10-04 19:25:17,0,0,0,0,0,0
2,201392387,2170660915,0,0,2024-10-04 19:25:17,128,84,212,1,1,2
2,201392387,2170660915,39639,36895,2024-10-04 19:25:18,0,0,0,0,0,0
2,201392387,2170660915,41643,36895,2024-10-04 19:25:18,0,0,0,0,0,0
2,201392387,2170660915,22663,36895,2024-10-04 19:25:18,0,0,0,0,0,0
2,201392387,2170660915,53926,36895,2024-10-04 19:25:18,0,0,0,0,0,0
2,201392387,2170660915,0,0,2024-10-04 19:25:18,128,84,212,1,1,2
2,201392387,2170660915,39639,36895,2024-10-04 19:25:19,0,0,0,0,0,0
2,201392387,2170660915,41643,36895,2024-10-04 19:25:19,0,0,0,0,0,0
2,201392387,2170660915,22663,36895,2024-10-04 19:25:19,0,0,0,0,0,0
2,201392387,2170660915,53926,36895,2024-10-04 19:25:19,0,0,0,0,0,0
2,201392387,2170660915,0,0,2024-10-04 19:25:19,128,84,212,1,1,2
2,201392387,1145490691,21728,47873,2024-10-04 19:25:19,5388,82825,88213,45,64,109
2,201392387,2170660915,39639,36895,2024-10-04 19:25:20,0,0,0,0,0,0
2,201392387,2170660915,41643,36895,2024-10-04 19:25:20,0,0,0,0,0,0
2,201392387,2170660915,22663,36895,2024-10-04 19:25:20,0,0,0,0,0,0
2,201392387,2170660915,53926,36895,2024-10-04 19:25:20,0,0,0,0,0,0
2,201392387,2170660915,0,0,2024-10-04 19:25:20,0,0,0,0,0,0
2,201392387,1145490691,21728,47873,2024-10-04 19:25:20,0,0,0,0,0,0
2,201392387,2170660915,39639,36895,2024-10-04 19:25:21,0,0,0,0,0,0
2,201392387,2170660915,41643,36895,2024-10-04 19:25:21,0,0,0,0,0,0
2,201392387,2170660915,22663,36895,2024-10-04 19:25:21,0,0,0,0,0,0
2,201392387,2170660915,53926,36895,2024-10-04 19:25:21,0,0,0,0,0,0
2,201392387,2170660915,0,0,2024-10-04 19:25:21,0,0,0,0,0,0
2,201392387,1145490691,21728,47873,2024-10-04 19:25:21,0,0,0,0,0,0
2,201392387,2170660915,39639,36895,2024-10-04 19:25:22,0,0,0,0,0,0
2,201392387,2170660915,41643,36895,2024-10-04 19:25:22,0,0,0,0,0,0
2,201392387,2170660915,22663,36895,2024-10-04 19:25:22,0,0,0,0,0,0
2,201392387,2170660915,53926,36895,2024-10-04 19:25:22,0,0,0,0,0,0
2,201392387,2170660915,0,0,2024-10-04 19:25:22,0,0,0,0,0,0
2,201392387,1145490691,21728,47873,2024-10-04 19:25:22,0,0,0,0,0,0
2,201392387,2170660915,39639,36895,2024-10-04 19:25:23,0,0,0,0,0,0
2,201392387,2170660915,41643,36895,2024-10-04 19:25:23,0,0,0,0,0,0
2,201392387,2170660915,22663,36895,2024-10-04 19:25:23,0,0,0,0,0,0
2,201392387,2170660915,53926,36895,2024-10-04 19:25:23,0,0,0,0,0,0
2,201392387,2170660915,0,0,2024-10-04 19:25:23,0,0,0,0,0,0
2,201392387,1145490691,21728,47873,2024-10-04 19:25:23,0,0,0,0,0,0
2,201392387,2170660915,39639,36895,2024-10-04 19:25:24,0,0,0,0,0,0
2,201392387,2170660915,41643,36895,2024-10-04 19:25:24,0,0,0,0,0,0
2,201392387,2170660915,22663,36895,2024-10-04 19:25:24,0,0,0,0,0,0
2,201392387,2170660915,53926,36895,2024-10-04 19:25:24,0,0,0,0,0,0
2,201392387,2170660915,0,0,2024-10-04 19:25:24,0,0,0,0,0,0
2,201392387,1145490691,21728,47873,2024-10-04 19:25:24,0,0,0,0,0,0
2,201392387,2170660915,39639,36895,2024-10-04 19:25:25,0,0,0,0,0,0
2,201392387,2170660915,41643,36895,2024-10-04 19:25:25,0,0,0,0,0,0
2,201392387,2170660915,22663,36895,2024-10-04 19:25:25,0,0,0,0,0,0
2,201392387,2170660915,53926,36895,2024-10-04 19:25:25,0,0,0,0,0,0
2,201392387,2170660915,0,0,2024-10-04 19:25:25,0,0,0,0,0,0
2,201392387,1145490691,21728,47873,2024-10-04 19:25:25,0,0,0,0,0,0
2,201392387,2170660915,39639,36895,2024-10-04 19:25:26,0,0,0,0,0,0
2,201392387,2170660915,41643,36895,2024-10-04 19:25:26,0,0,0,0,0,0
2,201392387,2170660915,22663,36895,2024-10-04 19:25:26,0,0,0,0,0,0
2,201392387,2170660915,53926,36895,2024-10-04 19:25:26,0,0,0,0,0,0
2,201392387,2170660915,0,0,2024-10-04 19:25:26,0,0,0,0,0,0
2,201392387,1145490691,21728,47873,2024-10-04 19:25:26,0,0,0,0,0,0
2,201392387,2170660915,39639,36895,2024-10-04 19:25:27,0,0,0,0,0,0
2,201392387,2170660915,41643,36895,2024-10-04 19:25:27,0,0,0,0,0,0
2,201392387,2170660915,22663,36895,2024-10-04 19:25:27,0,0,0,0,0,0
2,201392387,2170660915,53926,36895,2024-10-04 19:25:27,0,0,0,0,0,0
2,201392387,2170660915,0,0,2024-10-04 19:25:27,0,0,0,0,0,0
2,201392387,1145490691,21728,47873,2024-10-04 19:25:27,0,0,0,0,0,0
2,201392387,2170660915,39639,36895,2024-10-04 19:25:28,0,0,0,0,0,0
2,201392387,2170660915,41643,36895,2024-10-04 19:25:28,0,0,0,0,0,0
2,201392387,2170660915,22663,36895,2024-10-04 19:25:28,0,0,0,0,0,0
2,201392387,2170660915,53926,36895,2024-10-04 19:25:28,0,0,0,0,0,0
2,201392387,2170660915,0,0,2024-10-04 19:25:28,0,0,0,0,0,0
2,201392387,1145490691,21728,47873,2024-10-04 19:25:28,0,0,0,0,0,0
2,201392387,2170660915,39639,36895,2024-10-04 19:25:29,0,0,0,0,0,0
2,201392387,2170660915,41643,36895,2024-10-04 19:25:29,0,0,0,0,0,0
2,201392387,2170660915,22663,36895,2024-10-04 19:25:29,0,0,0,0,0,0
2,201392387,2170660915,53926,36895,2024-10-04 19:25:29,0,0,0,0,0,0
2,201392387,2170660915,0,0,2024-10-04 19:25:29,128,0,128,1,0,1
2,201392387,1145490691,21728,47873,2024-10-04 19:25:29,912,8237,9149,9,8,17
2,201392387,2170660915,39639,36895,2024-10-04 19:25:30,0,0,0,0,0,0
2,201392387,2170660915,41643,36895,2024-10-04 19:25:30,0,0,0,0,0,0
2,201392387,2170660915,22663,36895,2024-10-04 19:25:30,0,0,0,0,0,0
2,201392387,2170660915,53926,36895,2024-10-04 19:25:30,0,0,0,0,0,0
2,201392387,2170660915,0,0,2024-10-04 19:25:30,128,84,212,1,1,2
2,201392387,1145490691,21728,47873,2024-10-04 19:25:30,0,0,0,0,0,0
2,201392387,2170660915,39639,36895,2024-10-04 19:25:31,0,0,0,0,0,0
2,201392387,2170660915,41643,36895,2024-10-04 19:25:31,0,0,0,0,0,0
2,201392387,2170660915,22663,36895,2024-10-04 19:25:31,0,0,0,0,0,0
2,201392387,2170660915,53926,36895,2024-10-04 19:25:31,0,0,0,0,0,0
2,201392387,2170660915,0,0,2024-10-04 19:25:31,128,84,212,1,1,2
2,201392387,1145490691,21728,47873,2024-10-04 19:25:31,0,0,0,0,0,0
2,201392387,2170660915,39639,36895,2024-10-04 19:25:32,0,0,0,0,0,0
2,201392387,2170660915,41643,36895,2024-10-04 19:25:32,0,0,0,0,0,0
2,201392387,2170660915,22663,36895,2024-10-04 19:25:32,0,0,0,0,0,0
2,201392387,2170660915,53926,36895,2024-10-04 19:25:32,0,0,0,0,0,0
2,201392387,2170660915,0,0,2024-10-04 19:25:32,128,84,212,1,1,2
2,201392387,1145490691,21728,47873,2024-10-04 19:25:32,0,0,0,0,0,0
2,201392387,2170660915,39639,36895,2024-10-04 19:25:33,0,0,0,0,0,0
2,201392387,2170660915,41643,36895,2024-10-04 19:25:33,0,0,0,0,0,0
2,201392387,2170660915,22663,36895,2024-10-04 19:25:33,0,0,0,0,0,0
2,201392387,2170660915,53926,36895,2024-10-04 19:25:33,0,0,0,0,0,0
2,201392387,2170660915,0,0,2024-10-04 19:25:33,128,84,212,1,1,2
2,201392387,1145490691,21728,47873,2024-10-04 19:25:33,0,0,0,0,0,0
2,201392387,2170660915,39639,36895,2024-10-04 19:25:34,0,0,0,0,0,0
2,201392387,2170660915,41643,36895,2024-10-04 19:25:34,0,0,0,0,0,0
2,201392387,2170660915,22663,36895,2024-10-04 19:25:34,0,0,0,0,0,0
2,201392387,2170660915,53926,36895,2024-10-04 19:25:34,0,0,0,0,0,0
2,201392387,2170660915,0,0,2024-10-04 19:25:34,128,84,212,1,1,2
2,201392387,1145490691,21728,47873,2024-10-04 19:25:34,0,0,0,0,0,0
2,201392387,2170660915,39639,36895,2024-10-04 19:25:35,0,0,0,0,0,0
2,201392387,2170660915,41643,36895,2024-10-04 19:25:35,0,0,0,0,0,0
2,201392387,2170660915,22663,36895,2024-10-04 19:25:35,0,0,0,0,0,0
2,201392387,2170660915,53926,36895,2024-10-04 19:25:35,0,0,0,0,0,0
2,201392387,2170660915,0,0,2024-10-04 19:25:35,128,84,212,1,1,2
2,201392387,1145490691,21728,47873,2024-10-04 19:25:35,0,0,0,0,0,0
2,201392387,2170660915,39639,36895,2024-10-04 19:25:36,0,0,0,0,0,0
2,201392387,2170660915,41643,36895,2024-10-04 19:25:36,0,0,0,0,0,0
2,201392387,2170660915,22663,36895,2024-10-04 19:25:36,0,0,0,0,0,0
2,201392387,2170660915,53926,36895,2024-10-04 19:25:36,0,0,0,0,0,0
2,201392387,2170660915,0,0,2024-10-04 19:25:36,128,84,212,1,1,2
2,201392387,1145490691,21728,47873,2024-10-04 19:25:36,0,0,0,0,0,0
2,201392387,2170660915,39639,36895,2024-10-04 19:25:37,0,0,0,0,0,0
2,201392387,2170660915,41643,36895,2024-10-04 19:25:37,0,0,0,0,0,0
2,201392387,2170660915,22663,36895,2024-10-04 19:25:37,0,0,0,0,0,0
2,201392387,2170660915,53926,36895,2024-10-04 19:25:37,0,0,0,0,0,0
2,201392387,2170660915,0,0,2024-10-04 19:25:37,128,84,212,1,1,2
2,201392387,1145490691,21728,47873,2024-10-04 19:25:37,0,0,0,0,0,0
2,201392387,2170660915,39639,36895,2024-10-04 19:25:38,0,0,0,0,0,0
2,201392387,2170660915,41643,36895,2024-10-04 19:25:38,0,0,0,0,0,0
2,201392387,2170660915,22663,36895,2024-10-04 19:25:38,0,0,0,0,0,0
2,201392387,2170660915,53926,36895,2024-10-04 19:25:38,0,0,0,0,0,0
2,201392387,2170660915,0,0,2024-10-04 19:25:38,128,84,212,1,1,2
2,201392387,1145490691,21728,47873,2024-10-04 19:25:38,0,0,0,0,0,0
2,201392387,2170660915,39639,36895,2024-10-04 19:25:39,0,0,0,0,0,0
2,201392387,2170660915,41643,36895,2024-10-04 19:25:39,0,0,0,0,0,0
2,201392387,2170660915,22663,36895,2024-10-04 19:25:39,0,0,0,0,0,0
2,201392387,2170660915,53926,36895,2024-10-04 19:25:39,0,0,0,0,0,0
2,201392387,2170660915,0,0,2024-10-04 19:25:39,0,84,84,0,1,1
2,201392387,1145490691,21728,47873,2024-10-04 19:25:39,0,0,0,0,0,0
2,201392387,2170660915,39639,36895,2024-10-04 19:25:40,0,0,0,0,0,0
2,201392387,2170660915,22663,36895,2024-10-04 19:25:40,0,0,0,0,0,0
2,201392387,2170660915,53926,36895,2024-10-04 19:25:40,0,0,0,0,0,0
2,201392387,2170660915,0,0,2024-10-04 19:25:40,0,0,0,0,0,0
2,201392387,2170660915,52893,36895,2024-10-04 19:25:40,666,507,1173,6,6,12
2,201392387,2170660915,39639,36895,2024-10-04 19:25:41,0,0,0,0,0,0
2,201392387,2170660915,22663,36895,2024-10-04 19:25:41,0,0,0,0,0,0
2,201392387,2170660915,53926,36895,2024-10-04 19:25:41,0,0,0,0,0,0
2,201392387,2170660915,0,0,2024-10-04 19:25:41,0,0,0,0,0,0
2,201392387,2170660915,52893,36895,2024-10-04 19:25:41,0,0,0,0,0,0
2,201392387,2170660915,39639,36895,2024-10-04 19:25:42,0,0,0,0,0,0
2,201392387,2170660915,22663,36895,2024-10-04 19:25:42,0,0,0,0,0,0
2,201392387,2170660915,53926,36895,2024-10-04 19:25:42,0,0,0,0,0,0
2,201392387,2170660915,0,0,2024-10-04 19:25:42,128,84,212,1,1,2
2,201392387,2170660915,52893,36895,2024-10-04 19:25:42,0,0,0,0,0,0
2,201392387,2170660915,39639,36895,2024-10-04 19:25:43,0,0,0,0,0,0
2,201392387,2170660915,22663,36895,2024-10-04 19:25:43,0,0,0,0,0,0
2,201392387,2170660915,53926,36895,2024-10-04 19:25:43,0,0,0,0,0,0
2,201392387,2170660915,0,0,2024-10-04 19:25:43,128,84,212,1,1,2
2,201392387,2170660915,52893,36895,2024-10-04 19:25:43,0,0,0,0,0,0
2,201392387,2170660915,39639,36895,2024-10-04 19:25:44,0,0,0,0,0,0
2,201392387,2170660915,22663,36895,2024-10-04 19:25:44,0,0,0,0,0,0
2,201392387,2170660915,53926,36895,2024-10-04 19:25:44,0,0,0,0,0,0
2,201392387,2170660915,0,0,2024-10-04 19:25:44,128,84,212,1,1,2
2,201392387,2170660915,52893,36895,2024-10-04 19:25:44,0,0,0,0,0,0
2,201392387,2170660915,39639,36895,2024-10-04 19:25:45,0,0,0,0,0,0
2,201392387,2170660915,22663,36895,2024-10-04 19:25:45,0,0,0,0,0,0
2,201392387,2170660915,53926,36895,2024-10-04 19:25:45,0,0,0,0,0,0
2,201392387,2170660915,0,0,2024-10-04 19:25:45,0,0,0,0,0,0
2,201392387,2170660915,52893,36895,2024-10-04 19:25:45,0,0,0,0,0,0
2,201392387,2170660915,39639,36895,2024-10-04 19:25:46,0,0,0,0,0,0
2,201392387,2170660915,22663,36895,2024-10-04 19:25:46,0,0,0,0,0,0
2,201392387,2170660915,53926,36895,2024-10-04 19:25:46,0,0,0,0,0,0
2,201392387,2170660915,0,0,2024-10-04 19:25:46,0,0,0,0,0,0
2,201392387,2170660915,52893,36895,2024-10-04 19:25:46,0,0,0,0,0,0
2,201392387,2170660915,39639,36895,2024-10-04 19:25:47,0,0,0,0,0,0
2,201392387,2170660915,22663,36895,2024-10-04 19:25:47,0,0,0,0,0,0
2,201392387,2170660915,53926,36895,2024-10-04 19:25:47,0,0,0,0,0,0
2,201392387,2170660915,0,0,2024-10-04 19:25:47,128,84,212,1,1,2
2,201392387,2170660915,52893,36895,2024-10-04 19:25:47,0,0,0,0,0,0
2,201392387,2170660915,39639,36895,2024-10-04 19:25:48,0,0,0,0,0,0
2,201392387,2170660915,22663,36895,2024-10-04 19:25:48,0,0,0,0,0,0
2,201392387,2170660915,53926,36895,2024-10-04 19:25:48,0,0,0,0,0,0
2,201392387,2170660915,0,0,2024-10-04 19:25:48,128,84,212,1,1,2
2,201392387,2170660915,52893,36895,2024-10-04 19:25:48,0,0,0,0,0,0
2,201392387,2170660915,39639,36895,2024-10-04 19:25:49,0,0,0,0,0,0
2,201392387,2170660915,22663,36895,2024-10-04 19:25:49,0,0,0,0,0,0
2,201392387,2170660915,53926,36895,2024-10-04 19:25:49,0,0,0,0,0,0
2,201392387,1145490690,29403,47873,2024-10-04 19:25:49,6464,95256,101720,54,76,130
2,201392387,2170660915,0,0,2024-10-04 19:25:49,128,84,212,1,1,2
2,201392387,2170660915,52893,36895,2024-10-04 19:25:49,0,0,0,0,0,0
2,201392387,2170660915,39639,36895,2024-10-04 19:25:50,0,0,0,0,0,0
2,201392387,2170660915,22663,36895,2024-10-04 19:25:50,0,0,0,0,0,0
2,201392387,2170660915,53926,36895,2024-10-04 19:25:50,0,0,0,0,0,0
2,201392387,1145490690,29403,47873,2024-10-04 19:25:50,0,0,0,0,0,0
2,201392387,2170660915,0,0,2024-10-04 19:25:50,0,0,0,0,0,0
2,201392387,2170660915,52893,36895,2024-10-04 19:25:50,0,0,0,0,0,0
2,201392387,2170660915,39639,36895,2024-10-04 19:25:51,0,0,0,0,0,0
2,201392387,2170660915,22663,36895,2024-10-04 19:25:51,0,0,0,0,0,0
2,201392387,2170660915,53926,36895,2024-10-04 19:25:51,0,0,0,0,0,0
2,201392387,1145490690,29403,47873,2024-10-04 19:25:51,0,0,0,0,0,0
2,201392387,2170660915,0,0,2024-10-04 19:25:51,0,0,0,0,0,0
2,201392387,2170660915,52893,36895,2024-10-04 19:25:51,0,0,0,0,0,0
2,201392387,2170660915,39639,36895,2024-10-04 19:25:52,0,0,0,0,0,0
2,201392387,2170660915,22663,36895,2024-10-04 19:25:52,0,0,0,0,0,0
2,201392387,2170660915,53926,36895,2024-10-04 19:25:52,0,0,0,0,0,0
2,201392387,1145490690,29403,47873,2024-10-04 19:25:52,0,0,0,0,0,0
2,201392387,2170660915,0,0,2024-10-04 19:25:52,0,0,0,0,0,0
2,201392387,2170660915,52893,36895,2024-10-04 19:25:52,0,0,0,0,0,0
2,201392387,2170660915,39639,36895,2024-10-04 19:25:53,0,0,0,0,0,0
2,201392387,2170660915,22663,36895,2024-10-04 19:25:53,0,0,0,0,0,0
2,201392387,2170660915,53926,36895,2024-10-04 19:25:53,0,0,0,0,0,0
2,201392387,1145490690,29403,47873,2024-10-04 19:25:53,0,0,0,0,0,0
2,201392387,2170660915,0,0,2024-10-04 19:25:53,0,0,0,0,0,0
2,201392387,2170660915,52893,36895,2024-10-04 19:25:53,0,0,0,0,0,0
2,201392387,2170660915,39639,36895,2024-10-04 19:25:54,0,0,0,0,0,0
2,201392387,2170660915,22663,36895,2024-10-04 19:25:54,0,0,0,0,0,0
2,201392387,2170660915,53926,36895,2024-10-04 19:25:54,0,0,0,0,0,0
2,201392387,1145490690,29403,47873,2024-10-04 19:25:54,0,0,0,0,0,0
2,201392387,2170660915,0,0,2024-10-04 19:25:54,0,0,0,0,0,0
2,201392387,2170660915,52893,36895,2024-10-04 19:25:54,0,0,0,0,0,0
2,201392387,2170660915,39639,36895,2024-10-04 19:25:55,0,0,0,0,0,0
2,201392387,2170660915,22663,36895,2024-10-04 19:25:55,0,0,0,0,0,0
2,201392387,2170660915,53926,36895,2024-10-04 19:25:55,0,0,0,0,0,0
2,201392387,1145490690,29403,47873,2024-10-04 19:25:55,0,0,0,0,0,0
2,201392387,2170660915,0,0,2024-10-04 19:25:55,0,0,0,0,0,0
2,201392387,2170660915,52893,36895,2024-10-04 19:25:55,0,0,0,0,0,0
2,201392387,2170660915,39639,36895,2024-10-04 19:25:56,0,0,0,0,0,0
2,201392387,2170660915,22663,36895,2024-10-04 19:25:56,0,0,0,0,0,0
2,201392387,2170660915,53926,36895,2024-10-04 19:25:56,0,0,0,0,0,0
2,201392387,1145490690,29403,47873,2024-10-04 19:25:56,0,0,0,0,0,0
2,201392387,2170660915,0,0,2024-10-04 19:25:56,0,0,0,0,0,0
2,201392387,2170660915,52893,36895,2024-10-04 19:25:56,0,0,0,0,0,0
2,201392387,2170660915,39639,36895,2024-10-04 19:25:57,0,0,0,0,0,0
2,201392387,2170660915,22663,36895,2024-10-04 19:25:57,0,0,0,0,0,0
2,201392387,2170660915,53926,36895,2024-10-04 19:25:57,0,0,0,0,0,0
2,201392387,1145490690,29403,47873,2024-10-04 19:25:57,0,0,0,0,0,0
2,201392387,2170660915,0,0,2024-10-04 19:25:57,0,0,0,0,0,0
2,201392387,2170660915,52893,36895,2024-10-04 19:25:57,0,0,0,0,0,0
2,201392387,2170660915,39639,36895,2024-10-04 19:25:58,0,0,0,0,0,0
2,201392387,2170660915,22663,36895,2024-10-04 19:25:58,0,0,0,0,0,0
2,201392387,2170660915,53926,36895,2024-10-04 19:25:58,0,0,0,0,0,0
2,201392387,1145490690,29403,47873,2024-10-04 19:25:58,0,0,0,0,0,0
2,201392387,2170660915,0,0,2024-10-04 19:25:58,0,0,0,0,0,0
2,201392387,2170660915,52893,36895,2024-10-04 19:25:58,0,0,0,0,0,0
2,201392387,2170660915,39639,36895,2024-10-04 19:25:59,0,0,0,0,0,0
2,201392387,2170660915,22663,36895,2024-10-04 19:25:59,0,0,0,0,0,0
2,201392387,2170660915,53926,36895,2024-10-04 19:25:59,0,0,0,0,0,0
2,201392387,1145490690,29403,47873,2024-10-04 19:25:59,0,0,0,0,0,0
2,201392387,2170660915,0,0,2024-10-04 19:25:59,128,0,128,1,0,1
2,201392387,2170660915,52893,36895,2024-10-04 19:25:59,0,0,0,0,0,0
2,201392387,2170660915,39639,36895,2024-10-04 19:26:00,0,0,0,0,0,0
2,201392387,2170660915,22663,36895,2024-10-04 19:26:00,0,0,0,0,0,0
2,201392387,2170660915,53926,36895,2024-10-04 19:26:00,0,0,0,0,0,0
2,201392387,1145490690,29403,47873,2024-10-04 19:26:00,0,0,0,0,0,0
2,201392387,2170660915,0,0,2024-10-04 19:26:00,128,84,212,1,1,2
2,201392387,2170660915,52893,36895,2024-10-04 19:26:00,0,0,0,0,0,0
2,201392387,2170660915,39639,36895,2024-10-04 19:26:01,0,0,0,0,0,0
2,201392387,2170660915,22663,36895,2024-10-04 19:26:01,0,0,0,0,0,0
2,201392387,2170660915,53926,36895,2024-10-04 19:26:01,0,0,0,0,0,0
2,201392387,1145490690,29403,47873,2024-10-04 19:26:01,0,0,0,0,0,0
2,201392387,2170660915,0,0,2024-10-04 19:26:01,128,168,296,1,2,3
2,201392387,2170660915,52893,36895,2024-10-04 19:26:01,0,0,0,0,0,0
2,201392387,2170660915,39639,36895,2024-10-04 19:26:02,0,0,0,0,0,0
2,201392387,2170660915,22663,36895,2024-10-04 19:26:02,0,0,0,0,0,0
2,201392387,2170660915,53926,36895,2024-10-04 19:26:02,0,0,0,0,0,0
2,201392387,1145490690,29403,47873,2024-10-04 19:26:02,0,0,0,0,0,0
2,201392387,2170660915,0,0,2024-10-04 19:26:02,128,84,212,1,1,2
2,201392387,2170660915,52893,36895,2024-10-04 19:26:02,0,0,0,0,0,0
2,201392387,2170660915,39639,36895,2024-10-04 19:26:03,0,0,0,0,0,0
2,201392387,2170660915,22663,36895,2024-10-04 19:26:03,0,0,0,0,0,0
2,201392387,2170660915,53926,36895,2024-10-04 19:26:03,0,0,0,0,0,0
2,201392387,1145490690,29403,47873,2024-10-04 19:26:03,0,0,0,0,0,0
2,201392387,2170660915,0,0,2024-10-04 19:26:03,128,84,212,1,1,2
2,201392387,2170660915,52893,36895,2024-10-04 19:26:03,0,0,0,0,0,0
2,201392387,2170660915,39639,36895,2024-10-04 19:26:04,0,0,0,0,0,0
2,201392387,2170660915,22663,36895,2024-10-04 19:26:04,0,0,0,0,0,0
2,201392387,2170660915,53926,36895,2024-10-04 19:26:04,0,0,0,0,0,0
2,201392387,1145490690,29403,47873,2024-10-04 19:26:04,0,0,0,0,0,0
2,201392387,2170660915,0,0,2024-10-04 19:26:04,128,84,212,1,1,2
2,201392387,2170660915,52893,36895,2024-10-04 19:26:04,0,0,0,0,0,0
2,201392387,2170660915,39639,36895,2024-10-04 19:26:05,0,0,0,0,0,0
2,201392387,2170660915,22663,36895,2024-10-04 19:26:05,0,0,0,0,0,0
2,201392387,2170660915,53926,36895,2024-10-04 19:26:05,0,0,0,0,0,0
2,201392387,1145490690,29403,47873,2024-10-04 19:26:05,0,0,0,0,0,0
2,201392387,2170660915,0,0,2024-10-04 19:26:05,128,84,212,1,1,2
2,201392387,2170660915,52893,36895,2024-10-04 19:26:05,0,0,0,0,0,0
2,201392387,2170660915,39639,36895,2024-10-04 19:26:06,0,0,0,0,0,0
2,201392387,2170660915,22663,36895,2024-10-04 19:26:06,0,0,0,0,0,0
2,201392387,2170660915,53926,36895,2024-10-04 19:26:06,0,0,0,0,0,0
2,201392387,1145490690,29403,47873,2024-10-04 19:26:06,0,0,0,0,0,0
2,201392387,2170660915,0,0,2024-10-04 19:26:06,128,84,212,1,1,2
2,201392387,2170660915,52893,36895,2024-10-04 19:26:06,0,0,0,0,0,0
2,201392387,2170660915,39639,36895,2024-10-04 19:26:07,0,0,0,0,0,0
2,201392387,2170660915,22663,36895,2024-10-04 19:26:07,0,0,0,0,0,0
2,201392387,2170660915,53926,36895,2024-10-04 19:26:07,0,0,0,0,0,0
2,201392387,1145490690,29403,47873,2024-10-04 19:26:07,0,0,0,0,0,0
2,201392387,2170660915,0,0,2024-10-04 19:26:07,128,84,212,1,1,2
2,201392387,2170660915,52893,36895,2024-10-04 19:26:07,0,0,0,0,0,0
2,201392387,2170660915,39639,36895,2024-10-04 19:26:08,0,0,0,0,0,0
2,201392387,2170660915,22663,36895,2024-10-04 19:26:08,0,0,0,0,0,0
2,201392387,2170660915,53926,36895,2024-10-04 19:26:08,0,0,0,0,0,0
2,201392387,1145490690,29403,47873,2024-10-04 19:26:08,0,0,0,0,0,0
2,201392387,2170660915,0,0,2024-10-04 19:26:08,128,84,212,1,1,2
2,201392387,2170660915,52893,36895,2024-10-04 19:26:08,0,0,0,0,0,0
2,201392387,2170660915,39639,36895,2024-10-04 19:26:09,0,0,0,0,0,0
2,201392387,2170660915,22663,36895,2024-10-04 19:26:09,0,0,0,0,0,0
2,201392387,2170660915,53926,36895,2024-10-04 19:26:09,0,0,0,0,0,0
2,201392387,1145490690,29403,47873,2024-10-04 19:26:09,0,0,0,0,0,0
2,201392387,2170660915,0,0,2024-10-04 19:26:09,0,0,0,0,0,0
2,201392387,2170660915,52893,36895,2024-10-04 19:26:09,0,0,0,0,0,0
2,201392387,2170660915,39639,36895,2024-10-04 19:26:10,0,0,0,0,0,0
2,201392387,2170660915,22663,36895,2024-10-04 19:26:10,0,0,0,0,0,0
2,201392387,2170660915,53926,36895,2024-10-04 19:26:10,0,0,0,0,0,0
2,201392387,2170660915,29419,36895,2024-10-04 19:26:10,666,507,1173,6,6,12
2,201392387,2170660915,0,0,2024-10-04 19:26:10,0,0,0,0,0,0
2,201392387,2170660915,52893,36895,2024-10-04 19:26:10,0,0,0,0,0,0
2,201392387,2170660915,39639,36895,2024-10-04 19:26:11,0,0,0,0,0,0
2,201392387,2170660915,22663,36895,2024-10-04 19:26:11,0,0,0,0,0,0
2,201392387,2170660915,53926,36895,2024-10-04 19:26:11,0,0,0,0,0,0
2,201392387,2170660915,29419,36895,2024-10-04 19:26:11,0,0,0,0,0,0
2,201392387,2170660915,0,0,2024-10-04 19:26:11,128,84,212,1,1,2
2,201392387,2170660915,39639,36895,2024-10-04 19:26:12,0,0,0,0,0,0
2,201392387,2170660915,22663,36895,2024-10-04 19:26:12,0,0,0,0,0,0
2,201392387,2170660915,53926,36895,2024-10-04 19:26:12,0,0,0,0,0,0
2,201392387,2170660915,29419,36895,2024-10-04 19:26:12,0,0,0,0,0,0
2,201392387,2170660915,0,0,2024-10-04 19:26:12,256,84,340,2,1,3
2,201392387,2170660915,39639,36895,2024-10-04 19:26:13,0,0,0,0,0,0
2,201392387,2170660915,22663,36895,2024-10-04 19:26:13,0,0,0,0,0,0
2,201392387,2170660915,53926,36895,2024-10-04 19:26:13,0,0,0,0,0,0
2,201392387,2170660915,29419,36895,2024-10-04 19:26:13,0,0,0,0,0,0
2,201392387,2170660915,0,0,2024-10-04 19:26:13,0,0,0,0,0,0
2,201392387,2170660915,39639,36895,2024-10-04 19:26:14,0,0,0,0,0,0
2,201392387,2170660915,22663,36895,2024-10-04 19:26:14,0,0,0,0,0,0
2,201392387,2170660915,53926,36895,2024-10-04 19:26:14,0,0,0,0,0,0
2,201392387,2170660915,29419,36895,2024-10-04 19:26:14,0,0,0,0,0,0
2,201392387,2170660915,0,0,2024-10-04 19:26:14,0,84,84,0,1,1
2,201392387,2170660915,39639,36895,2024-10-04 19:26:15,0,0,0,0,0,0
2,201392387,2170660915,22663,36895,2024-10-04 19:26:15,0,0,0,0,0,0
2,201392387,2170660915,53926,36895,2024-10-04 19:26:15,0,0,0,0,0,0
2,201392387,2170660915,29419,36895,2024-10-04 19:26:15,0,0,0,0,0,0
2,201392387,2170660915,0,0,2024-10-04 19:26:15,0,0,0,0,0,0
2,201392387,2170660915,39639,36895,2024-10-04 19:26:16,0,0,0,0,0,0
2,201392387,2170660915,22663,36895,2024-10-04 19:26:16,0,0,0,0,0,0
2,201392387,2170660915,53926,36895,2024-10-04 19:26:16,0,0,0,0,0,0
2,201392387,2170660915,29419,36895,2024-10-04 19:26:16,0,0,0,0,0,0
2,201392387,2170660915,0,0,2024-10-04 19:26:16,128,0,128,1,0,1
2,201392387,2170660915,39639,36895,2024-10-04 19:26:17,0,0,0,0,0,0
2,201392387,2170660915,22663,36895,2024-10-04 19:26:17,0,0,0,0,0,0
2,201392387,2170660915,53926,36895,2024-10-04 19:26:17,0,0,0,0,0,0
2,201392387,2170660915,29419,36895,2024-10-04 19:26:17,0,0,0,0,0,0
2,201392387,2170660915,0,0,2024-10-04 19:26:17,0,84,84,0,1,1
2,201392387,2170660915,39639,36895,2024-10-04 19:26:18,0,0,0,0,0,0
2,201392387,2170660915,22663,36895,2024-10-04 19:26:18,0,0,0,0,0,0
2,201392387,2170660915,53926,36895,2024-10-04 19:26:18,0,0,0,0,0,0
2,201392387,2170660915,29419,36895,2024-10-04 19:26:18,0,0,0,0,0,0
2,201392387,2170660915,0,0,2024-10-04 19:26:18,256,168,424,2,2,4
2,201392387,1145490692,12422,47873,2024-10-04 19:26:18,813,60,873,3,1,4
2,201392387,2170660915,39639,36895,2024-10-04 19:26:19,0,0,0,0,0,0
2,201392387,2170660915,22663,36895,2024-10-04 19:26:19,0,0,0,0,0,0
2,201392387,2170660915,53926,36895,2024-10-04 19:26:19,0,0,0,0,0,0
2,201392387,2170660915,29419,36895,2024-10-04 19:26:19,0,0,0,0,0,0
2,201392387,2170660915,0,0,2024-10-04 19:26:19,0,0,0,0,0,0
2,201392387,1145490692,12422,47873,2024-10-04 19:26:19,1827,28191,30018,15,25,40
2,201392387,2170660915,39639,36895,2024-10-04 19:26:20,0,0,0,0,0,0
2,201392387,2170660915,22663,36895,2024-10-04 19:26:20,0,0,0,0,0,0
2,201392387,2170660915,53926,36895,2024-10-04 19:26:20,0,0,0,0,0,0
2,201392387,2170660915,29419,36895,2024-10-04 19:26:20,0,0,0,0,0,0
2,201392387,2170660915,0,0,2024-10-04 19:26:20,0,0,0,0,0,0
2,201392387,1145490692,12422,47873,2024-10-04 19:26:20,2028,53384,55412,20,35,55
2,201392387,2170660915,39639,36895,2024-10-04 19:26:21,0,0,0,0,0,0
2,201392387,2170660915,22663,36895,2024-10-04 19:26:21,0,0,0,0,0,0
2,201392387,2170660915,53926,36895,2024-10-04 19:26:21,0,0,0,0,0,0
2,201392387,2170660915,29419,36895,2024-10-04 19:26:21,0,0,0,0,0,0
2,201392387,2170660915,0,0,2024-10-04 19:26:21,0,0,0,0,0,0
2,201392387,1145490692,12422,47873,2024-10-04 19:26:21,1332,23717,25049,13,19,32
2,201392387,2170660915,39639,36895,2024-10-04 19:26:22,0,0,0,0,0,0
2,201392387,2170660915,22663,36895,2024-10-04 19:26:22,0,0,0,0,0,0
2,201392387,2170660915,53926,36895,2024-10-04 19:26:22,0,0,0,0,0,0
2,201392387,2170660915,29419,36895,2024-10-04 19:26:22,0,0,0,0,0,0
2,201392387,2170660915,0,0,2024-10-04 19:26:22,0,0,0,0,0,0
2,201392387,1145490692,12422,47873,2024-10-04 19:26:22,0,0,0,0,0,0
2,201392387,2170660915,39639,36895,2024-10-04 19:26:23,0,0,0,0,0,0
2,201392387,2170660915,22663,36895,2024-10-04 19:26:23,0,0,0,0,0,0
2,201392387,2170660915,53926,36895,2024-10-04 19:26:23,0,0,0,0,0,0
2,201392387,2170660915,29419,36895,2024-10-04 19:26:23,0,0,0,0,0,0
2,201392387,2170660915,0,0,2024-10-04 19:26:23,0,0,0,0,0,0
2,201392387,1145490692,12422,47873,2024-10-04 19:26:23,0,0,0,0,0,0
2,201392387,2170660915,39639,36895,2024-10-04 19:26:24,0,0,0,0,0,0
2,201392387,2170660915,22663,36895,2024-10-04 19:26:24,0,0,0,0,0,0
2,201392387,2170660915,53926,36895,2024-10-04 19:26:24,0,0,0,0,0,0
2,201392387,2170660915,29419,36895,2024-10-04 19:26:24,0,0,0,0,0,0
2,201392387,2170660915,0,0,2024-10-04 19:26:24,0,0,0,0,0,0
2,201392387,1145490692,12422,47873,2024-10-04 19:26:24,0,0,0,0,0,0
2,201392387,2170660915,39639,36895,2024-10-04 19:26:25,0,0,0,0,0,0
2,201392387,2170660915,22663,36895,2024-10-04 19:26:25,0,0,0,0,0,0
2,201392387,2170660915,53926,36895,2024-10-04 19:26:25,0,0,0,0,0,0
2,201392387,2170660915,29419,36895,2024-10-04 19:26:25,0,0,0,0,0,0
2,201392387,2170660915,0,0,2024-10-04 19:26:25,0,0,0,0,0,0
2,201392387,1145490692,12422,47873,2024-10-04 19:26:25,0,0,0,0,0,0
2,201392387,2170660915,39639,36895,2024-10-04 19:26:26,0,0,0,0,0,0
2,201392387,2170660915,22663,36895,2024-10-04 19:26:26,0,0,0,0,0,0
2,201392387,2170660915,53926,36895,2024-10-04 19:26:26,0,0,0,0,0,0
2,201392387,2170660915,29419,36895,2024-10-04 19:26:26,0,0,0,0,0,0
2,201392387,2170660915,0,0,2024-10-04 19:26:26,0,0,0,0,0,0
2,201392387,1145490692,12422,47873,2024-10-04 19:26:26,0,0,0,0,0,0
2,201392387,2170660915,39639,36895,2024-10-04 19:26:27,0,0,0,0,0,0
2,201392387,2170660915,22663,36895,2024-10-04 19:26:27,0,0,0,0,0,0
2,201392387,2170660915,53926,36895,2024-10-04 19:26:27,0,0,0,0,0,0
2,201392387,2170660915,29419,36895,2024-10-04 19:26:27,0,0,0,0,0,0
2,201392387,2170660915,0,0,2024-10-04 19:26:27,0,0,0,0,0,0
2,201392387,1145490692,12422,47873,2024-10-04 19:26:27,0,0,0,0,0,0
2,201392387,2170660915,39639,36895,2024-10-04 19:26:28,0,0,0,0,0,0
2,201392387,2170660915,22663,36895,2024-10-04 19:26:28,0,0,0,0,0,0
2,201392387,2170660915,53926,36895,2024-10-04 19:26:28,0,0,0,0,0,0
2,201392387,2170660915,29419,36895,2024-10-04 19:26:28,0,0,0,0,0,0
2,201392387,2170660915,0,0,2024-10-04 19:26:28,0,0,0,0,0,0
2,201392387,1145490692,12422,47873,2024-10-04 19:26:28,0,0,0,0,0,0
2,201392387,2170660915,39639,36895,2024-10-04 19:26:29,0,0,0,0,0,0
2,201392387,2170660915,22663,36895,2024-10-04 19:26:29,0,0,0,0,0,0
2,201392387,2170660915,53926,36895,2024-10-04 19:26:29,0,0,0,0,0,0
2,201392387,2170660915,29419,36895,2024-10-04 19:26:29,0,0,0,0,0,0
2,201392387,2170660915,0,0,2024-10-04 19:26:29,0,0,0,0,0,0
2,201392387,1145490692,12422,47873,2024-10-04 19:26:29,0,0,0,0,0,0
2,201392387,2170660915,39639,36895,2024-10-04 19:26:30,0,0,0,0,0,0
2,201392387,2170660915,22663,36895,2024-10-04 19:26:30,0,0,0,0,0,0
2,201392387,2170660915,53926,36895,2024-10-04 19:26:30,0,0,0,0,0,0
2,201392387,2170660915,29419,36895,2024-10-04 19:26:30,0,0,0,0,0,0
2,201392387,2170660915,0,0,2024-10-04 19:26:30,0,0,0,0,0,0
2,201392387,1145490692,12422,47873,2024-10-04 19:26:30,0,0,0,0,0,0
2,201392387,2170660915,39639,36895,2024-10-04 19:26:31,0,0,0,0,0,0
2,201392387,2170660915,22663,36895,2024-10-04 19:26:31,0,0,0,0,0,0
2,201392387,2170660915,53926,36895,2024-10-04 19:26:31,0,0,0,0,0,0
2,201392387,2170660915,29419,36895,2024-10-04 19:26:31,0,0,0,0,0,0
2,201392387,2170660915,0,0,2024-10-04 19:26:31,128,0,128,1,0,1
2,201392387,1145490692,12422,47873,2024-10-04 19:26:31,0,0,0,0,0,0
2,201392387,2170660915,39639,36895,2024-10-04 19:26:32,0,0,0,0,0,0
2,201392387,2170660915,22663,36895,2024-10-04 19:26:32,0,0,0,0,0,0
2,201392387,2170660915,53926,36895,2024-10-04 19:26:32,0,0,0,0,0,0
2,201392387,2170660915,29419,36895,2024-10-04 19:26:32,0,0,0,0,0,0
2,201392387,2170660915,0,0,2024-10-04 19:26:32,0,84,84,0,1,1
2,201392387,1145490692,12422,47873,2024-10-04 19:26:32,0,0,0,0,0,0
2,201392387,2170660915,39639,36895,2024-10-04 19:26:33,0,0,0,0,0,0
2,201392387,2170660915,22663,36895,2024-10-04 19:26:33,0,0,0,0,0,0
2,201392387,2170660915,53926,36895,2024-10-04 19:26:33,0,0,0,0,0,0
2,201392387,2170660915,29419,36895,2024-10-04 19:26:33,0,0,0,0,0,0
2,201392387,2170660915,0,0,2024-10-04 19:26:33,128,84,212,1,1,2
2,201392387,1145490692,12422,47873,2024-10-04 19:26:33,0,0,0,0,0,0
2,201392387,2170660915,39639,36895,2024-10-04 19:26:34,0,0,0,0,0,0
2,201392387,2170660915,22663,36895,2024-10-04 19:26:34,0,0,0,0,0,0
2,201392387,2170660915,53926,36895,2024-10-04 19:26:34,0,0,0,0,0,0
2,201392387,2170660915,29419,36895,2024-10-04 19:26:34,0,0,0,0,0,0
2,201392387,2170660915,0,0,2024-10-04 19:26:34,128,84,212,1,1,2
2,201392387,1145490692,12422,47873,2024-10-04 19:26:34,0,0,0,0,0,0
2,201392387,2170660915,39639,36895,2024-10-04 19:26:35,0,0,0,0,0,0
2,201392387,2170660915,22663,36895,2024-10-04 19:26:35,0,0,0,0,0,0
2,201392387,2170660915,53926,36895,2024-10-04 19:26:35,0,0,0,0,0,0
2,201392387,2170660915,29419,36895,2024-10-04 19:26:35,0,0,0,0,0,0
2,201392387,2170660915,0,0,2024-10-04 19:26:35,128,84,212,1,1,2
2,201392387,1145490692,12422,47873,2024-10-04 19:26:35,0,0,0,0,0,0
2,201392387,2170660915,39639,36895,2024-10-04 19:26:36,0,0,0,0,0,0
2,201392387,2170660915,22663,36895,2024-10-04 19:26:36,0,0,0,0,0,0
2,201392387,2170660915,53926,36895,2024-10-04 19:26:36,0,0,0,0,0,0
2,201392387,2170660915,29419,36895,2024-10-04 19:26:36,0,0,0,0,0,0
2,201392387,2170660915,0,0,2024-10-04 19:26:36,128,84,212,1,1,2
2,201392387,1145490692,12422,47873,2024-10-04 19:26:36,0,0,0,0,0,0
2,201392387,2170660915,39639,36895,2024-10-04 19:26:37,0,0,0,0,0,0
2,201392387,2170660915,22663,36895,2024-10-04 19:26:37,0,0,0,0,0,0
2,201392387,2170660915,53926,36895,2024-10-04 19:26:37,0,0,0,0,0,0
2,201392387,2170660915,29419,36895,2024-10-04 19:26:37,0,0,0,0,0,0
2,201392387,2170660915,0,0,2024-10-04 19:26:37,128,84,212,1,1,2
2,201392387,1145490692,12422,47873,2024-10-04 19:26:37,0,0,0,0,0,0
2,201392387,2170660915,39639,36895,2024-10-04 19:26:38,0,0,0,0,0,0
2,201392387,2170660915,22663,36895,2024-10-04 19:26:38,0,0,0,0,0,0
2,201392387,2170660915,53926,36895,2024-10-04 19:26:38,0,0,0,0,0,0
2,201392387,2170660915,29419,36895,2024-10-04 19:26:38,0,0,0,0,0,0
2,201392387,2170660915,0,0,2024-10-04 19:26:38,128,84,212,1,1,2
2,201392387,1145490692,12422,47873,2024-10-04 19:26:38,0,0,0,0,0,0
2,201392387,2170660915,39639,36895,2024-10-04 19:26:39,0,0,0,0,0,0
2,201392387,2170660915,22663,36895,2024-10-04 19:26:39,0,0,0,0,0,0
2,201392387,2170660915,53926,36895,2024-10-04 19:26:39,0,0,0,0,0,0
2,201392387,2170660915,29419,36895,2024-10-04 19:26:39,0,0,0,0,0,0
2,201392387,2170660915,0,0,2024-10-04 19:26:39,128,84,212,1,1,2
2,201392387,1145490692,12422,47873,2024-10-04 19:26:39,0,0,0,0,0,0
2,201392387,2170660915,39639,36895,2024-10-04 19:26:40,0,0,0,0,0,0
2,201392387,2170660915,22663,36895,2024-10-04 19:26:40,0,0,0,0,0,0
2,201392387,2170660915,53926,36895,2024-10-04 19:26:40,0,0,0,0,0,0
2,201392387,2170660915,29419,36895,2024-10-04 19:26:40,0,0,0,0,0,0
2,201392387,2170660915,0,0,2024-10-04 19:26:40,256,168,424,2,2,4
2,201392387,1145490692,12422,47873,2024-10-04 19:26:40,0,0,0,0,0,0
2,201392387,2170660915,39639,36895,2024-10-04 19:26:41,0,0,0,0,0,0
2,201392387,2170660915,22663,36895,2024-10-04 19:26:41,0,0,0,0,0,0
2,201392387,2170660915,53926,36895,2024-10-04 19:26:41,0,0,0,0,0,0
2,201392387,2170660915,29419,36895,2024-10-04 19:26:41,0,0,0,0,0,0
2,201392387,2170660915,0,0,2024-10-04 19:26:41,0,0,0,0,0,0
2,201392387,2170660915,39639,36895,2024-10-04 19:26:42,0,0,0,0,0,0
2,201392387,2170660915,22663,36895,2024-10-04 19:26:42,0,0,0,0,0,0
2,201392387,2170660915,204,36895,2024-10-04 19:26:42,666,507,1173,6,6,12
2,201392387,2170660915,53926,36895,2024-10-04 19:26:42,0,0,0,0,0,0
2,201392387,2170660915,29419,36895,2024-10-04 19:26:42,0,0,0,0,0,0
2,201392387,2170660915,0,0,2024-10-04 19:26:42,0,0,0,0,0,0
2,201392387,2170660915,39639,36895,2024-10-04 19:26:43,0,0,0,0,0,0
2,201392387,2170660915,22663,36895,2024-10-04 19:26:43,0,0,0,0,0,0
2,201392387,2170660915,204,36895,2024-10-04 19:26:43,0,0,0,0,0,0
2,201392387,2170660915,53926,36895,2024-10-04 19:26:43,0,0,0,0,0,0
2,201392387,2170660915,29419,36895,2024-10-04 19:26:43,0,0,0,0,0,0
2,201392387,2170660915,0,0,2024-10-04 19:26:43,128,84,212,1,1,2
2,201392387,2170660915,39639,36895,2024-10-04 19:26:44,0,0,0,0,0,0
2,201392387,2170660915,22663,36895,2024-10-04 19:26:44,0,0,0,0,0,0
2,201392387,2170660915,204,36895,2024-10-04 19:26:44,0,0,0,0,0,0
2,201392387,2170660915,53926,36895,2024-10-04 19:26:44,0,0,0,0,0,0
2,201392387,2170660915,29419,36895,2024-10-04 19:26:44,0,0,0,0,0,0
2,201392387,2170660915,0,0,2024-10-04 19:26:44,0,0,0,0,0,0
2,201392387,2170660915,39639,36895,2024-10-04 19:26:45,0,0,0,0,0,0
2,201392387,2170660915,22663,36895,2024-10-04 19:26:45,0,0,0,0,0,0
2,201392387,2170660915,204,36895,2024-10-04 19:26:45,0,0,0,0,0,0
2,201392387,2170660915,53926,36895,2024-10-04 19:26:45,0,0,0,0,0,0
2,201392387,2170660915,29419,36895,2024-10-04 19:26:45,0,0,0,0,0,0
2,201392387,2170660915,0,0,2024-10-04 19:26:45,128,84,212,1,1,2
2,201392387,2170660915,39639,36895,2024-10-04 19:26:46,0,0,0,0,0,0
2,201392387,2170660915,22663,36895,2024-10-04 19:26:46,0,0,0,0,0,0
2,201392387,2170660915,204,36895,2024-10-04 19:26:46,0,0,0,0,0,0
2,201392387,2170660915,53926,36895,2024-10-04 19:26:46,0,0,0,0,0,0
2,201392387,2170660915,29419,36895,2024-10-04 19:26:46,0,0,0,0,0,0
2,201392387,2170660915,0,0,2024-10-04 19:26:46,128,84,212,1,1,2
2,201392387,2170660915,39639,36895,2024-10-04 19:26:47,0,0,0,0,0,0
2,201392387,2170660915,22663,36895,2024-10-04 19:26:47,0,0,0,0,0,0
2,201392387,2170660915,204,36895,2024-10-04 19:26:47,0,0,0,0,0,0
2,201392387,2170660915,53926,36895,2024-10-04 19:26:47,0,0,0,0,0,0
2,201392387,2170660915,29419,36895,2024-10-04 19:26:47,0,0,0,0,0,0
2,201392387,2170660915,0,0,2024-10-04 19:26:47,0,0,0,0,0,0
2,201392387,2170660915,39639,36895,2024-10-04 19:26:48,0,0,0,0,0,0
2,201392387,2170660915,22663,36895,2024-10-04 19:26:48,0,0,0,0,0,0
2,201392387,2170660915,204,36895,2024-10-04 19:26:48,0,0,0,0,0,0
2,201392387,2170660915,53926,36895,2024-10-04 19:26:48,0,0,0,0,0,0
2,201392387,2170660915,29419,36895,2024-10-04 19:26:48,0,0,0,0,0,0
2,201392387,2170660915,0,0,2024-10-04 19:26:48,128,0,128,1,0,1
2,201392387,2170660915,39639,36895,2024-10-04 19:26:49,0,0,0,0,0,0
2,201392387,2170660915,22663,36895,2024-10-04 19:26:49,0,0,0,0,0,0
2,201392387,2170660915,204,36895,2024-10-04 19:26:49,0,0,0,0,0,0
2,201392387,2170660915,53926,36895,2024-10-04 19:26:49,0,0,0,0,0,0
2,201392387,2170660915,29419,36895,2024-10-04 19:26:49,0,0,0,0,0,0
2,201392387,2170660915,0,0,2024-10-04 19:26:49,0,84,84,0,1,1
2,201392387,2170660915,39639,36895,2024-10-04 19:26:50,0,0,0,0,0,0
2,201392387,2170660915,22663,36895,2024-10-04 19:26:50,0,0,0,0,0,0
2,201392387,2170660915,204,36895,2024-10-04 19:26:50,0,0,0,0,0,0
2,201392387,2170660915,53926,36895,2024-10-04 19:26:50,0,0,0,0,0,0
2,201392387,2170660915,29419,36895,2024-10-04 19:26:50,0,0,0,0,0,0
2,201392387,2170660915,0,0,2024-10-04 19:26:50,128,84,212,1,1,2
2,201392387,2170660915,39639,36895,2024-10-04 19:26:51,0,0,0,0,0,0
2,201392387,1145490691,5298,47873,2024-10-04 19:26:51,4248,57073,61321,34,45,79
2,201392387,2170660915,22663,36895,2024-10-04 19:26:51,0,0,0,0,0,0
2,201392387,2170660915,204,36895,2024-10-04 19:26:51,0,0,0,0,0,0
2,201392387,2170660915,53926,36895,2024-10-04 19:26:51,0,0,0,0,0,0
2,201392387,2170660915,29419,36895,2024-10-04 19:26:51,0,0,0,0,0,0
2,201392387,2170660915,0,0,2024-10-04 19:26:51,128,84,212,1,1,2
2,201392387,2170660915,39639,36895,2024-10-04 19:26:52,0,0,0,0,0,0
2,201392387,1145490691,5298,47873,2024-10-04 19:26:52,2616,44211,46827,26,33,59
2,201392387,2170660915,22663,36895,2024-10-04 19:26:52,0,0,0,0,0,0
2,201392387,2170660915,204,36895,2024-10-04 19:26:52,0,0,0,0,0,0
2,201392387,2170660915,53926,36895,2024-10-04 19:26:52,0,0,0,0,0,0
2,201392387,2170660915,29419,36895,2024-10-04 19:26:52,0,0,0,0,0,0
2,201392387,2170660915,0,0,2024-10-04 19:26:52,0,0,0,0,0,0
2,201392387,2170660915,39639,36895,2024-10-04 19:26:53,0,0,0,0,0,0
2,201392387,1145490691,5298,47873,2024-10-04 19:26:53,0,0,0,0,0,0
2,201392387,2170660915,22663,36895,2024-10-04 19:26:53,0,0,0,0,0,0
2,201392387,2170660915,204,36895,2024-10-04 19:26:53,0,0,0,0,0,0
2,201392387,2170660915,53926,36895,2024-10-04 19:26:53,0,0,0,0,0,0
2,201392387,2170660915,29419,36895,2024-10-04 19:26:53,0,0,0,0,0,0
2,201392387,2170660915,0,0,2024-10-04 19:26:53,0,0,0,0,0,0
2,201392387,2170660915,39639,36895,2024-10-04 19:26:54,0,0,0,0,0,0
2,201392387,1145490691,5298,47873,2024-10-04 19:26:54,0,0,0,0,0,0
2,201392387,2170660915,22663,36895,2024-10-04 19:26:54,0,0,0,0,0,0
2,201392387,2170660915,204,36895,2024-10-04 19:26:54,0,0,0,0,0,0
2,201392387,2170660915,53926,36895,2024-10-04 19:26:54,0,0,0,0,0,0
2,201392387,2170660915,29419,36895,2024-10-04 19:26:54,0,0,0,0,0,0
2,201392387,2170660915,0,0,2024-10-04 19:26:54,0,0,0,0,0,0
2,201392387,2170660915,39639,36895,2024-10-04 19:26:55,0,0,0,0,0,0
2,201392387,1145490691,5298,47873,2024-10-04 19:26:55,0,0,0,0,0,0
2,201392387,2170660915,22663,36895,2024-10-04 19:26:55,0,0,0,0,0,0
2,201392387,2170660915,204,36895,2024-10-04 19:26:55,0,0,0,0,0,0
2,201392387,2170660915,53926,36895,2024-10-04 19:26:55,0,0,0,0,0,0
2,201392387,2170660915,29419,36895,2024-10-04 19:26:55,0,0,0,0,0,0
2,201392387,2170660915,0,0,2024-10-04 19:26:55,0,0,0,0,0,0
2,201392387,2170660915,39639,36895,2024-10-04 19:26:56,0,0,0,0,0,0
2,201392387,1145490691,5298,47873,2024-10-04 19:26:56,0,0,0,0,0,0
2,201392387,2170660915,22663,36895,2024-10-04 19:26:56,0,0,0,0,0,0
2,201392387,2170660915,204,36895,2024-10-04 19:26:56,0,0,0,0,0,0
2,201392387,2170660915,53926,36895,2024-10-04 19:26:56,0,0,0,0,0,0
2,201392387,2170660915,29419,36895,2024-10-04 19:26:56,0,0,0,0,0,0
2,201392387,2170660915,0,0,2024-10-04 19:26:56,0,0,0,0,0,0
2,201392387,2170660915,39639,36895,2024-10-04 19:26:57,0,0,0,0,0,0
2,201392387,1145490691,5298,47873,2024-10-04 19:26:57,0,0,0,0,0,0
2,201392387,2170660915,22663,36895,2024-10-04 19:26:57,0,0,0,0,0,0
2,201392387,2170660915,204,36895,2024-10-04 19:26:57,0,0,0,0,0,0
2,201392387,2170660915,53926,36895,2024-10-04 19:26:57,0,0,0,0,0,0
2,201392387,2170660915,29419,36895,2024-10-04 19:26:57,0,0,0,0,0,0
2,201392387,2170660915,0,0,2024-10-04 19:26:57,0,0,0,0,0,0
2,201392387,2170660915,39639,36895,2024-10-04 19:26:58,0,0,0,0,0,0
2,201392387,1145490691,5298,47873,2024-10-04 19:26:58,0,0,0,0,0,0
2,201392387,2170660915,22663,36895,2024-10-04 19:26:58,0,0,0,0,0,0
2,201392387,2170660915,204,36895,2024-10-04 19:26:58,0,0,0,0,0,0
2,201392387,2170660915,53926,36895,2024-10-04 19:26:58,0,0,0,0,0,0
2,201392387,2170660915,29419,36895,2024-10-04 19:26:58,0,0,0,0,0,0
2,201392387,2170660915,0,0,2024-10-04 19:26:58,0,0,0,0,0,0
2,201392387,2170660915,39639,36895,2024-10-04 19:26:59,0,0,0,0,0,0
2,201392387,1145490691,5298,47873,2024-10-04 19:26:59,0,0,0,0,0,0
2,201392387,2170660915,22663,36895,2024-10-04 19:26:59,0,0,0,0,0,0
2,201392387,2170660915,204,36895,2024-10-04 19:26:59,0,0,0,0,0,0
2,201392387,2170660915,53926,36895,2024-10-04 19:26:59,0,0,0,0,0,0
2,201392387,2170660915,29419,36895,2024-10-04 19:26:59,0,0,0,0,0,0
2,201392387,2170660915,0,0,2024-10-04 19:26:59,0,0,0,0,0,0
2,201392387,2170660915,39639,36895,2024-10-04 19:27:00,0,0,0,0,0,0
2,201392387,1145490691,5298,47873,2024-10-04 19:27:00,0,0,0,0,0,0
2,201392387,2170660915,22663,36895,2024-10-04 19:27:00,0,0,0,0,0,0
2,201392387,2170660915,204,36895,2024-10-04 19:27:00,0,0,0,0,0,0
2,201392387,2170660915,53926,36895,2024-10-04 19:27:00,0,0,0,0,0,0
2,201392387,2170660915,29419,36895,2024-10-04 19:27:00,0,0,0,0,0,0
2,201392387,2170660915,0,0,2024-10-04 19:27:00,0,0,0,0,0,0
2,201392387,2170660915,39639,36895,2024-10-04 19:27:01,0,0,0,0,0,0
2,201392387,1145490691,5298,47873,2024-10-04 19:27:01,0,0,0,0,0,0
2,201392387,2170660915,22663,36895,2024-10-04 19:27:01,0,0,0,0,0,0
2,201392387,2170660915,204,36895,2024-10-04 19:27:01,0,0,0,0,0,0
2,201392387,2170660915,53926,36895,2024-10-04 19:27:01,0,0,0,0,0,0
2,201392387,2170660915,29419,36895,2024-10-04 19:27:01,0,0,0,0,0,0
2,201392387,2170660915,0,0,2024-10-04 19:27:01,0,0,0,0,0,0
2,201392387,2170660915,39639,36895,2024-10-04 19:27:02,0,0,0,0,0,0
2,201392387,1145490691,5298,47873,2024-10-04 19:27:02,0,0,0,0,0,0
2,201392387,2170660915,22663,36895,2024-10-04 19:27:02,0,0,0,0,0,0
2,201392387,2170660915,204,36895,2024-10-04 19:27:02,0,0,0,0,0,0
2,201392387,2170660915,53926,36895,2024-10-04 19:27:02,0,0,0,0,0,0
2,201392387,2170660915,29419,36895,2024-10-04 19:27:02,0,0,0,0,0,0
2,201392387,2170660915,0,0,2024-10-04 19:27:02,0,0,0,0,0,0
2,201392387,2170660915,39639,36895,2024-10-04 19:27:03,0,0,0,0,0,0
2,201392387,1145490691,5298,47873,2024-10-04 19:27:03,0,0,0,0,0,0
2,201392387,2170660915,22663,36895,2024-10-04 19:27:03,0,0,0,0,0,0
2,201392387,2170660915,204,36895,2024-10-04 19:27:03,0,0,0,0,0,0
2,201392387,2170660915,53926,36895,2024-10-04 19:27:03,0,0,0,0,0,0
2,201392387,2170660915,29419,36895,2024-10-04 19:27:03,0,0,0,0,0,0
2,201392387,2170660915,0,0,2024-10-04 19:27:03,128,84,212,1,1,2
2,201392387,2170660915,39639,36895,2024-10-04 19:27:04,0,0,0,0,0,0
2,201392387,1145490691,5298,47873,2024-10-04 19:27:04,0,0,0,0,0,0
2,201392387,2170660915,22663,36895,2024-10-04 19:27:04,0,0,0,0,0,0
2,201392387,2170660915,204,36895,2024-10-04 19:27:04,0,0,0,0,0,0
2,201392387,2170660915,53926,36895,2024-10-04 19:27:04,0,0,0,0,0,0
2,201392387,2170660915,29419,36895,2024-10-04 19:27:04,0,0,0,0,0,0
2,201392387,2170660915,0,0,2024-10-04 19:27:04,128,84,212,1,1,2
2,201392387,2170660915,39639,36895,2024-10-04 19:27:05,0,0,0,0,0,0
2,201392387,1145490691,5298,47873,2024-10-04 19:27:05,0,0,0,0,0,0
2,201392387,2170660915,22663,36895,2024-10-04 19:27:05,0,0,0,0,0,0
2,201392387,2170660915,204,36895,2024-10-04 19:27:05,0,0,0,0,0,0
2,201392387,2170660915,53926,36895,2024-10-04 19:27:05,0,0,0,0,0,0
2,201392387,2170660915,29419,36895,2024-10-04 19:27:05,0,0,0,0,0,0
2,201392387,2170660915,0,0,2024-10-04 19:27:05,128,84,212,1,1,2
2,201392387,2170660915,39639,36895,2024-10-04 19:27:06,0,0,0,0,0,0
2,201392387,1145490691,5298,47873,2024-10-04 19:27:06,0,0,0,0,0,0
2,201392387,2170660915,22663,36895,2024-10-04 19:27:06,0,0,0,0,0,0
2,201392387,2170660915,204,36895,2024-10-04 19:27:06,0,0,0,0,0,0
2,201392387,2170660915,53926,36895,2024-10-04 19:27:06,0,0,0,0,0,0
2,201392387,2170660915,29419,36895,2024-10-04 19:27:06,0,0,0,0,0,0
2,201392387,2170660915,0,0,2024-10-04 19:27:06,128,84,212,1,1,2
2,201392387,2170660915,39639,36895,2024-10-04 19:27:07,0,0,0,0,0,0
2,201392387,1145490691,5298,47873,2024-10-04 19:27:07,0,0,0,0,0,0
2,201392387,2170660915,22663,36895,2024-10-04 19:27:07,0,0,0,0,0,0
2,201392387,2170660915,204,36895,2024-10-04 19:27:07,0,0,0,0,0,0
2,201392387,2170660915,53926,36895,2024-10-04 19:27:07,0,0,0,0,0,0
2,201392387,2170660915,29419,36895,2024-10-04 19:27:07,0,0,0,0,0,0
2,201392387,2170660915,0,0,2024-10-04 19:27:07,128,84,212,1,1,2
2,201392387,2170660915,39639,36895,2024-10-04 19:27:08,0,0,0,0,0,0
2,201392387,1145490691,5298,47873,2024-10-04 19:27:08,0,0,0,0,0,0
2,201392387,2170660915,22663,36895,2024-10-04 19:27:08,0,0,0,0,0,0
2,201392387,2170660915,204,36895,2024-10-04 19:27:08,0,0,0,0,0,0
2,201392387,2170660915,53926,36895,2024-10-04 19:27:08,0,0,0,0,0,0
2,201392387,2170660915,29419,36895,2024-10-04 19:27:08,0,0,0,0,0,0
2,201392387,2170660915,0,0,2024-10-04 19:27:08,128,84,212,1,1,2
2,201392387,2170660915,39639,36895,2024-10-04 19:27:09,0,0,0,0,0,0
2,201392387,1145490691,5298,47873,2024-10-04 19:27:09,0,0,0,0,0,0
2,201392387,2170660915,22663,36895,2024-10-04 19:27:09,0,0,0,0,0,0
2,201392387,2170660915,204,36895,2024-10-04 19:27:09,0,0,0,0,0,0
2,201392387,2170660915,53926,36895,2024-10-04 19:27:09,0,0,0,0,0,0
2,201392387,2170660915,29419,36895,2024-10-04 19:27:09,0,0,0,0,0,0
2,201392387,2170660915,0,0,2024-10-04 19:27:09,128,84,212,1,1,2
2,201392387,2170660915,39639,36895,2024-10-04 19:27:10,0,0,0,0,0,0
2,201392387,1145490691,5298,47873,2024-10-04 19:27:10,0,0,0,0,0,0
2,201392387,2170660915,22663,36895,2024-10-04 19:27:10,0,0,0,0,0,0
2,201392387,2170660915,204,36895,2024-10-04 19:27:10,0,0,0,0,0,0
2,201392387,2170660915,53926,36895,2024-10-04 19:27:10,0,0,0,0,0,0
2,201392387,2170660915,29419,36895,2024-10-04 19:27:10,0,0,0,0,0,0
2,201392387,2170660915,0,0,2024-10-04 19:27:10,128,84,212,1,1,2
2,201392387,2170660915,39639,36895,2024-10-04 19:27:11,0,0,0,0,0,0
2,201392387,1145490691,5298,47873,2024-10-04 19:27:11,0,0,0,0,0,0
2,201392387,2170660915,22663,36895,2024-10-04 19:27:11,0,0,0,0,0,0
2,201392387,2170660915,204,36895,2024-10-04 19:27:11,0,0,0,0,0,0
2,201392387,2170660915,53926,36895,2024-10-04 19:27:11,0,0,0,0,0,0
2,201392387,2170660915,29419,36895,2024-10-04 19:27:11,0,0,0,0,0,0
2,201392387,2170660915,0,0,2024-10-04 19:27:11,256,168,424,2,2,4
2,201392387,2170660915,39639,36895,2024-10-04 19:27:12,0,0,0,0,0,0
2,201392387,2170660915,22663,36895,2024-10-04 19:27:12,0,0,0,0,0,0
2,201392387,2170660915,204,36895,2024-10-04 19:27:12,0,0,0,0,0,0
2,201392387,2170660915,53926,36895,2024-10-04 19:27:12,0,0,0,0,0,0
2,201392387,2170660915,29419,36895,2024-10-04 19:27:12,0,0,0,0,0,0
2,201392387,2170660915,0,0,2024-10-04 19:27:12,0,0,0,0,0,0
2,201392387,2170660915,39639,36895,2024-10-04 19:27:13,0,0,0,0,0,0
2,201392387,2170660915,22663,36895,2024-10-04 19:27:13,0,0,0,0,0,0
2,201392387,2170660915,16018,36895,2024-10-04 19:27:13,666,507,1173,6,6,12
2,201392387,2170660915,53926,36895,2024-10-04 19:27:13,0,0,0,0,0,0
2,201392387,2170660915,29419,36895,2024-10-04 19:27:13,0,0,0,0,0,0
2,201392387,2170660915,0,0,2024-10-04 19:27:13,0,0,0,0,0,0
2,201392387,2170660915,39639,36895,2024-10-04 19:27:14,0,0,0,0,0,0
2,201392387,2170660915,22663,36895,2024-10-04 19:27:14,0,0,0,0,0,0
2,201392387,2170660915,16018,36895,2024-10-04 19:27:14,0,0,0,0,0,0
2,201392387,2170660915,53926,36895,2024-10-04 19:27:14,0,0,0,0,0,0
2,201392387,2170660915,29419,36895,2024-10-04 19:27:14,0,0,0,0,0,0
2,201392387,2170660915,0,0,2024-10-04 19:27:14,0,0,0,0,0,0
2,201392387,2170660915,39639,36895,2024-10-04 19:27:15,0,0,0,0,0,0
2,201392387,2170660915,22663,36895,2024-10-04 19:27:15,0,0,0,0,0,0
2,201392387,2170660915,16018,36895,2024-10-04 19:27:15,0,0,0,0,0,0
2,201392387,2170660915,53926,36895,2024-10-04 19:27:15,0,0,0,0,0,0
2,201392387,2170660915,0,0,2024-10-04 19:27:15,128,84,212,1,1,2
2,201392387,2170660915,39639,36895,2024-10-04 19:27:16,0,0,0,0,0,0
2,201392387,2170660915,22663,36895,2024-10-04 19:27:16,0,0,0,0,0,0
2,201392387,2170660915,16018,36895,2024-10-04 19:27:16,0,0,0,0,0,0
2,201392387,2170660915,53926,36895,2024-10-04 19:27:16,0,0,0,0,0,0
2,201392387,2170660915,0,0,2024-10-04 19:27:16,128,84,212,1,1,2
2,201392387,2170660915,39639,36895,2024-10-04 19:27:17,0,0,0,0,0,0
2,201392387,2170660915,22663,36895,2024-10-04 19:27:17,0,0,0,0,0,0
2,201392387,2170660915,16018,36895,2024-10-04 19:27:17,0,0,0,0,0,0
2,201392387,2170660915,53926,36895,2024-10-04 19:27:17,0,0,0,0,0,0
2,201392387,2170660915,0,0,2024-10-04 19:27:17,128,84,212,1,1,2
2,201392387,2170660915,39639,36895,2024-10-04 19:27:18,0,0,0,0,0,0
2,201392387,2170660915,22663,36895,2024-10-04 19:27:18,0,0,0,0,0,0
2,201392387,2170660915,16018,36895,2024-10-04 19:27:18,0,0,0,0,0,0
2,201392387,2170660915,53926,36895,2024-10-04 19:27:18,0,0,0,0,0,0
2,201392387,2170660915,0,0,2024-10-04 19:27:18,0,0,0,0,0,0
2,201392387,2170660915,39639,36895,2024-10-04 19:27:19,0,0,0,0,0,0
2,201392387,2170660915,22663,36895,2024-10-04 19:27:19,0,0,0,0,0,0
2,201392387,2170660915,16018,36895,2024-10-04 19:27:19,0,0,0,0,0,0
2,201392387,2170660915,53926,36895,2024-10-04 19:27:19,0,0,0,0,0,0
2,201392387,2170660915,0,0,2024-10-04 19:27:19,0,0,0,0,0,0
2,201392387,2170660915,39639,36895,2024-10-04 19:27:20,0,0,0,0,0,0
2,201392387,2170660915,22663,36895,2024-10-04 19:27:20,0,0,0,0,0,0
2,201392387,2170660915,16018,36895,2024-10-04 19:27:20,0,0,0,0,0,0
2,201392387,2170660915,53926,36895,2024-10-04 19:27:20,0,0,0,0,0,0
2,201392387,2170660915,0,0,2024-10-04 19:27:20,128,84,212,1,1,2
2,201392387,2170660915,39639,36895,2024-10-04 19:27:21,0,0,0,0,0,0
2,201392387,2170660915,22663,36895,2024-10-04 19:27:21,0,0,0,0,0,0
2,201392387,2170660915,16018,36895,2024-10-04 19:27:21,0,0,0,0,0,0
2,201392387,2170660915,53926,36895,2024-10-04 19:27:21,0,0,0,0,0,0
2,201392387,2170660915,0,0,2024-10-04 19:27:21,128,84,212,1,1,2
2,201392387,2170660915,39639,36895,2024-10-04 19:27:22,0,0,0,0,0,0
2,201392387,2170660915,22663,36895,2024-10-04 19:27:22,0,0,0,0,0,0
2,201392387,2170660915,16018,36895,2024-10-04 19:27:22,0,0,0,0,0,0
2,201392387,2170660915,53926,36895,2024-10-04 19:27:22,0,0,0,0,0,0
2,201392387,2170660915,0,0,2024-10-04 19:27:22,128,84,212,1,1,2
2,201392387,1145490691,58000,47873,2024-10-04 19:27:22,2508,28865,31373,17,26,43
2,201392387,2170660915,39639,36895,2024-10-04 19:27:23,0,0,0,0,0,0
2,201392387,2170660915,22663,36895,2024-10-04 19:27:23,0,0,0,0,0,0
2,201392387,2170660915,16018,36895,2024-10-04 19:27:23,0,0,0,0,0,0
2,201392387,2170660915,53926,36895,2024-10-04 19:27:23,0,0,0,0,0,0
2,201392387,2170660915,0,0,2024-10-04 19:27:23,0,0,0,0,0,0
2,201392387,1145490691,58000,47873,2024-10-04 19:27:23,600,18076,18676,6,11,17
2,201392387,2170660915,39639,36895,2024-10-04 19:27:24,0,0,0,0,0,0
2,201392387,2170660915,22663,36895,2024-10-04 19:27:24,0,0,0,0,0,0
2,201392387,2170660915,16018,36895,2024-10-04 19:27:24,0,0,0,0,0,0
2,201392387,2170660915,53926,36895,2024-10-04 19:27:24,0,0,0,0,0,0
2,201392387,2170660915,0,0,2024-10-04 19:27:24,0,0,0,0,0,0
2,201392387,1145490691,58000,47873,2024-10-04 19:27:24,0,0,0,0,0,0
2,201392387,2170660915,39639,36895,2024-10-04 19:27:25,0,0,0,0,0,0
2,201392387,2170660915,22663,36895,2024-10-04 19:27:25,0,0,0,0,0,0
2,201392387,2170660915,16018,36895,2024-10-04 19:27:25,0,0,0,0,0,0
2,201392387,2170660915,53926,36895,2024-10-04 19:27:25,0,0,0,0,0,0
2,201392387,2170660915,0,0,2024-10-04 19:27:25,0,0,0,0,0,0
2,201392387,1145490691,58000,47873,2024-10-04 19:27:25,0,0,0,0,0,0
2,201392387,2170660915,39639,36895,2024-10-04 19:27:26,0,0,0,0,0,0
2,201392387,2170660915,22663,36895,2024-10-04 19:27:26,0,0,0,0,0,0
2,201392387,2170660915,16018,36895,2024-10-04 19:27:26,0,0,0,0,0,0
2,201392387,2170660915,53926,36895,2024-10-04 19:27:26,0,0,0,0,0,0
2,201392387,2170660915,0,0,2024-10-04 19:27:26,0,0,0,0,0,0
2,201392387,1145490691,58000,47873,2024-10-04 19:27:26,0,0,0,0,0,0
2,201392387,2170660915,39639,36895,2024-10-04 19:27:27,0,0,0,0,0,0
2,201392387,2170660915,22663,36895,2024-10-04 19:27:27,0,0,0,0,0,0
2,201392387,2170660915,16018,36895,2024-10-04 19:27:27,0,0,0,0,0,0
2,201392387,2170660915,53926,36895,2024-10-04 19:27:27,0,0,0,0,0,0
2,201392387,2170660915,0,0,2024-10-04 19:27:27,0,0,0,0,0,0
2,201392387,1145490691,58000,47873,2024-10-04 19:27:27,0,0,0,0,0,0
2,201392387,2170660915,39639,36895,2024-10-04 19:27:28,0,0,0,0,0,0
2,201392387,2170660915,22663,36895,2024-10-04 19:27:28,0,0,0,0,0,0
2,201392387,2170660915,16018,36895,2024-10-04 19:27:28,0,0,0,0,0,0
2,201392387,2170660915,53926,36895,2024-10-04 19:27:28,0,0,0,0,0,0
2,201392387,2170660915,0,0,2024-10-04 19:27:28,0,0,0,0,0,0
2,201392387,1145490691,58000,47873,2024-10-04 19:27:28,0,0,0,0,0,0
2,201392387,2170660915,39639,36895,2024-10-04 19:27:29,0,0,0,0,0,0
2,201392387,2170660915,22663,36895,2024-10-04 19:27:29,0,0,0,0,0,0
2,201392387,2170660915,16018,36895,2024-10-04 19:27:29,0,0,0,0,0,0
2,201392387,2170660915,53926,36895,2024-10-04 19:27:29,0,0,0,0,0,0
2,201392387,2170660915,0,0,2024-10-04 19:27:29,0,0,0,0,0,0
2,201392387,1145490691,58000,47873,2024-10-04 19:27:29,0,0,0,0,0,0
2,201392387,2170660915,39639,36895,2024-10-04 19:27:30,0,0,0,0,0,0
2,201392387,2170660915,22663,36895,2024-10-04 19:27:30,0,0,0,0,0,0
2,201392387,2170660915,16018,36895,2024-10-04 19:27:30,0,0,0,0,0,0
2,201392387,2170660915,53926,36895,2024-10-04 19:27:30,0,0,0,0,0,0
2,201392387,2170660915,0,0,2024-10-04 19:27:30,0,0,0,0,0,0
2,201392387,1145490691,58000,47873,2024-10-04 19:27:30,0,0,0,0,0,0
2,201392387,2170660915,39639,36895,2024-10-04 19:27:31,0,0,0,0,0,0
2,201392387,2170660915,22663,36895,2024-10-04 19:27:31,0,0,0,0,0,0
2,201392387,2170660915,16018,36895,2024-10-04 19:27:31,0,0,0,0,0,0
2,201392387,2170660915,53926,36895,2024-10-04 19:27:31,0,0,0,0,0,0
2,201392387,2170660915,0,0,2024-10-04 19:27:31,0,0,0,0,0,0
2,201392387,1145490691,58000,47873,2024-10-04 19:27:31,3180,58359,61539,32,42,74
2,201392387,2170660915,39639,36895,2024-10-04 19:27:32,0,0,0,0,0,0
2,201392387,2170660915,22663,36895,2024-10-04 19:27:32,0,0,0,0,0,0
2,201392387,2170660915,16018,36895,2024-10-04 19:27:32,0,0,0,0,0,0
2,201392387,2170660915,53926,36895,2024-10-04 19:27:32,0,0,0,0,0,0
2,201392387,2170660915,0,0,2024-10-04 19:27:32,0,0,0,0,0,0
2,201392387,1145490691,58000,47873,2024-10-04 19:27:32,0,0,0,0,0,0
2,201392387,2170660915,39639,36895,2024-10-04 19:27:33,0,0,0,0,0,0
2,201392387,2170660915,22663,36895,2024-10-04 19:27:33,0,0,0,0,0,0
2,201392387,2170660915,16018,36895,2024-10-04 19:27:33,0,0,0,0,0,0
2,201392387,2170660915,53926,36895,2024-10-04 19:27:33,0,0,0,0,0,0
2,201392387,2170660915,0,0,2024-10-04 19:27:33,0,0,0,0,0,0
2,201392387,1145490691,58000,47873,2024-10-04 19:27:33,0,0,0,0,0,0
2,201392387,2170660915,39639,36895,2024-10-04 19:27:34,0,0,0,0,0,0
2,201392387,2170660915,22663,36895,2024-10-04 19:27:34,0,0,0,0,0,0
2,201392387,2170660915,16018,36895,2024-10-04 19:27:34,0,0,0,0,0,0
2,201392387,2170660915,53926,36895,2024-10-04 19:27:34,0,0,0,0,0,0
2,201392387,2170660915,0,0,2024-10-04 19:27:34,128,84,212,1,1,2
2,201392387,1145490691,58000,47873,2024-10-04 19:27:34,0,0,0,0,0,0
2,201392387,2170660915,39639,36895,2024-10-04 19:27:35,0,0,0,0,0,0
2,201392387,2170660915,22663,36895,2024-10-04 19:27:35,0,0,0,0,0,0
2,201392387,2170660915,16018,36895,2024-10-04 19:27:35,0,0,0,0,0,0
2,201392387,2170660915,53926,36895,2024-10-04 19:27:35,0,0,0,0,0,0
2,201392387,2170660915,0,0,2024-10-04 19:27:35,128,84,212,1,1,2
2,201392387,1145490691,58000,47873,2024-10-04 19:27:35,0,0,0,0,0,0
2,201392387,2170660915,39639,36895,2024-10-04 19:27:36,0,0,0,0,0,0
2,201392387,2170660915,22663,36895,2024-10-04 19:27:36,0,0,0,0,0,0
2,201392387,2170660915,16018,36895,2024-10-04 19:27:36,0,0,0,0,0,0
2,201392387,2170660915,53926,36895,2024-10-04 19:27:36,0,0,0,0,0,0
2,201392387,2170660915,0,0,2024-10-04 19:27:36,128,84,212,1,1,2
2,201392387,1145490691,58000,47873,2024-10-04 19:27:36,0,0,0,0,0,0
2,201392387,2170660915,39639,36895,2024-10-04 19:27:37,0,0,0,0,0,0
2,201392387,2170660915,22663,36895,2024-10-04 19:27:37,0,0,0,0,0,0
2,201392387,2170660915,16018,36895,2024-10-04 19:27:37,0,0,0,0,0,0
2,201392387,2170660915,53926,36895,2024-10-04 19:27:37,0,0,0,0,0,0
2,201392387,2170660915,0,0,2024-10-04 19:27:37,128,84,212,1,1,2
2,201392387,1145490691,58000,47873,2024-10-04 19:27:37,0,0,0,0,0,0
2,201392387,2170660915,39639,36895,2024-10-04 19:27:38,0,0,0,0,0,0
2,201392387,2170660915,22663,36895,2024-10-04 19:27:38,0,0,0,0,0,0
2,201392387,2170660915,16018,36895,2024-10-04 19:27:38,0,0,0,0,0,0
2,201392387,2170660915,53926,36895,2024-10-04 19:27:38,0,0,0,0,0,0
2,201392387,2170660915,0,0,2024-10-04 19:27:38,128,84,212,1,1,2
2,201392387,1145490691,58000,47873,2024-10-04 19:27:38,0,0,0,0,0,0
2,201392387,2170660915,39639,36895,2024-10-04 19:27:39,0,0,0,0,0,0
2,201392387,2170660915,22663,36895,2024-10-04 19:27:39,0,0,0,0,0,0
2,201392387,2170660915,16018,36895,2024-10-04 19:27:39,0,0,0,0,0,0
2,201392387,2170660915,53926,36895,2024-10-04 19:27:39,0,0,0,0,0,0
2,201392387,2170660915,0,0,2024-10-04 19:27:39,128,84,212,1,1,2
2,201392387,1145490691,58000,47873,2024-10-04 19:27:39,0,0,0,0,0,0
2,201392387,2170660915,39639,36895,2024-10-04 19:27:40,0,0,0,0,0,0
2,201392387,2170660915,22663,36895,2024-10-04 19:27:40,0,0,0,0,0,0
2,201392387,2170660915,16018,36895,2024-10-04 19:27:40,0,0,0,0,0,0
2,201392387,2170660915,53926,36895,2024-10-04 19:27:40,0,0,0,0,0,0
2,201392387,2170660915,0,0,2024-10-04 19:27:40,128,84,212,1,1,2
2,201392387,1145490691,58000,47873,2024-10-04 19:27:40,0,0,0,0,0,0
2,201392387,2170660915,39639,36895,2024-10-04 19:27:41,0,0,0,0,0,0
2,201392387,2170660915,22663,36895,2024-10-04 19:27:41,0,0,0,0,0,0
2,201392387,2170660915,16018,36895,2024-10-04 19:27:41,0,0,0,0,0,0
2,201392387,2170660915,53926,36895,2024-10-04 19:27:41,0,0,0,0,0,0
2,201392387,2170660915,0,0,2024-10-04 19:27:41,128,84,212,1,1,2
2,201392387,2170660915,39639,36895,2024-10-04 19:27:42,0,0,0,0,0,0
2,201392387,2170660915,22663,36895,2024-10-04 19:27:42,0,0,0,0,0,0
2,201392387,2170660915,16018,36895,2024-10-04 19:27:42,0,0,0,0,0,0
2,201392387,2170660915,53926,36895,2024-10-04 19:27:42,0,0,0,0,0,0
2,201392387,2170660915,0,0,2024-10-04 19:27:42,128,84,212,1,1,2
2,201392387,2170660915,39639,36895,2024-10-04 19:27:43,0,0,0,0,0,0
2,201392387,2170660915,22663,36895,2024-10-04 19:27:43,0,0,0,0,0,0
2,201392387,2170660915,16018,36895,2024-10-04 19:27:43,0,0,0,0,0,0
2,201392387,2170660915,53926,36895,2024-10-04 19:27:43,0,0,0,0,0,0
2,201392387,2170660915,0,0,2024-10-04 19:27:43,128,84,212,1,1,2
2,201392387,2170660915,39639,36895,2024-10-04 19:27:44,0,0,0,0,0,0
2,201392387,2170660915,22663,36895,2024-10-04 19:27:44,0,0,0,0,0,0
2,201392387,2170660915,53926,36895,2024-10-04 19:27:44,0,0,0,0,0,0
2,201392387,2170660915,0,0,2024-10-04 19:27:44,0,0,0,0,0,0
2,201392387,2170660915,39639,36895,2024-10-04 19:27:45,0,0,0,0,0,0
2,201392387,2170660915,22663,36895,2024-10-04 19:27:45,0,0,0,0,0,0
2,201392387,2170660915,53926,36895,2024-10-04 19:27:45,0,0,0,0,0,0
2,201392387,2170660915,0,0,2024-10-04 19:27:45,0,0,0,0,0,0
2,201392387,2170660915,39639,36895,2024-10-04 19:27:46,0,0,0,0,0,0
2,201392387,2170660915,39132,36895,2024-10-04 19:27:46,666,507,1173,6,6,12
2,201392387,2170660915,22663,36895,2024-10-04 19:27:46,0,0,0,0,0,0
2,201392387,2170660915,53926,36895,2024-10-04 19:27:46,0,0,0,0,0,0
2,201392387,2170660915,0,0,2024-10-04 19:27:46,0,0,0,0,0,0
2,201392387,2170660915,39639,36895,2024-10-04 19:27:47,0,0,0,0,0,0
2,201392387,2170660915,39132,36895,2024-10-04 19:27:47,0,0,0,0,0,0
2,201392387,2170660915,22663,36895,2024-10-04 19:27:47,0,0,0,0,0,0
2,201392387,2170660915,53926,36895,2024-10-04 19:27:47,0,0,0,0,0,0
2,201392387,2170660915,0,0,2024-10-04 19:27:47,128,84,212,1,1,2
2,201392387,2170660915,39639,36895,2024-10-04 19:27:48,0,0,0,0,0,0
2,201392387,2170660915,39132,36895,2024-10-04 19:27:48,0,0,0,0,0,0
2,201392387,2170660915,22663,36895,2024-10-04 19:27:48,0,0,0,0,0,0
2,201392387,2170660915,53926,36895,2024-10-04 19:27:48,0,0,0,0,0,0
2,201392387,2170660915,0,0,2024-10-04 19:27:48,128,84,212,1,1,2
2,201392387,2170660915,39639,36895,2024-10-04 19:27:49,0,0,0,0,0,0
2,201392387,2170660915,39132,36895,2024-10-04 19:27:49,0,0,0,0,0,0
2,201392387,2170660915,22663,36895,2024-10-04 19:27:49,0,0,0,0,0,0
2,201392387,2170660915,53926,36895,2024-10-04 19:27:49,0,0,0,0,0,0
2,201392387,2170660915,0,0,2024-10-04 19:27:49,128,84,212,1,1,2
2,201392387,2170660915,39639,36895,2024-10-04 19:27:50,0,0,0,0,0,0
2,201392387,2170660915,39132,36895,2024-10-04 19:27:50,0,0,0,0,0,0
2,201392387,2170660915,22663,36895,2024-10-04 19:27:50,0,0,0,0,0,0
2,201392387,2170660915,53926,36895,2024-10-04 19:27:50,0,0,0,0,0,0
2,201392387,2170660915,0,0,2024-10-04 19:27:50,0,0,0,0,0,0
2,201392387,2170660915,39639,36895,2024-10-04 19:27:51,0,0,0,0,0,0
2,201392387,2170660915,39132,36895,2024-10-04 19:27:51,0,0,0,0,0,0
2,201392387,2170660915,22663,36895,2024-10-04 19:27:51,0,0,0,0,0,0
2,201392387,2170660915,53926,36895,2024-10-04 19:27:51,0,0,0,0,0,0
2,201392387,2170660915,0,0,2024-10-04 19:27:51,0,0,0,0,0,0
2,201392387,2170660915,39639,36895,2024-10-04 19:27:52,0,0,0,0,0,0
2,201392387,2170660915,39132,36895,2024-10-04 19:27:52,0,0,0,0,0,0
2,201392387,2170660915,22663,36895,2024-10-04 19:27:52,0,0,0,0,0,0
2,201392387,2170660915,53926,36895,2024-10-04 19:27:52,0,0,0,0,0,0
2,201392387,2170660915,0,0,2024-10-04 19:27:52,128,84,212,1,1,2
2,201392387,2170660915,39639,36895,2024-10-04 19:27:53,0,0,0,0,0,0
2,201392387,2170660915,39132,36895,2024-10-04 19:27:53,0,0,0,0,0,0
2,201392387,2170660915,22663,36895,2024-10-04 19:27:53,0,0,0,0,0,0
2,201392387,2170660915,53926,36895,2024-10-04 19:27:53,0,0,0,0,0,0
2,201392387,2170660915,0,0,2024-10-04 19:27:53,128,84,212,1,1,2
2,201392387,2170660915,39639,36895,2024-10-04 19:27:54,0,0,0,0,0,0
2,201392387,2170660915,39132,36895,2024-10-04 19:27:54,0,0,0,0,0,0
2,201392387,2170660915,22663,36895,2024-10-04 19:27:54,0,0,0,0,0,0
2,201392387,1145490690,53980,47873,2024-10-04 19:27:54,3588,41889,45477,27,37,64
2,201392387,2170660915,53926,36895,2024-10-04 19:27:54,0,0,0,0,0,0
2,201392387,2170660915,0,0,2024-10-04 19:27:54,128,84,212,1,1,2
2,201392387,2170660915,39639,36895,2024-10-04 19:27:55,0,0,0,0,0,0
2,201392387,2170660915,39132,36895,2024-10-04 19:27:55,0,0,0,0,0,0
2,201392387,2170660915,22663,36895,2024-10-04 19:27:55,0,0,0,0,0,0
2,201392387,1145490690,53980,47873,2024-10-04 19:27:55,0,0,0,0,0,0
2,201392387,2170660915,53926,36895,2024-10-04 19:27:55,0,0,0,0,0,0
2,201392387,2170660915,0,0,2024-10-04 19:27:55,0,0,0,0,0,0
2,201392387,2170660915,39639,36895,2024-10-04 19:27:56,0,0,0,0,0,0
2,201392387,2170660915,39132,36895,2024-10-04 19:27:56,0,0,0,0,0,0
2,201392387,2170660915,22663,36895,2024-10-04 19:27:56,0,0,0,0,0,0
2,201392387,1145490690,53980,47873,2024-10-04 19:27:56,0,0,0,0,0,0
2,201392387,2170660915,53926,36895,2024-10-04 19:27:56,0,0,0,0,0,0
2,201392387,2170660915,0,0,2024-10-04 19:27:56,0,0,0,0,0,0
2,201392387,2170660915,39639,36895,2024-10-04 19:27:57,0,0,0,0,0,0
2,201392387,2170660915,39132,36895,2024-10-04 19:27:57,0,0,0,0,0,0
2,201392387,2170660915,22663,36895,2024-10-04 19:27:57,0,0,0,0,0,0
2,201392387,1145490690,53980,47873,2024-10-04 19:27:57,0,0,0,0,0,0
2,201392387,2170660915,53926,36895,2024-10-04 19:27:57,0,0,0,0,0,0
2,201392387,2170660915,0,0,2024-10-04 19:27:57,0,0,0,0,0,0
2,201392387,2170660915,39639,36895,2024-10-04 19:27:58,0,0,0,0,0,0
2,201392387,2170660915,39132,36895,2024-10-04 19:27:58,0,0,0,0,0,0
2,201392387,2170660915,22663,36895,2024-10-04 19:27:58,0,0,0,0,0,0
2,201392387,1145490690,53980,47873,2024-10-04 19:27:58,0,0,0,0,0,0
2,201392387,2170660915,53926,36895,2024-10-04 19:27:58,0,0,0,0,0,0
2,201392387,2170660915,0,0,2024-10-04 19:27:58,0,0,0,0,0,0
2,201392387,2170660915,39639,36895,2024-10-04 19:27:59,0,0,0,0,0,0
2,201392387,2170660915,39132,36895,2024-10-04 19:27:59,0,0,0,0,0,0
2,201392387,2170660915,22663,36895,2024-10-04 19:27:59,0,0,0,0,0,0
2,201392387,1145490690,53980,47873,2024-10-04 19:27:59,0,0,0,0,0,0
2,201392387,2170660915,53926,36895,2024-10-04 19:27:59,0,0,0,0,0,0
2,201392387,2170660915,0,0,2024-10-04 19:27:59,0,0,0,0,0,0
2,201392387,2170660915,39639,36895,2024-10-04 19:28:00,0,0,0,0,0,0
2,201392387,2170660915,39132,36895,2024-10-04 19:28:00,0,0,0,0,0,0
2,201392387,2170660915,22663,36895,2024-10-04 19:28:00,0,0,0,0,0,0
2,201392387,1145490690,53980,47873,2024-10-04 19:28:00,0,0,0,0,0,0
2,201392387,2170660915,53926,36895,2024-10-04 19:28:00,0,0,0,0,0,0
2,201392387,2170660915,0,0,2024-10-04 19:28:00,0,0,0,0,0,0
2,201392387,2170660915,39639,36895,2024-10-04 19:28:01,0,0,0,0,0,0
2,201392387,2170660915,39132,36895,2024-10-04 19:28:01,0,0,0,0,0,0
2,201392387,2170660915,22663,36895,2024-10-04 19:28:01,0,0,0,0,0,0
2,201392387,1145490690,53980,47873,2024-10-04 19:28:01,3360,57361,60721,33,40,73
2,201392387,2170660915,53926,36895,2024-10-04 19:28:01,0,0,0,0,0,0
2,201392387,2170660915,0,0,2024-10-04 19:28:01,0,0,0,0,0,0
2,201392387,2170660915,39639,36895,2024-10-04 19:28:02,0,0,0,0,0,0
2,201392387,2170660915,39132,36895,2024-10-04 19:28:02,0,0,0,0,0,0
2,201392387,2170660915,22663,36895,2024-10-04 19:28:02,0,0,0,0,0,0
2,201392387,1145490690,53980,47873,2024-10-04 19:28:02,0,0,0,0,0,0
2,201392387,2170660915,53926,36895,2024-10-04 19:28:02,0,0,0,0,0,0
2,201392387,2170660915,0,0,2024-10-04 19:28:02,0,0,0,0,0,0
2,201392387,2170660915,39639,36895,2024-10-04 19:28:03,0,0,0,0,0,0
2,201392387,2170660915,39132,36895,2024-10-04 19:28:03,0,0,0,0,0,0
2,201392387,2170660915,22663,36895,2024-10-04 19:28:03,0,0,0,0,0,0
2,201392387,1145490690,53980,47873,2024-10-04 19:28:03,0,0,0,0,0,0
2,201392387,2170660915,53926,36895,2024-10-04 19:28:03,0,0,0,0,0,0
2,201392387,2170660915,0,0,2024-10-04 19:28:03,0,0,0,0,0,0
2,201392387,2170660915,39639,36895,2024-10-04 19:28:04,0,0,0,0,0,0
2,201392387,2170660915,39132,36895,2024-10-04 19:28:04,0,0,0,0,0,0
2,201392387,2170660915,22663,36895,2024-10-04 19:28:04,0,0,0,0,0,0
2,201392387,1145490690,53980,47873,2024-10-04 19:28:04,0,0,0,0,0,0
2,201392387,2170660915,53926,36895,2024-10-04 19:28:04,0,0,0,0,0,0
2,201392387,2170660915,0,0,2024-10-04 19:28:04,0,0,0,0,0,0
2,201392387,2170660915,39639,36895,2024-10-04 19:28:05,0,0,0,0,0,0
2,201392387,2170660915,39132,36895,2024-10-04 19:28:05,0,0,0,0,0,0
2,201392387,2170660915,22663,36895,2024-10-04 19:28:05,0,0,0,0,0,0
2,201392387,1145490690,53980,47873,2024-10-04 19:28:05,0,0,0,0,0,0
2,201392387,2170660915,53926,36895,2024-10-04 19:28:05,0,0,0,0,0,0
2,201392387,2170660915,0,0,2024-10-04 19:28:05,0,0,0,0,0,0
2,201392387,2170660915,39639,36895,2024-10-04 19:28:06,0,0,0,0,0,0
2,201392387,2170660915,39132,36895,2024-10-04 19:28:06,0,0,0,0,0,0
2,201392387,2170660915,22663,36895,2024-10-04 19:28:06,0,0,0,0,0,0
2,201392387,1145490690,53980,47873,2024-10-04 19:28:06,0,0,0,0,0,0
2,201392387,2170660915,53926,36895,2024-10-04 19:28:06,0,0,0,0,0,0
2,201392387,2170660915,0,0,2024-10-04 19:28:06,128,84,212,1,1,2
2,201392387,2170660915,39639,36895,2024-10-04 19:28:07,0,0,0,0,0,0
2,201392387,2170660915,39132,36895,2024-10-04 19:28:07,0,0,0,0,0,0
2,201392387,2170660915,22663,36895,2024-10-04 19:28:07,0,0,0,0,0,0
2,201392387,1145490690,53980,47873,2024-10-04 19:28:07,0,0,0,0,0,0
2,201392387,2170660915,53926,36895,2024-10-04 19:28:07,0,0,0,0,0,0
2,201392387,2170660915,0,0,2024-10-04 19:28:07,128,84,212,1,1,2
2,201392387,2170660915,39639,36895,2024-10-04 19:28:08,0,0,0,0,0,0
2,201392387,2170660915,39132,36895,2024-10-04 19:28:08,0,0,0,0,0,0
2,201392387,2170660915,22663,36895,2024-10-04 19:28:08,0,0,0,0,0,0
2,201392387,1145490690,53980,47873,2024-10-04 19:28:08,0,0,0,0,0,0
2,201392387,2170660915,53926,36895,2024-10-04 19:28:08,0,0,0,0,0,0
2,201392387,2170660915,0,0,2024-10-04 19:28:08,128,84,212,1,1,2
2,201392387,2170660915,39639,36895,2024-10-04 19:28:09,0,0,0,0,0,0
2,201392387,2170660915,39132,36895,2024-10-04 19:28:09,0,0,0,0,0,0
2,201392387,2170660915,22663,36895,2024-10-04 19:28:09,0,0,0,0,0,0
2,201392387,1145490690,53980,47873,2024-10-04 19:28:09,0,0,0,0,0,0
2,201392387,2170660915,53926,36895,2024-10-04 19:28:09,0,0,0,0,0,0
2,201392387,2170660915,0,0,2024-10-04 19:28:09,128,84,212,1,1,2
2,201392387,2170660915,39639,36895,2024-10-04 19:28:10,0,0,0,0,0,0
2,201392387,2170660915,39132,36895,2024-10-04 19:28:10,0,0,0,0,0,0
2,201392387,2170660915,22663,36895,2024-10-04 19:28:10,0,0,0,0,0,0
2,201392387,1145490690,53980,47873,2024-10-04 19:28:10,0,0,0,0,0,0
2,201392387,2170660915,53926,36895,2024-10-04 19:28:10,0,0,0,0,0,0
2,201392387,2170660915,0,0,2024-10-04 19:28:10,128,84,212,1,1,2
2,201392387,2170660915,39639,36895,2024-10-04 19:28:11,0,0,0,0,0,0
2,201392387,2170660915,39132,36895,2024-10-04 19:28:11,0,0,0,0,0,0
2,201392387,2170660915,22663,36895,2024-10-04 19:28:11,0,0,0,0,0,0
2,201392387,2170660915,53926,36895,2024-10-04 19:28:11,0,0,0,0,0,0
2,201392387,2170660915,0,0,2024-10-04 19:28:11,256,168,424,2,2,4
2,201392387,2170660915,39639,36895,2024-10-04 19:28:12,0,0,0,0,0,0
2,201392387,2170660915,39132,36895,2024-10-04 19:28:12,0,0,0,0,0,0
2,201392387,2170660915,22663,36895,2024-10-04 19:28:12,0,0,0,0,0,0
2,201392387,2170660915,53926,36895,2024-10-04 19:28:12,0,0,0,0,0,0
2,201392387,2170660915,0,0,2024-10-04 19:28:12,0,0,0,0,0,0
2,201392387,2170660915,39639,36895,2024-10-04 19:28:13,0,0,0,0,0,0
2,201392387,2170660915,39132,36895,2024-10-04 19:28:13,0,0,0,0,0,0
2,201392387,2170660915,22663,36895,2024-10-04 19:28:13,0,0,0,0,0,0
2,201392387,2170660915,53926,36895,2024-10-04 19:28:13,0,0,0,0,0,0
2,201392387,2170660915,0,0,2024-10-04 19:28:13,256,84,340,2,1,3
2,201392387,2170660915,39639,36895,2024-10-04 19:28:14,0,0,0,0,0,0
2,201392387,2170660915,22663,36895,2024-10-04 19:28:14,0,0,0,0,0,0
2,201392387,2170660915,53926,36895,2024-10-04 19:28:14,0,0,0,0,0,0
2,201392387,2170660915,0,0,2024-10-04 19:28:14,128,84,212,1,1,2
2,201392387,2170660915,39639,36895,2024-10-04 19:28:15,0,0,0,0,0,0
2,201392387,2170660915,22663,36895,2024-10-04 19:28:15,0,0,0,0,0,0
2,201392387,2170660915,53926,36895,2024-10-04 19:28:15,0,0,0,0,0,0
2,201392387,2170660915,0,0,2024-10-04 19:28:15,0,84,84,0,1,1
2,201392387,2170660915,39639,36895,2024-10-04 19:28:16,0,0,0,0,0,0
2,201392387,2170660915,22663,36895,2024-10-04 19:28:16,0,0,0,0,0,0
2,201392387,2170660915,53926,36895,2024-10-04 19:28:16,0,0,0,0,0,0
2,201392387,2170660915,0,0,2024-10-04 19:28:16,0,0,0,0,0,0
2,201392387,2170660915,39639,36895,2024-10-04 19:28:17,0,0,0,0,0,0
2,201392387,2170660915,22663,36895,2024-10-04 19:28:17,0,0,0,0,0,0
2,201392387,2170660915,53926,36895,2024-10-04 19:28:17,0,0,0,0,0,0
2,201392387,2170660915,0,0,2024-10-04 19:28:17,0,0,0,0,0,0
2,201392387,2170660915,53455,36895,2024-10-04 19:28:17,570,455,1025,5,5,10
2,201392387,2170660915,39639,36895,2024-10-04 19:28:18,0,0,0,0,0,0
2,201392387,2170660915,22663,36895,2024-10-04 19:28:18,0,0,0,0,0,0
2,201392387,2170660915,53926,36895,2024-10-04 19:28:18,0,0,0,0,0,0
2,201392387,2170660915,0,0,2024-10-04 19:28:18,256,168,424,2,2,4
2,201392387,2170660915,53455,36895,2024-10-04 19:28:18,0,0,0,0,0,0
2,201392387,2170660915,39639,36895,2024-10-04 19:28:19,0,0,0,0,0,0
2,201392387,2170660915,22663,36895,2024-10-04 19:28:19,0,0,0,0,0,0
2,201392387,2170660915,53926,36895,2024-10-04 19:28:19,0,0,0,0,0,0
2,201392387,2170660915,0,0,2024-10-04 19:28:19,128,84,212,1,1,2
2,201392387,2170660915,53455,36895,2024-10-04 19:28:19,0,0,0,0,0,0
2,201392387,2170660915,39639,36895,2024-10-04 19:28:20,0,0,0,0,0,0
2,201392387,2170660915,22663,36895,2024-10-04 19:28:20,0,0,0,0,0,0
2,201392387,2170660915,53926,36895,2024-10-04 19:28:20,0,0,0,0,0,0
2,201392387,2170660915,0,0,2024-10-04 19:28:20,0,0,0,0,0,0
2,201392387,2170660915,53455,36895,2024-10-04 19:28:20,0,0,0,0,0,0
2,201392387,2170660915,39639,36895,2024-10-04 19:28:21,0,0,0,0,0,0
2,201392387,2170660915,22663,36895,2024-10-04 19:28:21,0,0,0,0,0,0
2,201392387,2170660915,53926,36895,2024-10-04 19:28:21,0,0,0,0,0,0
2,201392387,2170660915,0,0,2024-10-04 19:28:21,0,0,0,0,0,0
2,201392387,2170660915,39639,36895,2024-10-04 19:28:22,0,0,0,0,0,0
2,201392387,2170660915,22663,36895,2024-10-04 19:28:22,0,0,0,0,0,0
2,201392387,2170660915,53926,36895,2024-10-04 19:28:22,0,0,0,0,0,0
2,201392387,2170660915,0,0,2024-10-04 19:28:22,0,0,0,0,0,0
2,201392387,2170660915,39639,36895,2024-10-04 19:28:23,0,0,0,0,0,0
2,201392387,2170660915,22663,36895,2024-10-04 19:28:23,0,0,0,0,0,0
2,201392387,2170660915,53926,36895,2024-10-04 19:28:23,0,0,0,0,0,0
2,201392387,2170660915,0,0,2024-10-04 19:28:23,128,84,212,1,1,2
2,201392387,2170660915,39639,36895,2024-10-04 19:28:24,0,0,0,0,0,0
2,201392387,2170660915,22663,36895,2024-10-04 19:28:24,0,0,0,0,0,0
2,201392387,2170660915,53926,36895,2024-10-04 19:28:24,0,0,0,0,0,0
2,201392387,2170660915,0,0,2024-10-04 19:28:24,128,84,212,1,1,2
2,201392387,2170660915,39639,36895,2024-10-04 19:28:25,0,0,0,0,0,0
2,201392387,2170660915,22663,36895,2024-10-04 19:28:25,0,0,0,0,0,0
2,201392387,2170660915,53926,36895,2024-10-04 19:28:25,0,0,0,0,0,0
2,201392387,1145490690,59011,47873,2024-10-04 19:28:25,3696,47273,50969,28,38,66
2,201392387,2170660915,0,0,2024-10-04 19:28:25,128,84,212,1,1,2
2,201392387,2170660915,39639,36895,2024-10-04 19:28:26,0,0,0,0,0,0
2,201392387,2170660915,22663,36895,2024-10-04 19:28:26,0,0,0,0,0,0
2,201392387,2170660915,53926,36895,2024-10-04 19:28:26,0,0,0,0,0,0
2,201392387,1145490690,59011,47873,2024-10-04 19:28:26,0,0,0,0,0,0
2,201392387,2170660915,0,0,2024-10-04 19:28:26,0,0,0,0,0,0
2,201392387,2170660915,39639,36895,2024-10-04 19:28:27,0,0,0,0,0,0
2,201392387,2170660915,22663,36895,2024-10-04 19:28:27,0,0,0,0,0,0
2,201392387,2170660915,53926,36895,2024-10-04 19:28:27,0,0,0,0,0,0
2,201392387,1145490690,59011,47873,2024-10-04 19:28:27,0,0,0,0,0,0
2,201392387,2170660915,0,0,2024-10-04 19:28:27,0,0,0,0,0,0
2,201392387,2170660915,39639,36895,2024-10-04 19:28:28,0,0,0,0,0,0
2,201392387,2170660915,22663,36895,2024-10-04 19:28:28,0,0,0,0,0,0
2,201392387,2170660915,53926,36895,2024-10-04 19:28:28,0,0,0,0,0,0
2,201392387,1145490690,59011,47873,2024-10-04 19:28:28,0,0,0,0,0,0
2,201392387,2170660915,0,0,2024-10-04 19:28:28,0,0,0,0,0,0
2,201392387,2170660915,39639,36895,2024-10-04 19:28:29,0,0,0,0,0,0
2,201392387,2170660915,22663,36895,2024-10-04 19:28:29,0,0,0,0,0,0
2,201392387,2170660915,53926,36895,2024-10-04 19:28:29,0,0,0,0,0,0
2,201392387,1145490690,59011,47873,2024-10-04 19:28:29,0,0,0,0,0,0
2,201392387,2170660915,0,0,2024-10-04 19:28:29,0,0,0,0,0,0
2,201392387,2170660915,39639,36895,2024-10-04 19:28:30,0,0,0,0,0,0
2,201392387,2170660915,22663,36895,2024-10-04 19:28:30,0,0,0,0,0,0
2,201392387,2170660915,53926,36895,2024-10-04 19:28:30,0,0,0,0,0,0
2,201392387,1145490690,59011,47873,2024-10-04 19:28:30,0,0,0,0,0,0
2,201392387,2170660915,0,0,2024-10-04 19:28:30,0,0,0,0,0,0
2,201392387,2170660915,39639,36895,2024-10-04 19:28:31,0,0,0,0,0,0
2,201392387,2170660915,22663,36895,2024-10-04 19:28:31,0,0,0,0,0,0
2,201392387,2170660915,53926,36895,2024-10-04 19:28:31,0,0,0,0,0,0
2,201392387,1145490690,59011,47873,2024-10-04 19:28:31,2820,49839,52659,28,36,64
2,201392387,2170660915,0,0,2024-10-04 19:28:31,0,0,0,0,0,0
2,201392387,2170660915,39639,36895,2024-10-04 19:28:32,0,0,0,0,0,0
2,201392387,2170660915,22663,36895,2024-10-04 19:28:32,0,0,0,0,0,0
2,201392387,2170660915,53926,36895,2024-10-04 19:28:32,0,0,0,0,0,0
2,201392387,1145490690,59011,47873,2024-10-04 19:28:32,0,0,0,0,0,0
2,201392387,2170660915,0,0,2024-10-04 19:28:32,0,0,0,0,0,0
2,201392387,2170660915,39639,36895,2024-10-04 19:28:33,0,0,0,0,0,0
2,201392387,2170660915,22663,36895,2024-10-04 19:28:33,0,0,0,0,0,0
2,201392387,2170660915,53926,36895,2024-10-04 19:28:33,0,0,0,0,0,0
2,201392387,1145490690,59011,47873,2024-10-04 19:28:33,0,0,0,0,0,0
2,201392387,2170660915,0,0,2024-10-04 19:28:33,0,0,0,0,0,0
2,201392387,2170660915,39639,36895,2024-10-04 19:28:34,0,0,0,0,0,0
2,201392387,2170660915,22663,36895,2024-10-04 19:28:34,0,0,0,0,0,0
2,201392387,2170660915,53926,36895,2024-10-04 19:28:34,0,0,0,0,0,0
2,201392387,1145490690,59011,47873,2024-10-04 19:28:34,0,0,0,0,0,0
2,201392387,2170660915,0,0,2024-10-04 19:28:34,0,0,0,0,0,0
2,201392387,2170660915,39639,36895,2024-10-04 19:28:35,0,0,0,0,0,0
2,201392387,2170660915,22663,36895,2024-10-04 19:28:35,0,0,0,0,0,0
2,201392387,2170660915,53926,36895,2024-10-04 19:28:35,0,0,0,0,0,0
2,201392387,1145490690,59011,47873,2024-10-04 19:28:35,0,0,0,0,0,0
2,201392387,2170660915,0,0,2024-10-04 19:28:35,0,0,0,0,0,0
2,201392387,2170660915,39639,36895,2024-10-04 19:28:36,0,0,0,0,0,0
2,201392387,2170660915,22663,36895,2024-10-04 19:28:36,0,0,0,0,0,0
2,201392387,2170660915,53926,36895,2024-10-04 19:28:36,0,0,0,0,0,0
2,201392387,1145490690,59011,47873,2024-10-04 19:28:36,0,0,0,0,0,0
2,201392387,2170660915,0,0,2024-10-04 19:28:36,128,0,128,1,0,1
2,201392387,2170660915,39639,36895,2024-10-04 19:28:37,0,0,0,0,0,0
2,201392387,2170660915,22663,36895,2024-10-04 19:28:37,0,0,0,0,0,0
2,201392387,2170660915,53926,36895,2024-10-04 19:28:37,0,0,0,0,0,0
2,201392387,1145490690,59011,47873,2024-10-04 19:28:37,0,0,0,0,0,0
2,201392387,2170660915,0,0,2024-10-04 19:28:37,128,84,212,1,1,2
2,201392387,2170660915,39639,36895,2024-10-04 19:28:38,0,0,0,0,0,0
2,201392387,2170660915,22663,36895,2024-10-04 19:28:38,0,0,0,0,0,0
2,201392387,2170660915,53926,36895,2024-10-04 19:28:38,0,0,0,0,0,0
2,201392387,1145490690,59011,47873,2024-10-04 19:28:38,0,0,0,0,0,0
2,201392387,2170660915,0,0,2024-10-04 19:28:38,128,84,212,1,1,2
2,201392387,2170660915,39639,36895,2024-10-04 19:28:39,0,0,0,0,0,0
2,201392387,2170660915,22663,36895,2024-10-04 19:28:39,0,0,0,0,0,0
2,201392387,2170660915,53926,36895,2024-10-04 19:28:39,0,0,0,0,0,0
2,201392387,1145490690,59011,47873,2024-10-04 19:28:39,0,0,0,0,0,0
2,201392387,2170660915,0,0,2024-10-04 19:28:39,128,84,212,1,1,2
2,201392387,2170660915,39639,36895,2024-10-04 19:28:40,0,0,0,0,0,0
2,201392387,2170660915,22663,36895,2024-10-04 19:28:40,0,0,0,0,0,0
2,201392387,2170660915,53926,36895,2024-10-04 19:28:40,0,0,0,0,0,0
2,201392387,1145490690,59011,47873,2024-10-04 19:28:40,0,0,0,0,0,0
2,201392387,2170660915,0,0,2024-10-04 19:28:40,128,168,296,1,2,3
2,201392387,2170660915,39639,36895,2024-10-04 19:28:41,0,0,0,0,0,0
2,201392387,2170660915,22663,36895,2024-10-04 19:28:41,0,0,0,0,0,0
2,201392387,2170660915,53926,36895,2024-10-04 19:28:41,0,0,0,0,0,0
2,201392387,2170660915,0,0,2024-10-04 19:28:41,128,84,212,1,1,2
2,201392387,2170660915,39639,36895,2024-10-04 19:28:42,0,0,0,0,0,0
2,201392387,2170660915,22663,36895,2024-10-04 19:28:42,0,0,0,0,0,0
2,201392387,2170660915,53926,36895,2024-10-04 19:28:42,0,0,0,0,0,0
2,201392387,2170660915,0,0,2024-10-04 19:28:42,128,84,212,1,1,2
2,201392387,2170660915,39639,36895,2024-10-04 19:28:43,0,0,0,0,0,0
2,201392387,2170660915,22663,36895,2024-10-04 19:28:43,0,0,0,0,0,0
2,201392387,2170660915,53926,36895,2024-10-04 19:28:43,0,0,0,0,0,0
2,201392387,2170660915,0,0,2024-10-04 19:28:43,128,84,212,1,1,2
2,201392387,2170660915,39639,36895,2024-10-04 19:28:44,0,0,0,0,0,0
2,201392387,2170660915,22663,36895,2024-10-04 19:28:44,0,0,0,0,0,0
2,201392387,2170660915,53926,36895,2024-10-04 19:28:44,0,0,0,0,0,0
2,201392387,2170660915,0,0,2024-10-04 19:28:44,128,84,212,1,1,2
2,201392387,2170660915,39639,36895,2024-10-04 19:28:45,0,0,0,0,0,0
2,201392387,2170660915,22663,36895,2024-10-04 19:28:45,0,0,0,0,0,0
2,201392387,2170660915,53926,36895,2024-10-04 19:28:45,0,0,0,0,0,0
2,201392387,2170660915,0,0,2024-10-04 19:28:45,128,84,212,1,1,2
2,201392387,2170660915,39639,36895,2024-10-04 19:28:46,0,0,0,0,0,0
2,201392387,2170660915,22663,36895,2024-10-04 19:28:46,0,0,0,0,0,0
2,201392387,2170660915,53926,36895,2024-10-04 19:28:46,0,0,0,0,0,0
2,201392387,2170660915,0,0,2024-10-04 19:28:46,0,0,0,0,0,0
2,201392387,2170660915,39639,36895,2024-10-04 19:28:47,0,0,0,0,0,0
2,201392387,2170660915,22663,36895,2024-10-04 19:28:47,0,0,0,0,0,0
2,201392387,2170660915,32922,36895,2024-10-04 19:28:47,666,507,1173,6,6,12
2,201392387,2170660915,53926,36895,2024-10-04 19:28:47,0,0,0,0,0,0
2,201392387,2170660915,0,0,2024-10-04 19:28:47,0,0,0,0,0,0
2,201392387,2170660915,39639,36895,2024-10-04 19:28:48,0,0,0,0,0,0
2,201392387,2170660915,22663,36895,2024-10-04 19:28:48,0,0,0,0,0,0
2,201392387,2170660915,32922,36895,2024-10-04 19:28:48,0,0,0,0,0,0
2,201392387,2170660915,53926,36895,2024-10-04 19:28:48,0,0,0,0,0,0
2,201392387,2170660915,0,0,2024-10-04 19:28:48,128,84,212,1,1,2
2,201392387,2170660915,39639,36895,2024-10-04 19:28:49,0,0,0,0,0,0
2,201392387,2170660915,22663,36895,2024-10-04 19:28:49,0,0,0,0,0,0
2,201392387,2170660915,32922,36895,2024-10-04 19:28:49,0,0,0,0,0,0
2,201392387,2170660915,53926,36895,2024-10-04 19:28:49,0,0,0,0,0,0
2,201392387,2170660915,0,0,2024-10-04 19:28:49,128,84,212,1,1,2
2,201392387,2170660915,39639,36895,2024-10-04 19:28:50,0,0,0,0,0,0
2,201392387,2170660915,22663,36895,2024-10-04 19:28:50,0,0,0,0,0,0
2,201392387,2170660915,32922,36895,2024-10-04 19:28:50,0,0,0,0,0,0
2,201392387,2170660915,53926,36895,2024-10-04 19:28:50,0,0,0,0,0,0
2,201392387,2170660915,0,0,2024-10-04 19:28:50,128,84,212,1,1,2
2,201392387,2170660915,39639,36895,2024-10-04 19:28:51,0,0,0,0,0,0
2,201392387,2170660915,22663,36895,2024-10-04 19:28:51,0,0,0,0,0,0
2,201392387,2170660915,53926,36895,2024-10-04 19:28:51,0,0,0,0,0,0
2,201392387,2170660915,0,0,2024-10-04 19:28:51,0,0,0,0,0,0
2,201392387,2170660915,39639,36895,2024-10-04 19:28:52,0,0,0,0,0,0
2,201392387,2170660915,22663,36895,2024-10-04 19:28:52,0,0,0,0,0,0
2,201392387,2170660915,53926,36895,2024-10-04 19:28:52,0,0,0,0,0,0
2,201392387,2170660915,0,0,2024-10-04 19:28:52,0,0,0,0,0,0
2,201392387,2170660915,39639,36895,2024-10-04 19:28:53,0,0,0,0,0,0
2,201392387,2170660915,22663,36895,2024-10-04 19:28:53,0,0,0,0,0,0
2,201392387,2170660915,53926,36895,2024-10-04 19:28:53,0,0,0,0,0,0
2,201392387,2170660915,0,0,2024-10-04 19:28:53,128,84,212,1,1,2
2,201392387,2170660915,39639,36895,2024-10-04 19:28:54,0,0,0,0,0,0
2,201392387,2170660915,22663,36895,2024-10-04 19:28:54,0,0,0,0,0,0
2,201392387,2170660915,53926,36895,2024-10-04 19:28:54,0,0,0,0,0,0
2,201392387,2170660915,0,0,2024-10-04 19:28:54,128,84,212,1,1,2
2,201392387,2170660915,39639,36895,2024-10-04 19:28:55,0,0,0,0,0,0
2,201392387,2170660915,22663,36895,2024-10-04 19:28:55,0,0,0,0,0,0
2,201392387,2170660915,53926,36895,2024-10-04 19:28:55,0,0,0,0,0,0
2,201392387,2170660915,0,0,2024-10-04 19:28:55,128,84,212,1,1,2
2,201392387,1145490689,7394,47873,2024-10-04 19:28:55,3876,46097,49973,30,39,69
2,201392387,2170660915,39639,36895,2024-10-04 19:28:56,0,0,0,0,0,0
2,201392387,2170660915,22663,36895,2024-10-04 19:28:56,0,0,0,0,0,0
2,201392387,2170660915,53926,36895,2024-10-04 19:28:56,0,0,0,0,0,0
2,201392387,2170660915,0,0,2024-10-04 19:28:56,0,0,0,0,0,0
2,201392387,1145490689,7394,47873,2024-10-04 19:28:56,0,0,0,0,0,0
2,201392387,2170660915,39639,36895,2024-10-04 19:28:57,0,0,0,0,0,0
2,201392387,2170660915,22663,36895,2024-10-04 19:28:57,0,0,0,0,0,0
2,201392387,2170660915,53926,36895,2024-10-04 19:28:57,0,0,0,0,0,0
2,201392387,2170660915,0,0,2024-10-04 19:28:57,0,0,0,0,0,0
2,201392387,1145490689,7394,47873,2024-10-04 19:28:57,2664,53101,55765,26,37,63
2,201392387,2170660915,39639,36895,2024-10-04 19:28:58,0,0,0,0,0,0
2,201392387,2170660915,22663,36895,2024-10-04 19:28:58,0,0,0,0,0,0
2,201392387,2170660915,53926,36895,2024-10-04 19:28:58,0,0,0,0,0,0
2,201392387,2170660915,0,0,2024-10-04 19:28:58,0,0,0,0,0,0
2,201392387,1145490689,7394,47873,2024-10-04 19:28:58,0,0,0,0,0,0
2,201392387,2170660915,39639,36895,2024-10-04 19:28:59,0,0,0,0,0,0
2,201392387,2170660915,22663,36895,2024-10-04 19:28:59,0,0,0,0,0,0
2,201392387,2170660915,53926,36895,2024-10-04 19:28:59,0,0,0,0,0,0
2,201392387,2170660915,0,0,2024-10-04 19:28:59,0,0,0,0,0,0
2,201392387,1145490689,7394,47873,2024-10-04 19:28:59,0,0,0,0,0,0
2,201392387,2170660915,39639,36895,2024-10-04 19:29:00,0,0,0,0,0,0
2,201392387,2170660915,22663,36895,2024-10-04 19:29:00,0,0,0,0,0,0
2,201392387,2170660915,53926,36895,2024-10-04 19:29:00,0,0,0,0,0,0
2,201392387,2170660915,0,0,2024-10-04 19:29:00,0,0,0,0,0,0
2,201392387,1145490689,7394,47873,2024-10-04 19:29:00,0,0,0,0,0,0
2,201392387,2170660915,39639,36895,2024-10-04 19:29:01,0,0,0,0,0,0
2,201392387,2170660915,22663,36895,2024-10-04 19:29:01,0,0,0,0,0,0
2,201392387,2170660915,53926,36895,2024-10-04 19:29:01,0,0,0,0,0,0
2,201392387,2170660915,0,0,2024-10-04 19:29:01,0,0,0,0,0,0
2,201392387,1145490689,7394,47873,2024-10-04 19:29:01,0,0,0,0,0,0
2,201392387,2170660915,39639,36895,2024-10-04 19:29:02,0,0,0,0,0,0
2,201392387,2170660915,22663,36895,2024-10-04 19:29:02,0,0,0,0,0,0
2,201392387,2170660915,53926,36895,2024-10-04 19:29:02,0,0,0,0,0,0
2,201392387,2170660915,0,0,2024-10-04 19:29:02,0,0,0,0,0,0
2,201392387,1145490689,7394,47873,2024-10-04 19:29:02,0,0,0,0,0,0
2,201392387,2170660915,39639,36895,2024-10-04 19:29:03,0,0,0,0,0,0
2,201392387,2170660915,22663,36895,2024-10-04 19:29:03,0,0,0,0,0,0
2,201392387,2170660915,53926,36895,2024-10-04 19:29:03,0,0,0,0,0,0
2,201392387,2170660915,0,0,2024-10-04 19:29:03,0,0,0,0,0,0
2,201392387,1145490689,7394,47873,2024-10-04 19:29:03,0,0,0,0,0,0
2,201392387,2170660915,39639,36895,2024-10-04 19:29:04,0,0,0,0,0,0
2,201392387,2170660915,22663,36895,2024-10-04 19:29:04,0,0,0,0,0,0
2,201392387,2170660915,53926,36895,2024-10-04 19:29:04,0,0,0,0,0,0
2,201392387,2170660915,0,0,2024-10-04 19:29:04,0,0,0,0,0,0
2,201392387,1145490689,7394,47873,2024-10-04 19:29:04,0,0,0,0,0,0
2,201392387,2170660915,39639,36895,2024-10-04 19:29:05,0,0,0,0,0,0
2,201392387,2170660915,22663,36895,2024-10-04 19:29:05,0,0,0,0,0,0
2,201392387,2170660915,53926,36895,2024-10-04 19:29:05,0,0,0,0,0,0
2,201392387,2170660915,0,0,2024-10-04 19:29:05,0,0,0,0,0,0
2,201392387,1145490689,7394,47873,2024-10-04 19:29:05,0,0,0,0,0,0
2,201392387,2170660915,39639,36895,2024-10-04 19:29:06,0,0,0,0,0,0
2,201392387,2170660915,22663,36895,2024-10-04 19:29:06,0,0,0,0,0,0
2,201392387,2170660915,53926,36895,2024-10-04 19:29:06,0,0,0,0,0,0
2,201392387,2170660915,0,0,2024-10-04 19:29:06,0,0,0,0,0,0
2,201392387,1145490689,7394,47873,2024-10-04 19:29:06,0,0,0,0,0,0
2,201392387,2170660915,39639,36895,2024-10-04 19:29:07,0,0,0,0,0,0
2,201392387,2170660915,22663,36895,2024-10-04 19:29:07,0,0,0,0,0,0
2,201392387,2170660915,53926,36895,2024-10-04 19:29:07,0,0,0,0,0,0
2,201392387,2170660915,0,0,2024-10-04 19:29:07,128,84,212,1,1,2
2,201392387,1145490689,7394,47873,2024-10-04 19:29:07,0,0,0,0,0,0
2,201392387,2170660915,39639,36895,2024-10-04 19:29:08,0,0,0,0,0,0
2,201392387,2170660915,22663,36895,2024-10-04 19:29:08,0,0,0,0,0,0
2,201392387,2170660915,53926,36895,2024-10-04 19:29:08,0,0,0,0,0,0
2,201392387,2170660915,0,0,2024-10-04 19:29:08,128,84,212,1,1,2
2,201392387,1145490689,7394,47873,2024-10-04 19:29:08,0,0,0,0,0,0
2,201392387,2170660915,39639,36895,2024-10-04 19:29:09,0,0,0,0,0,0
2,201392387,2170660915,22663,36895,2024-10-04 19:29:09,0,0,0,0,0,0
2,201392387,2170660915,53926,36895,2024-10-04 19:29:09,0,0,0,0,0,0
2,201392387,2170660915,0,0,2024-10-04 19:29:09,128,84,212,1,1,2
2,201392387,1145490689,7394,47873,2024-10-04 19:29:09,0,0,0,0,0,0
2,201392387,2170660915,39639,36895,2024-10-04 19:29:10,0,0,0,0,0,0
2,201392387,2170660915,22663,36895,2024-10-04 19:29:10,0,0,0,0,0,0
2,201392387,2170660915,53926,36895,2024-10-04 19:29:10,0,0,0,0,0,0
2,201392387,2170660915,0,0,2024-10-04 19:29:10,256,84,340,2,1,3
2,201392387,1145490689,7394,47873,2024-10-04 19:29:10,0,0,0,0,0,0
2,201392387,2170660915,39639,36895,2024-10-04 19:29:11,0,0,0,0,0,0
2,201392387,2170660915,22663,36895,2024-10-04 19:29:11,0,0,0,0,0,0
2,201392387,2170660915,53926,36895,2024-10-04 19:29:11,0,0,0,0,0,0
2,201392387,2170660915,0,0,2024-10-04 19:29:11,128,84,212,1,1,2
2,201392387,1145490689,7394,47873,2024-10-04 19:29:11,0,0,0,0,0,0
2,201392387,2170660915,39639,36895,2024-10-04 19:29:12,0,0,0,0,0,0
2,201392387,2170660915,22663,36895,2024-10-04 19:29:12,0,0,0,0,0,0
2,201392387,2170660915,53926,36895,2024-10-04 19:29:12,0,0,0,0,0,0
2,201392387,2170660915,0,0,2024-10-04 19:29:12,128,84,212,1,1,2
2,201392387,2170660915,39639,36895,2024-10-04 19:29:13,0,0,0,0,0,0
2,201392387,2170660915,22663,36895,2024-10-04 19:29:13,0,0,0,0,0,0
2,201392387,2170660915,53926,36895,2024-10-04 19:29:13,0,0,0,0,0,0
2,201392387,2170660915,0,0,2024-10-04 19:29:13,128,84,212,1,1,2
2,201392387,2170660915,39639,36895,2024-10-04 19:29:14,0,0,0,0,0,0
2,201392387,2170660915,22663,36895,2024-10-04 19:29:14,0,0,0,0,0,0
2,201392387,2170660915,53926,36895,2024-10-04 19:29:14,0,0,0,0,0,0
2,201392387,2170660915,0,0,2024-10-04 19:29:14,128,84,212,1,1,2
2,201392387,2170660915,39639,36895,2024-10-04 19:29:15,0,0,0,0,0,0
2,201392387,2170660915,22663,36895,2024-10-04 19:29:15,0,0,0,0,0,0
2,201392387,2170660915,53926,36895,2024-10-04 19:29:15,0,0,0,0,0,0
2,201392387,2170660915,0,0,2024-10-04 19:29:15,128,84,212,1,1,2
2,201392387,2170660915,39639,36895,2024-10-04 19:29:16,0,0,0,0,0,0
2,201392387,2170660915,22663,36895,2024-10-04 19:29:16,0,0,0,0,0,0
2,201392387,2170660915,53926,36895,2024-10-04 19:29:16,0,0,0,0,0,0
2,201392387,2170660915,0,0,2024-10-04 19:29:16,0,84,84,0,1,1
2,201392387,2170660915,39639,36895,2024-10-04 19:29:17,0,0,0,0,0,0
2,201392387,2170660915,22663,36895,2024-10-04 19:29:17,0,0,0,0,0,0
2,201392387,2170660915,53926,36895,2024-10-04 19:29:17,0,0,0,0,0,0
2,201392387,2170660915,0,0,2024-10-04 19:29:17,0,0,0,0,0,0
2,201392387,2170660915,39639,36895,2024-10-04 19:29:18,0,0,0,0,0,0
2,201392387,2170660915,22663,36895,2024-10-04 19:29:18,0,0,0,0,0,0
2,201392387,2170660915,3244,36895,2024-10-04 19:29:18,666,507,1173,6,6,12
2,201392387,2170660915,0,0,2024-10-04 19:29:18,128,0,128,1,0,1
2,201392387,2170660915,39639,36895,2024-10-04 19:29:19,0,0,0,0,0,0
2,201392387,2170660915,22663,36895,2024-10-04 19:29:19,0,0,0,0,0,0
2,201392387,2170660915,3244,36895,2024-10-04 19:29:19,0,0,0,0,0,0
2,201392387,2170660915,0,0,2024-10-04 19:29:19,128,84,212,1,1,2
2,201392387,2170660915,39639,36895,2024-10-04 19:29:20,0,0,0,0,0,0
2,201392387,2170660915,22663,36895,2024-10-04 19:29:20,0,0,0,0,0,0
2,201392387,2170660915,3244,36895,2024-10-04 19:29:20,0,0,0,0,0,0
2,201392387,2170660915,0,0,2024-10-04 19:29:20,128,84,212,1,1,2
2,201392387,2170660915,39639,36895,2024-10-04 19:29:21,0,0,0,0,0,0
2,201392387,2170660915,22663,36895,2024-10-04 19:29:21,0,0,0,0,0,0
2,201392387,2170660915,3244,36895,2024-10-04 19:29:21,0,0,0,0,0,0
2,201392387,2170660915,0,0,2024-10-04 19:29:21,0,84,84,0,1,1
2,201392387,2170660915,39639,36895,2024-10-04 19:29:22,0,0,0,0,0,0
2,201392387,2170660915,22663,36895,2024-10-04 19:29:22,0,0,0,0,0,0
2,201392387,2170660915,3244,36895,2024-10-04 19:29:22,0,0,0,0,0,0
2,201392387,2170660915,0,0,2024-10-04 19:29:22,0,0,0,0,0,0
2,201392387,2170660915,39639,36895,2024-10-04 19:29:23,0,0,0,0,0,0
2,201392387,2170660915,22663,36895,2024-10-04 19:29:23,0,0,0,0,0,0
2,201392387,2170660915,3244,36895,2024-10-04 19:29:23,0,0,0,0,0,0
2,201392387,2170660915,0,0,2024-10-04 19:29:23,128,0,128,1,0,1
2,201392387,2170660915,39639,36895,2024-10-04 19:29:24,0,0,0,0,0,0
2,201392387,2170660915,22663,36895,2024-10-04 19:29:24,0,0,0,0,0,0
2,201392387,2170660915,3244,36895,2024-10-04 19:29:24,0,0,0,0,0,0
2,201392387,2170660915,0,0,2024-10-04 19:29:24,128,84,212,1,1,2
2,201392387,2170660915,39639,36895,2024-10-04 19:29:25,0,0,0,0,0,0
2,201392387,2170660915,22663,36895,2024-10-04 19:29:25,0,0,0,0,0,0
2,201392387,2170660915,3244,36895,2024-10-04 19:29:25,0,0,0,0,0,0
2,201392387,2170660915,0,0,2024-10-04 19:29:25,128,84,212,1,1,2
2,201392387,2170660915,39639,36895,2024-10-04 19:29:26,0,0,0,0,0,0
2,201392387,2170660915,22663,36895,2024-10-04 19:29:26,0,0,0,0,0,0
2,201392387,2170660915,3244,36895,2024-10-04 19:29:26,0,0,0,0,0,0
2,201392387,1145490690,3283,47873,2024-10-04 19:29:26,3452,43943,47395,26,39,65
2,201392387,2170660915,0,0,2024-10-04 19:29:26,0,84,84,0,1,1
2,201392387,2170660915,39639,36895,2024-10-04 19:29:27,0,0,0,0,0,0
2,201392387,2170660915,22663,36895,2024-10-04 19:29:27,0,0,0,0,0,0
2,201392387,2170660915,3244,36895,2024-10-04 19:29:27,0,0,0,0,0,0
2,201392387,1145490690,3283,47873,2024-10-04 19:29:27,0,0,0,0,0,0
2,201392387,2170660915,0,0,2024-10-04 19:29:27,0,0,0,0,0,0
2,201392387,2170660915,39639,36895,2024-10-04 19:29:28,0,0,0,0,0,0
2,201392387,2170660915,22663,36895,2024-10-04 19:29:28,0,0,0,0,0,0
2,201392387,2170660915,3244,36895,2024-10-04 19:29:28,0,0,0,0,0,0
2,201392387,1145490690,3283,47873,2024-10-04 19:29:28,0,0,0,0,0,0
2,201392387,2170660915,0,0,2024-10-04 19:29:28,0,0,0,0,0,0
2,201392387,2170660915,39639,36895,2024-10-04 19:29:29,0,0,0,0,0,0
2,201392387,2170660915,22663,36895,2024-10-04 19:29:29,0,0,0,0,0,0
2,201392387,2170660915,3244,36895,2024-10-04 19:29:29,0,0,0,0,0,0
2,201392387,1145490690,3283,47873,2024-10-04 19:29:29,0,0,0,0,0,0
2,201392387,2170660915,0,0,2024-10-04 19:29:29,0,0,0,0,0,0
2,201392387,2170660915,39639,36895,2024-10-04 19:29:30,0,0,0,0,0,0
2,201392387,2170660915,22663,36895,2024-10-04 19:29:30,0,0,0,0,0,0
2,201392387,2170660915,3244,36895,2024-10-04 19:29:30,0,0,0,0,0,0
2,201392387,1145490690,3283,47873,2024-10-04 19:29:30,0,0,0,0,0,0
2,201392387,2170660915,0,0,2024-10-04 19:29:30,0,0,0,0,0,0
2,201392387,2170660915,39639,36895,2024-10-04 19:29:31,0,0,0,0,0,0
2,201392387,2170660915,22663,36895,2024-10-04 19:29:31,0,0,0,0,0,0
2,201392387,2170660915,3244,36895,2024-10-04 19:29:31,0,0,0,0,0,0
2,201392387,1145490690,3283,47873,2024-10-04 19:29:31,0,0,0,0,0,0
2,201392387,2170660915,0,0,2024-10-04 19:29:31,0,0,0,0,0,0
2,201392387,2170660915,39639,36895,2024-10-04 19:29:32,0,0,0,0,0,0
2,201392387,2170660915,22663,36895,2024-10-04 19:29:32,0,0,0,0,0,0
2,201392387,2170660915,3244,36895,2024-10-04 19:29:32,0,0,0,0,0,0
2,201392387,1145490690,3283,47873,2024-10-04 19:29:32,2748,53820,56568,27,40,67
2,201392387,2170660915,0,0,2024-10-04 19:29:32,0,0,0,0,0,0
2,201392387,2170660915,39639,36895,2024-10-04 19:29:33,0,0,0,0,0,0
2,201392387,2170660915,22663,36895,2024-10-04 19:29:33,0,0,0,0,0,0
2,201392387,2170660915,3244,36895,2024-10-04 19:29:33,0,0,0,0,0,0
2,201392387,1145490690,3283,47873,2024-10-04 19:29:33,0,0,0,0,0,0
2,201392387,2170660915,0,0,2024-10-04 19:29:33,0,0,0,0,0,0
2,201392387,2170660915,39639,36895,2024-10-04 19:29:34,0,0,0,0,0,0
2,201392387,2170660915,22663,36895,2024-10-04 19:29:34,0,0,0,0,0,0
2,201392387,2170660915,3244,36895,2024-10-04 19:29:34,0,0,0,0,0,0
2,201392387,1145490690,3283,47873,2024-10-04 19:29:34,0,0,0,0,0,0
2,201392387,2170660915,0,0,2024-10-04 19:29:34,0,0,0,0,0,0
2,201392387,2170660915,39639,36895,2024-10-04 19:29:35,0,0,0,0,0,0
2,201392387,2170660915,22663,36895,2024-10-04 19:29:35,0,0,0,0,0,0
2,201392387,2170660915,3244,36895,2024-10-04 19:29:35,0,0,0,0,0,0
2,201392387,1145490690,3283,47873,2024-10-04 19:29:35,0,0,0,0,0,0
2,201392387,2170660915,0,0,2024-10-04 19:29:35,0,0,0,0,0,0
2,201392387,2170660915,39639,36895,2024-10-04 19:29:36,0,0,0,0,0,0
2,201392387,2170660915,22663,36895,2024-10-04 19:29:36,0,0,0,0,0,0
2,201392387,2170660915,3244,36895,2024-10-04 19:29:36,0,0,0,0,0,0
2,201392387,1145490690,3283,47873,2024-10-04 19:29:36,0,0,0,0,0,0
2,201392387,2170660915,0,0,2024-10-04 19:29:36,0,0,0,0,0,0
2,201392387,2170660915,39639,36895,2024-10-04 19:29:37,0,0,0,0,0,0
2,201392387,2170660915,22663,36895,2024-10-04 19:29:37,0,0,0,0,0,0
2,201392387,2170660915,3244,36895,2024-10-04 19:29:37,0,0,0,0,0,0
2,201392387,1145490690,3283,47873,2024-10-04 19:29:37,0,0,0,0,0,0
2,201392387,2170660915,0,0,2024-10-04 19:29:37,128,84,212,1,1,2
2,201392387,2170660915,39639,36895,2024-10-04 19:29:38,0,0,0,0,0,0
2,201392387,2170660915,22663,36895,2024-10-04 19:29:38,0,0,0,0,0,0
2,201392387,2170660915,3244,36895,2024-10-04 19:29:38,0,0,0,0,0,0
2,201392387,1145490690,3283,47873,2024-10-04 19:29:38,0,0,0,0,0,0
2,201392387,2170660915,0,0,2024-10-04 19:29:38,128,84,212,1,1,2
2,201392387,2170660915,39639,36895,2024-10-04 19:29:39,0,0,0,0,0,0
2,201392387,2170660915,22663,36895,2024-10-04 19:29:39,0,0,0,0,0,0
2,201392387,2170660915,3244,36895,2024-10-04 19:29:39,0,0,0,0,0,0
2,201392387,1145490690,3283,47873,2024-10-04 19:29:39,0,0,0,0,0,0
2,201392387,2170660915,0,0,2024-10-04 19:29:39,128,84,212,1,1,2
2,201392387,2170660915,39639,36895,2024-10-04 19:29:40,0,0,0,0,0,0
2,201392387,2170660915,22663,36895,2024-10-04 19:29:40,0,0,0,0,0,0
2,201392387,2170660915,3244,36895,2024-10-04 19:29:40,0,0,0,0,0,0
2,201392387,1145490690,3283,47873,2024-10-04 19:29:40,0,0,0,0,0,0
2,201392387,2170660915,0,0,2024-10-04 19:29:40,128,84,212,1,1,2
2,201392387,2170660915,39639,36895,2024-10-04 19:29:41,0,0,0,0,0,0
2,201392387,2170660915,22663,36895,2024-10-04 19:29:41,0,0,0,0,0,0
2,201392387,2170660915,3244,36895,2024-10-04 19:29:41,0,0,0,0,0,0
2,201392387,1145490690,3283,47873,2024-10-04 19:29:41,0,0,0,0,0,0
2,201392387,2170660915,0,0,2024-10-04 19:29:41,128,84,212,1,1,2
2,201392387,2170660915,39639,36895,2024-10-04 19:29:42,0,0,0,0,0,0
2,201392387,2170660915,22663,36895,2024-10-04 19:29:42,0,0,0,0,0,0
2,201392387,2170660915,3244,36895,2024-10-04 19:29:42,0,0,0,0,0,0
2,201392387,1145490690,3283,47873,2024-10-04 19:29:42,0,0,0,0,0,0
2,201392387,2170660915,0,0,2024-10-04 19:29:42,128,84,212,1,1,2
2,201392387,2170660915,39639,36895,2024-10-04 19:29:43,0,0,0,0,0,0
2,201392387,2170660915,22663,36895,2024-10-04 19:29:43,0,0,0,0,0,0
2,201392387,2170660915,3244,36895,2024-10-04 19:29:43,0,0,0,0,0,0
2,201392387,1145490690,3283,47873,2024-10-04 19:29:43,0,0,0,0,0,0
2,201392387,2170660915,0,0,2024-10-04 19:29:43,128,84,212,1,1,2
2,201392387,2170660915,39639,36895,2024-10-04 19:29:44,0,0,0,0,0,0
2,201392387,2170660915,22663,36895,2024-10-04 19:29:44,0,0,0,0,0,0
2,201392387,2170660915,3244,36895,2024-10-04 19:29:44,0,0,0,0,0,0
2,201392387,1145490690,3283,47873,2024-10-04 19:29:44,0,0,0,0,0,0
2,201392387,2170660915,0,0,2024-10-04 19:29:44,128,84,212,1,1,2
2,201392387,2170660915,39639,36895,2024-10-04 19:29:45,0,0,0,0,0,0
2,201392387,2170660915,22663,36895,2024-10-04 19:29:45,0,0,0,0,0,0
2,201392387,2170660915,3244,36895,2024-10-04 19:29:45,0,0,0,0,0,0
2,201392387,1145490690,3283,47873,2024-10-04 19:29:45,0,0,0,0,0,0
2,201392387,2170660915,0,0,2024-10-04 19:29:45,128,84,212,1,1,2
2,201392387,2170660915,39639,36895,2024-10-04 19:29:46,0,0,0,0,0,0
2,201392387,2170660915,22663,36895,2024-10-04 19:29:46,0,0,0,0,0,0
2,201392387,2170660915,3244,36895,2024-10-04 19:29:46,0,0,0,0,0,0
2,201392387,1145490690,3283,47873,2024-10-04 19:29:46,0,0,0,0,0,0
2,201392387,2170660915,0,0,2024-10-04 19:29:46,128,84,212,1,1,2
2,201392387,2170660915,39639,36895,2024-10-04 19:29:47,0,0,0,0,0,0
2,201392387,2170660915,22663,36895,2024-10-04 19:29:47,0,0,0,0,0,0
2,201392387,2170660915,3244,36895,2024-10-04 19:29:47,0,0,0,0,0,0
2,201392387,1145490690,3283,47873,2024-10-04 19:29:47,0,0,0,0,0,0
2,201392387,2170660915,0,0,2024-10-04 19:29:47,0,0,0,0,0,0
2,201392387,2170660915,39639,36895,2024-10-04 19:29:48,0,0,0,0,0,0
2,201392387,2170660915,22663,36895,2024-10-04 19:29:48,0,0,0,0,0,0
2,201392387,2170660915,0,0,2024-10-04 19:29:48,128,0,128,1,0,1
2,201392387,2170660915,2759,36895,2024-10-04 19:29:48,666,507,1173,6,6,12
2,201392387,2170660915,39639,36895,2024-10-04 19:29:49,0,0,0,0,0,0
2,201392387,2170660915,22663,36895,2024-10-04 19:29:49,0,0,0,0,0,0
2,201392387,2170660915,0,0,2024-10-04 19:29:49,0,84,84,0,1,1
2,201392387,2170660915,2759,36895,2024-10-04 19:29:49,0,0,0,0,0,0
2,201392387,2170660915,39639,36895,2024-10-04 19:29:50,0,0,0,0,0,0
2,201392387,2170660915,22663,36895,2024-10-04 19:29:50,0,0,0,0,0,0
2,201392387,2170660915,0,0,2024-10-04 19:29:50,128,84,212,1,1,2
2,201392387,2170660915,2759,36895,2024-10-04 19:29:50,0,0,0,0,0,0
2,201392387,2170660915,39639,36895,2024-10-04 19:29:51,0,0,0,0,0,0
2,201392387,2170660915,22663,36895,2024-10-04 19:29:51,0,0,0,0,0,0
2,201392387,2170660915,0,0,2024-10-04 19:29:51,128,84,212,1,1,2
2,201392387,2170660915,2759,36895,2024-10-04 19:29:51,0,0,0,0,0,0
2,201392387,2170660915,39639,36895,2024-10-04 19:29:52,0,0,0,0,0,0
2,201392387,2170660915,22663,36895,2024-10-04 19:29:52,0,0,0,0,0,0
2,201392387,2170660915,0,0,2024-10-04 19:29:52,0,0,0,0,0,0
2,201392387,2170660915,2759,36895,2024-10-04 19:29:52,0,0,0,0,0,0
2,201392387,2170660915,39639,36895,2024-10-04 19:29:53,0,0,0,0,0,0
2,201392387,2170660915,22663,36895,2024-10-04 19:29:53,0,0,0,0,0,0
2,201392387,2170660915,0,0,2024-10-04 19:29:53,0,0,0,0,0,0
2,201392387,2170660915,2759,36895,2024-10-04 19:29:53,0,0,0,0,0,0
2,201392387,2170660915,39639,36895,2024-10-04 19:29:54,0,0,0,0,0,0
2,201392387,2170660915,22663,36895,2024-10-04 19:29:54,0,0,0,0,0,0
2,201392387,2170660915,0,0,2024-10-04 19:29:54,128,84,212,1,1,2
2,201392387,2170660915,2759,36895,2024-10-04 19:29:54,0,0,0,0,0,0
2,201392387,2170660915,39639,36895,2024-10-04 19:29:55,0,0,0,0,0,0
2,201392387,2170660915,22663,36895,2024-10-04 19:29:55,0,0,0,0,0,0
2,201392387,2170660915,0,0,2024-10-04 19:29:55,128,84,212,1,1,2
2,201392387,2170660915,2759,36895,2024-10-04 19:29:55,0,0,0,0,0,0
2,201392387,2170660915,39639,36895,2024-10-04 19:29:56,0,0,0,0,0,0
2,201392387,2170660915,22663,36895,2024-10-04 19:29:56,0,0,0,0,0,0
2,201392387,1145490692,14544,47873,2024-10-04 19:29:56,1853,3447,5300,11,6,17
2,201392387,2170660915,0,0,2024-10-04 19:29:56,128,84,212,1,1,2
2,201392387,2170660915,2759,36895,2024-10-04 19:29:56,0,0,0,0,0,0
2,201392387,2170660915,39639,36895,2024-10-04 19:29:57,0,0,0,0,0,0
2,201392387,2170660915,22663,36895,2024-10-04 19:29:57,0,0,0,0,0,0
2,201392387,1145490692,14544,47873,2024-10-04 19:29:57,3951,96878,100829,37,66,103
2,201392387,2170660915,0,0,2024-10-04 19:29:57,0,0,0,0,0,0
2,201392387,2170660915,2759,36895,2024-10-04 19:29:57,0,0,0,0,0,0
2,201392387,2170660915,39639,36895,2024-10-04 19:29:58,0,0,0,0,0,0
2,201392387,2170660915,22663,36895,2024-10-04 19:29:58,0,0,0,0,0,0
2,201392387,1145490692,14544,47873,2024-10-04 19:29:58,0,0,0,0,0,0
2,201392387,2170660915,0,0,2024-10-04 19:29:58,0,0,0,0,0,0
2,201392387,2170660915,2759,36895,2024-10-04 19:29:58,0,0,0,0,0,0
2,201392387,2170660915,39639,36895,2024-10-04 19:29:59,0,0,0,0,0,0
2,201392387,2170660915,22663,36895,2024-10-04 19:29:59,0,0,0,0,0,0
2,201392387,1145490692,14544,47873,2024-10-04 19:29:59,0,0,0,0,0,0
2,201392387,2170660915,0,0,2024-10-04 19:29:59,0,0,0,0,0,0
2,201392387,2170660915,2759,36895,2024-10-04 19:29:59,0,0,0,0,0,0
2,201392387,2170660915,39639,36895,2024-10-04 19:30:00,0,0,0,0,0,0
2,201392387,2170660915,22663,36895,2024-10-04 19:30:00,0,0,0,0,0,0
2,201392387,1145490692,14544,47873,2024-10-04 19:30:00,0,0,0,0,0,0
2,201392387,2170660915,0,0,2024-10-04 19:30:00,0,0,0,0,0,0
2,201392387,2170660915,2759,36895,2024-10-04 19:30:00,0,0,0,0,0,0
2,201392387,2170660915,39639,36895,2024-10-04 19:30:01,0,0,0,0,0,0
2,201392387,2170660915,22663,36895,2024-10-04 19:30:01,0,0,0,0,0,0
2,201392387,1145490692,14544,47873,2024-10-04 19:30:01,0,0,0,0,0,0
2,201392387,2170660915,0,0,2024-10-04 19:30:01,0,0,0,0,0,0
2,201392387,2170660915,2759,36895,2024-10-04 19:30:01,0,0,0,0,0,0
2,201392387,2170660915,39639,36895,2024-10-04 19:30:02,0,0,0,0,0,0
2,201392387,2170660915,22663,36895,2024-10-04 19:30:02,0,0,0,0,0,0
2,201392387,1145490692,14544,47873,2024-10-04 19:30:02,0,0,0,0,0,0
2,201392387,2170660915,0,0,2024-10-04 19:30:02,0,0,0,0,0,0
2,201392387,2170660915,2759,36895,2024-10-04 19:30:02,0,0,0,0,0,0
2,201392387,2170660915,39639,36895,2024-10-04 19:30:03,0,0,0,0,0,0
2,201392387,2170660915,22663,36895,2024-10-04 19:30:03,0,0,0,0,0,0
2,201392387,1145490692,14544,47873,2024-10-04 19:30:03,924,13163,14087,9,12,21
2,201392387,2170660915,0,0,2024-10-04 19:30:03,0,0,0,0,0,0
2,201392387,2170660915,2759,36895,2024-10-04 19:30:03,0,0,0,0,0,0
2,201392387,2170660915,39639,36895,2024-10-04 19:30:04,0,0,0,0,0,0
2,201392387,2170660915,22663,36895,2024-10-04 19:30:04,0,0,0,0,0,0
2,201392387,1145490692,14544,47873,2024-10-04 19:30:04,0,0,0,0,0,0
2,201392387,2170660915,0,0,2024-10-04 19:30:04,0,0,0,0,0,0
2,201392387,2170660915,2759,36895,2024-10-04 19:30:04,0,0,0,0,0,0
2,201392387,2170660915,39639,36895,2024-10-04 19:30:05,0,0,0,0,0,0
2,201392387,2170660915,22663,36895,2024-10-04 19:30:05,0,0,0,0,0,0
2,201392387,1145490692,14544,47873,2024-10-04 19:30:05,0,0,0,0,0,0
2,201392387,2170660915,0,0,2024-10-04 19:30:05,0,0,0,0,0,0
2,201392387,2170660915,2759,36895,2024-10-04 19:30:05,0,0,0,0,0,0
2,201392387,2170660915,39639,36895,2024-10-04 19:30:06,0,0,0,0,0,0
2,201392387,2170660915,22663,36895,2024-10-04 19:30:06,0,0,0,0,0,0
2,201392387,1145490692,14544,47873,2024-10-04 19:30:06,0,0,0,0,0,0
2,201392387,2170660915,0,0,2024-10-04 19:30:06,0,0,0,0,0,0
2,201392387,2170660915,2759,36895,2024-10-04 19:30:06,0,0,0,0,0,0
2,201392387,2170660915,39639,36895,2024-10-04 19:30:07,0,0,0,0,0,0
2,201392387,2170660915,22663,36895,2024-10-04 19:30:07,0,0,0,0,0,0
2,201392387,1145490692,14544,47873,2024-10-04 19:30:07,0,0,0,0,0,0
2,201392387,2170660915,0,0,2024-10-04 19:30:07,128,0,128,1,0,1
2,201392387,2170660915,2759,36895,2024-10-04 19:30:07,0,0,0,0,0,0
2,201392387,2170660915,39639,36895,2024-10-04 19:30:08,0,0,0,0,0,0
2,201392387,2170660915,22663,36895,2024-10-04 19:30:08,0,0,0,0,0,0
2,201392387,1145490692,14544,47873,2024-10-04 19:30:08,0,0,0,0,0,0
2,201392387,2170660915,0,0,2024-10-04 19:30:08,128,84,212,1,1,2
2,201392387,2170660915,2759,36895,2024-10-04 19:30:08,0,0,0,0,0,0
2,201392387,2170660915,39639,36895,2024-10-04 19:30:09,0,0,0,0,0,0
2,201392387,2170660915,22663,36895,2024-10-04 19:30:09,0,0,0,0,0,0
2,201392387,1145490692,14544,47873,2024-10-04 19:30:09,0,0,0,0,0,0
2,201392387,2170660915,0,0,2024-10-04 19:30:09,128,84,212,1,1,2
2,201392387,2170660915,2759,36895,2024-10-04 19:30:09,0,0,0,0,0,0
2,201392387,2170660915,39639,36895,2024-10-04 19:30:10,0,0,0,0,0,0
2,201392387,2170660915,22663,36895,2024-10-04 19:30:10,0,0,0,0,0,0
2,201392387,1145490692,14544,47873,2024-10-04 19:30:10,0,0,0,0,0,0
2,201392387,2170660915,0,0,2024-10-04 19:30:10,128,84,212,1,1,2
2,201392387,2170660915,2759,36895,2024-10-04 19:30:10,0,0,0,0,0,0
2,201392387,2170660915,39639,36895,2024-10-04 19:30:11,0,0,0,0,0,0
2,201392387,2170660915,22663,36895,2024-10-04 19:30:11,0,0,0,0,0,0
2,201392387,1145490692,14544,47873,2024-10-04 19:30:11,0,0,0,0,0,0
2,201392387,2170660915,0,0,2024-10-04 19:30:11,128,84,212,1,1,2
2,201392387,2170660915,2759,36895,2024-10-04 19:30:11,0,0,0,0,0,0
2,201392387,2170660915,39639,36895,2024-10-04 19:30:12,0,0,0,0,0,0
2,201392387,2170660915,22663,36895,2024-10-04 19:30:12,0,0,0,0,0,0
2,201392387,1145490692,14544,47873,2024-10-04 19:30:12,0,0,0,0,0,0
2,201392387,2170660915,0,0,2024-10-04 19:30:12,0,84,84,0,1,1
2,201392387,2170660915,2759,36895,2024-10-04 19:30:12,0,0,0,0,0,0
2,201392387,2170660915,39639,36895,2024-10-04 19:30:13,0,0,0,0,0,0
2,201392387,2170660915,22663,36895,2024-10-04 19:30:13,0,0,0,0,0,0
2,201392387,1145490692,14544,47873,2024-10-04 19:30:13,0,0,0,0,0,0
2,201392387,2170660915,0,0,2024-10-04 19:30:13,128,84,212,1,1,2
2,201392387,2170660915,2759,36895,2024-10-04 19:30:13,0,0,0,0,0,0
2,201392387,2170660915,39639,36895,2024-10-04 19:30:14,0,0,0,0,0,0
2,201392387,2170660915,22663,36895,2024-10-04 19:30:14,0,0,0,0,0,0
2,201392387,2170660915,0,0,2024-10-04 19:30:14,128,84,212,1,1,2
2,201392387,2170660915,2759,36895,2024-10-04 19:30:14,0,0,0,0,0,0
2,201392387,2170660915,39639,36895,2024-10-04 19:30:15,0,0,0,0,0,0
2,201392387,2170660915,22663,36895,2024-10-04 19:30:15,0,0,0,0,0,0
2,201392387,2170660915,0,0,2024-10-04 19:30:15,128,84,212,1,1,2
2,201392387,2170660915,2759,36895,2024-10-04 19:30:15,0,0,0,0,0,0
2,201392387,2170660915,39639,36895,2024-10-04 19:30:16,0,0,0,0,0,0
2,201392387,2170660915,22663,36895,2024-10-04 19:30:16,0,0,0,0,0,0
2,201392387,2170660915,0,0,2024-10-04 19:30:16,128,84,212,1,1,2
2,201392387,2170660915,2759,36895,2024-10-04 19:30:16,0,0,0,0,0,0
2,201392387,2170660915,39639,36895,2024-10-04 19:30:17,0,0,0,0,0,0
2,201392387,2170660915,22663,36895,2024-10-04 19:30:17,0,0,0,0,0,0
2,201392387,2170660915,0,0,2024-10-04 19:30:17,128,84,212,1,1,2
2,201392387,2170660915,2759,36895,2024-10-04 19:30:17,0,0,0,0,0,0
2,201392387,2170660915,39639,36895,2024-10-04 19:30:18,0,0,0,0,0,0
2,201392387,2170660915,22663,36895,2024-10-04 19:30:18,0,0,0,0,0,0
2,201392387,2170660915,0,0,2024-10-04 19:30:18,0,0,0,0,0,0
2,201392387,2170660915,2759,36895,2024-10-04 19:30:18,0,0,0,0,0,0
2,201392387,2170660915,39639,36895,2024-10-04 19:30:19,0,0,0,0,0,0
2,201392387,2170660915,48844,36895,2024-10-04 19:30:19,666,507,1173,6,6,12
2,201392387,2170660915,22663,36895,2024-10-04 19:30:19,0,0,0,0,0,0
2,201392387,2170660915,0,0,2024-10-04 19:30:19,0,0,0,0,0,0
2,201392387,2170660915,2759,36895,2024-10-04 19:30:19,0,0,0,0,0,0
2,201392387,2170660915,39639,36895,2024-10-04 19:30:20,0,0,0,0,0,0
2,201392387,2170660915,48844,36895,2024-10-04 19:30:20,0,0,0,0,0,0
2,201392387,2170660915,22663,36895,2024-10-04 19:30:20,0,0,0,0,0,0
2,201392387,2170660915,0,0,2024-10-04 19:30:20,256,84,340,2,1,3
2,201392387,2170660915,2759,36895,2024-10-04 19:30:20,0,0,0,0,0,0
2,201392387,2170660915,39639,36895,2024-10-04 19:30:21,0,0,0,0,0,0
2,201392387,2170660915,48844,36895,2024-10-04 19:30:21,0,0,0,0,0,0
2,201392387,2170660915,22663,36895,2024-10-04 19:30:21,0,0,0,0,0,0
2,201392387,2170660915,0,0,2024-10-04 19:30:21,128,84,212,1,1,2
2,201392387,2170660915,2759,36895,2024-10-04 19:30:21,0,0,0,0,0,0
2,201392387,2170660915,39639,36895,2024-10-04 19:30:22,0,0,0,0,0,0
2,201392387,2170660915,48844,36895,2024-10-04 19:30:22,0,0,0,0,0,0
2,201392387,2170660915,22663,36895,2024-10-04 19:30:22,0,0,0,0,0,0
2,201392387,2170660915,0,0,2024-10-04 19:30:22,0,84,84,0,1,1
2,201392387,2170660915,2759,36895,2024-10-04 19:30:22,0,0,0,0,0,0
2,201392387,2170660915,39639,36895,2024-10-04 19:30:23,0,0,0,0,0,0
2,201392387,2170660915,48844,36895,2024-10-04 19:30:23,0,0,0,0,0,0
2,201392387,2170660915,22663,36895,2024-10-04 19:30:23,0,0,0,0,0,0
2,201392387,2170660915,0,0,2024-10-04 19:30:23,0,0,0,0,0,0
2,201392387,2170660915,2759,36895,2024-10-04 19:30:23,0,0,0,0,0,0
2,201392387,2170660915,39639,36895,2024-10-04 19:30:24,0,0,0,0,0,0
2,201392387,2170660915,48844,36895,2024-10-04 19:30:24,0,0,0,0,0,0
2,201392387,2170660915,22663,36895,2024-10-04 19:30:24,0,0,0,0,0,0
2,201392387,2170660915,0,0,2024-10-04 19:30:24,0,0,0,0,0,0
2,201392387,2170660915,2759,36895,2024-10-04 19:30:24,0,0,0,0,0,0
2,201392387,2170660915,39639,36895,2024-10-04 19:30:25,0,0,0,0,0,0
2,201392387,2170660915,48844,36895,2024-10-04 19:30:25,0,0,0,0,0,0
2,201392387,2170660915,22663,36895,2024-10-04 19:30:25,0,0,0,0,0,0
2,201392387,2170660915,0,0,2024-10-04 19:30:25,128,0,128,1,0,1
2,201392387,2170660915,2759,36895,2024-10-04 19:30:25,0,0,0,0,0,0
2,201392387,2170660915,39639,36895,2024-10-04 19:30:26,0,0,0,0,0,0
2,201392387,2170660915,48844,36895,2024-10-04 19:30:26,0,0,0,0,0,0
2,201392387,2170660915,22663,36895,2024-10-04 19:30:26,0,0,0,0,0,0
2,201392387,2170660915,0,0,2024-10-04 19:30:26,0,84,84,0,1,1
2,201392387,2170660915,2759,36895,2024-10-04 19:30:26,0,0,0,0,0,0
2,201392387,2170660915,39639,36895,2024-10-04 19:30:27,0,0,0,0,0,0
2,201392387,2170660915,48844,36895,2024-10-04 19:30:27,0,0,0,0,0,0
2,201392387,2170660915,22663,36895,2024-10-04 19:30:27,0,0,0,0,0,0
2,201392387,1145490691,160,47873,2024-10-04 19:30:27,2100,14487,16587,13,19,32
2,201392387,2170660915,0,0,2024-10-04 19:30:27,256,168,424,2,2,4
2,201392387,2170660915,2759,36895,2024-10-04 19:30:27,0,0,0,0,0,0
2,201392387,2170660915,39639,36895,2024-10-04 19:30:28,0,0,0,0,0,0
2,201392387,2170660915,48844,36895,2024-10-04 19:30:28,0,0,0,0,0,0
2,201392387,2170660915,22663,36895,2024-10-04 19:30:28,0,0,0,0,0,0
2,201392387,1145490691,160,47873,2024-10-04 19:30:28,1584,34924,36508,15,22,37
2,201392387,2170660915,0,0,2024-10-04 19:30:28,0,0,0,0,0,0
2,201392387,2170660915,2759,36895,2024-10-04 19:30:28,0,0,0,0,0,0
2,201392387,2170660915,39639,36895,2024-10-04 19:30:29,0,0,0,0,0,0
2,201392387,2170660915,48844,36895,2024-10-04 19:30:29,0,0,0,0,0,0
2,201392387,2170660915,22663,36895,2024-10-04 19:30:29,0,0,0,0,0,0
2,201392387,1145490691,160,47873,2024-10-04 19:30:29,0,0,0,0,0,0
2,201392387,2170660915,0,0,2024-10-04 19:30:29,0,0,0,0,0,0
2,201392387,2170660915,2759,36895,2024-10-04 19:30:29,0,0,0,0,0,0
2,201392387,2170660915,39639,36895,2024-10-04 19:30:30,0,0,0,0,0,0
2,201392387,2170660915,48844,36895,2024-10-04 19:30:30,0,0,0,0,0,0
2,201392387,2170660915,22663,36895,2024-10-04 19:30:30,0,0,0,0,0,0
2,201392387,1145490691,160,47873,2024-10-04 19:30:30,0,0,0,0,0,0
2,201392387,2170660915,0,0,2024-10-04 19:30:30,0,0,0,0,0,0
2,201392387,2170660915,2759,36895,2024-10-04 19:30:30,0,0,0,0,0,0
2,201392387,2170660915,39639,36895,2024-10-04 19:30:31,0,0,0,0,0,0
2,201392387,2170660915,48844,36895,2024-10-04 19:30:31,0,0,0,0,0,0
2,201392387,2170660915,22663,36895,2024-10-04 19:30:31,0,0,0,0,0,0
2,201392387,1145490691,160,47873,2024-10-04 19:30:31,0,0,0,0,0,0
2,201392387,2170660915,0,0,2024-10-04 19:30:31,0,0,0,0,0,0
2,201392387,2170660915,2759,36895,2024-10-04 19:30:31,0,0,0,0,0,0
2,201392387,2170660915,39639,36895,2024-10-04 19:30:32,0,0,0,0,0,0
2,201392387,2170660915,48844,36895,2024-10-04 19:30:32,0,0,0,0,0,0
2,201392387,2170660915,22663,36895,2024-10-04 19:30:32,0,0,0,0,0,0
2,201392387,1145490691,160,47873,2024-10-04 19:30:32,0,0,0,0,0,0
2,201392387,2170660915,0,0,2024-10-04 19:30:32,0,0,0,0,0,0
2,201392387,2170660915,2759,36895,2024-10-04 19:30:32,0,0,0,0,0,0
2,201392387,2170660915,39639,36895,2024-10-04 19:30:33,0,0,0,0,0,0
2,201392387,2170660915,48844,36895,2024-10-04 19:30:33,0,0,0,0,0,0
2,201392387,2170660915,22663,36895,2024-10-04 19:30:33,0,0,0,0,0,0
2,201392387,1145490691,160,47873,2024-10-04 19:30:33,2748,58027,60775,27,41,68
2,201392387,2170660915,0,0,2024-10-04 19:30:33,0,0,0,0,0,0
2,201392387,2170660915,2759,36895,2024-10-04 19:30:33,0,0,0,0,0,0
2,201392387,2170660915,39639,36895,2024-10-04 19:30:34,0,0,0,0,0,0
2,201392387,2170660915,48844,36895,2024-10-04 19:30:34,0,0,0,0,0,0
2,201392387,2170660915,22663,36895,2024-10-04 19:30:34,0,0,0,0,0,0
2,201392387,1145490691,160,47873,2024-10-04 19:30:34,0,0,0,0,0,0
2,201392387,2170660915,0,0,2024-10-04 19:30:34,0,0,0,0,0,0
2,201392387,2170660915,2759,36895,2024-10-04 19:30:34,0,0,0,0,0,0
2,201392387,2170660915,39639,36895,2024-10-04 19:30:35,0,0,0,0,0,0
2,201392387,2170660915,48844,36895,2024-10-04 19:30:35,0,0,0,0,0,0
2,201392387,2170660915,22663,36895,2024-10-04 19:30:35,0,0,0,0,0,0
2,201392387,1145490691,160,47873,2024-10-04 19:30:35,0,0,0,0,0,0
2,201392387,2170660915,0,0,2024-10-04 19:30:35,0,0,0,0,0,0
2,201392387,2170660915,2759,36895,2024-10-04 19:30:35,0,0,0,0,0,0
2,201392387,2170660915,39639,36895,2024-10-04 19:30:36,0,0,0,0,0,0
2,201392387,2170660915,48844,36895,2024-10-04 19:30:36,0,0,0,0,0,0
2,201392387,2170660915,22663,36895,2024-10-04 19:30:36,0,0,0,0,0,0
2,201392387,1145490691,160,47873,2024-10-04 19:30:36,0,0,0,0,0,0
2,201392387,2170660915,0,0,2024-10-04 19:30:36,0,0,0,0,0,0
2,201392387,2170660915,2759,36895,2024-10-04 19:30:36,0,0,0,0,0,0
2,201392387,2170660915,39639,36895,2024-10-04 19:30:37,0,0,0,0,0,0
2,201392387,2170660915,48844,36895,2024-10-04 19:30:37,0,0,0,0,0,0
2,201392387,2170660915,22663,36895,2024-10-04 19:30:37,0,0,0,0,0,0
2,201392387,1145490691,160,47873,2024-10-04 19:30:37,0,0,0,0,0,0
2,201392387,2170660915,0,0,2024-10-04 19:30:37,0,0,0,0,0,0
2,201392387,2170660915,2759,36895,2024-10-04 19:30:37,0,0,0,0,0,0
2,201392387,2170660915,39639,36895,2024-10-04 19:30:38,0,0,0,0,0,0
2,201392387,2170660915,48844,36895,2024-10-04 19:30:38,0,0,0,0,0,0
2,201392387,2170660915,22663,36895,2024-10-04 19:30:38,0,0,0,0,0,0
2,201392387,1145490691,160,47873,2024-10-04 19:30:38,0,0,0,0,0,0
2,201392387,2170660915,0,0,2024-10-04 19:30:38,0,0,0,0,0,0
2,201392387,2170660915,2759,36895,2024-10-04 19:30:38,0,0,0,0,0,0
2,201392387,2170660915,39639,36895,2024-10-04 19:30:39,0,0,0,0,0,0
2,201392387,2170660915,48844,36895,2024-10-04 19:30:39,0,0,0,0,0,0
2,201392387,2170660915,22663,36895,2024-10-04 19:30:39,0,0,0,0,0,0
2,201392387,1145490691,160,47873,2024-10-04 19:30:39,0,0,0,0,0,0
2,201392387,2170660915,0,0,2024-10-04 19:30:39,0,0,0,0,0,0
2,201392387,2170660915,2759,36895,2024-10-04 19:30:39,0,0,0,0,0,0
2,201392387,2170660915,39639,36895,2024-10-04 19:30:40,0,0,0,0,0,0
2,201392387,2170660915,48844,36895,2024-10-04 19:30:40,0,0,0,0,0,0
2,201392387,2170660915,22663,36895,2024-10-04 19:30:40,0,0,0,0,0,0
2,201392387,1145490691,160,47873,2024-10-04 19:30:40,0,0,0,0,0,0
2,201392387,2170660915,0,0,2024-10-04 19:30:40,128,84,212,1,1,2
2,201392387,2170660915,2759,36895,2024-10-04 19:30:40,0,0,0,0,0,0
2,201392387,2170660915,39639,36895,2024-10-04 19:30:41,0,0,0,0,0,0
2,201392387,2170660915,48844,36895,2024-10-04 19:30:41,0,0,0,0,0,0
2,201392387,2170660915,22663,36895,2024-10-04 19:30:41,0,0,0,0,0,0
2,201392387,1145490691,160,47873,2024-10-04 19:30:41,0,0,0,0,0,0
2,201392387,2170660915,0,0,2024-10-04 19:30:41,256,168,424,2,2,4
2,201392387,2170660915,2759,36895,2024-10-04 19:30:41,0,0,0,0,0,0
2,201392387,2170660915,39639,36895,2024-10-04 19:30:42,0,0,0,0,0,0
2,201392387,2170660915,48844,36895,2024-10-04 19:30:42,0,0,0,0,0,0
2,201392387,2170660915,22663,36895,2024-10-04 19:30:42,0,0,0,0,0,0
2,201392387,1145490691,160,47873,2024-10-04 19:30:42,0,0,0,0,0,0
2,201392387,2170660915,0,0,2024-10-04 19:30:42,128,0,128,1,0,1
2,201392387,2170660915,2759,36895,2024-10-04 19:30:42,0,0,0,0,0,0
2,201392387,2170660915,39639,36895,2024-10-04 19:30:43,0,0,0,0,0,0
2,201392387,2170660915,48844,36895,2024-10-04 19:30:43,0,0,0,0,0,0
2,201392387,2170660915,22663,36895,2024-10-04 19:30:43,0,0,0,0,0,0
2,201392387,1145490691,160,47873,2024-10-04 19:30:43,0,0,0,0,0,0
2,201392387,2170660915,0,0,2024-10-04 19:30:43,128,84,212,1,1,2
2,201392387,2170660915,2759,36895,2024-10-04 19:30:43,0,0,0,0,0,0
2,201392387,2170660915,39639,36895,2024-10-04 19:30:44,0,0,0,0,0,0
2,201392387,2170660915,48844,36895,2024-10-04 19:30:44,0,0,0,0,0,0
2,201392387,2170660915,22663,36895,2024-10-04 19:30:44,0,0,0,0,0,0
2,201392387,2170660915,0,0,2024-10-04 19:30:44,128,84,212,1,1,2
2,201392387,2170660915,2759,36895,2024-10-04 19:30:44,0,0,0,0,0,0
2,201392387,2170660915,39639,36895,2024-10-04 19:30:45,0,0,0,0,0,0
2,201392387,2170660915,48844,36895,2024-10-04 19:30:45,0,0,0,0,0,0
2,201392387,2170660915,22663,36895,2024-10-04 19:30:45,0,0,0,0,0,0
2,201392387,2170660915,0,0,2024-10-04 19:30:45,128,84,212,1,1,2
2,201392387,2170660915,2759,36895,2024-10-04 19:30:45,0,0,0,0,0,0
2,201392387,2170660915,39639,36895,2024-10-04 19:30:46,0,0,0,0,0,0
2,201392387,2170660915,48844,36895,2024-10-04 19:30:46,0,0,0,0,0,0
2,201392387,2170660915,22663,36895,2024-10-04 19:30:46,0,0,0,0,0,0
2,201392387,2170660915,0,0,2024-10-04 19:30:46,128,84,212,1,1,2
2,201392387,2170660915,2759,36895,2024-10-04 19:30:46,0,0,0,0,0,0
2,201392387,2170660915,39639,36895,2024-10-04 19:30:47,0,0,0,0,0,0
2,201392387,2170660915,48844,36895,2024-10-04 19:30:47,0,0,0,0,0,0
2,201392387,2170660915,22663,36895,2024-10-04 19:30:47,0,0,0,0,0,0
2,201392387,2170660915,0,0,2024-10-04 19:30:47,128,84,212,1,1,2
2,201392387,2170660915,2759,36895,2024-10-04 19:30:47,0,0,0,0,0,0
2,201392387,2170660915,39639,36895,2024-10-04 19:30:48,0,0,0,0,0,0
2,201392387,2170660915,48844,36895,2024-10-04 19:30:48,0,0,0,0,0,0
2,201392387,2170660915,22663,36895,2024-10-04 19:30:48,0,0,0,0,0,0
2,201392387,2170660915,0,0,2024-10-04 19:30:48,128,84,212,1,1,2
2,201392387,2170660915,2759,36895,2024-10-04 19:30:48,0,0,0,0,0,0
2,201392387,2170660915,39639,36895,2024-10-04 19:30:49,0,0,0,0,0,0
2,201392387,2170660915,48844,36895,2024-10-04 19:30:49,0,0,0,0,0,0
2,201392387,2170660915,22663,36895,2024-10-04 19:30:49,0,0,0,0,0,0
2,201392387,2170660915,0,0,2024-10-04 19:30:49,0,84,84,0,1,1
2,201392387,2170660915,2759,36895,2024-10-04 19:30:49,0,0,0,0,0,0
2,201392387,2170660915,39639,36895,2024-10-04 19:30:50,0,0,0,0,0,0
2,201392387,2170660915,15522,36895,2024-10-04 19:30:50,666,507,1173,6,6,12
2,201392387,2170660915,22663,36895,2024-10-04 19:30:50,0,0,0,0,0,0
2,201392387,2170660915,0,0,2024-10-04 19:30:50,0,0,0,0,0,0
2,201392387,2170660915,2759,36895,2024-10-04 19:30:50,0,0,0,0,0,0
2,201392387,2170660915,39639,36895,2024-10-04 19:30:51,0,0,0,0,0,0
2,201392387,2170660915,15522,36895,2024-10-04 19:30:51,0,0,0,0,0,0
2,201392387,2170660915,22663,36895,2024-10-04 19:30:51,0,0,0,0,0,0
2,201392387,2170660915,0,0,2024-10-04 19:30:51,128,84,212,1,1,2
2,201392387,2170660915,2759,36895,2024-10-04 19:30:51,0,0,0,0,0,0
2,201392387,2170660915,39639,36895,2024-10-04 19:30:52,0,0,0,0,0,0
2,201392387,2170660915,15522,36895,2024-10-04 19:30:52,0,0,0,0,0,0
2,201392387,2170660915,22663,36895,2024-10-04 19:30:52,0,0,0,0,0,0
2,201392387,2170660915,0,0,2024-10-04 19:30:52,128,84,212,1,1,2
2,201392387,2170660915,2759,36895,2024-10-04 19:30:52,0,0,0,0,0,0
2,201392387,2170660915,39639,36895,2024-10-04 19:30:53,0,0,0,0,0,0
2,201392387,2170660915,22663,36895,2024-10-04 19:30:53,0,0,0,0,0,0
2,201392387,2170660915,0,0,2024-10-04 19:30:53,128,84,212,1,1,2
2,201392387,2170660915,2759,36895,2024-10-04 19:30:53,0,0,0,0,0,0
2,201392387,2170660915,39639,36895,2024-10-04 19:30:54,0,0,0,0,0,0
2,201392387,2170660915,22663,36895,2024-10-04 19:30:54,0,0,0,0,0,0
2,201392387,2170660915,0,0,2024-10-04 19:30:54,0,0,0,0,0,0
2,201392387,2170660915,2759,36895,2024-10-04 19:30:54,0,0,0,0,0,0
2,201392387,2170660915,39639,36895,2024-10-04 19:30:55,0,0,0,0,0,0
2,201392387,2170660915,22663,36895,2024-10-04 19:30:55,0,0,0,0,0,0
2,201392387,2170660915,0,0,2024-10-04 19:30:55,0,0,0,0,0,0
2,201392387,2170660915,2759,36895,2024-10-04 19:30:55,0,0,0,0,0,0
2,201392387,2170660915,39639,36895,2024-10-04 19:30:56,0,0,0,0,0,0
2,201392387,2170660915,22663,36895,2024-10-04 19:30:56,0,0,0,0,0,0
2,201392387,2170660915,0,0,2024-10-04 19:30:56,0,0,0,0,0,0
2,201392387,2170660915,2759,36895,2024-10-04 19:30:56,0,0,0,0,0,0
2,201392387,2170660915,39639,36895,2024-10-04 19:30:57,0,0,0,0,0,0
2,201392387,2170660915,22663,36895,2024-10-04 19:30:57,0,0,0,0,0,0
2,201392387,2170660915,0,0,2024-10-04 19:30:57,128,84,212,1,1,2
2,201392387,2170660915,2759,36895,2024-10-04 19:30:57,0,0,0,0,0,0
2,201392387,2170660915,39639,36895,2024-10-04 19:30:58,0,0,0,0,0,0
2,201392387,2170660915,22663,36895,2024-10-04 19:30:58,0,0,0,0,0,0
2,201392387,2170660915,0,0,2024-10-04 19:30:58,128,84,212,1,1,2
2,201392387,2170660915,2759,36895,2024-10-04 19:30:58,0,0,0,0,0,0
2,201392387,2170660915,39639,36895,2024-10-04 19:30:59,0,0,0,0,0,0
2,201392387,2170660915,22663,36895,2024-10-04 19:30:59,0,0,0,0,0,0
2,201392387,1145490690,36583,47873,2024-10-04 19:30:59,5028,81443,86471,40,60,100
2,201392387,2170660915,0,0,2024-10-04 19:30:59,128,84,212,1,1,2
2,201392387,2170660915,2759,36895,2024-10-04 19:30:59,0,0,0,0,0,0
2,201392387,2170660915,39639,36895,2024-10-04 19:31:00,0,0,0,0,0,0
2,201392387,2170660915,22663,36895,2024-10-04 19:31:00,0,0,0,0,0,0
2,201392387,1145490690,36583,47873,2024-10-04 19:31:00,0,0,0,0,0,0
2,201392387,2170660915,0,0,2024-10-04 19:31:00,0,0,0,0,0,0
2,201392387,2170660915,2759,36895,2024-10-04 19:31:00,0,0,0,0,0,0
2,201392387,2170660915,39639,36895,2024-10-04 19:31:01,0,0,0,0,0,0
2,201392387,2170660915,22663,36895,2024-10-04 19:31:01,0,0,0,0,0,0
2,201392387,1145490690,36583,47873,2024-10-04 19:31:01,0,0,0,0,0,0
2,201392387,2170660915,0,0,2024-10-04 19:31:01,0,0,0,0,0,0
2,201392387,2170660915,2759,36895,2024-10-04 19:31:01,0,0,0,0,0,0
2,201392387,2170660915,39639,36895,2024-10-04 19:31:02,0,0,0,0,0,0
2,201392387,2170660915,22663,36895,2024-10-04 19:31:02,0,0,0,0,0,0
2,201392387,1145490690,36583,47873,2024-10-04 19:31:02,0,0,0,0,0,0
2,201392387,2170660915,0,0,2024-10-04 19:31:02,0,0,0,0,0,0
2,201392387,2170660915,2759,36895,2024-10-04 19:31:02,0,0,0,0,0,0
2,201392387,2170660915,39639,36895,2024-10-04 19:31:03,0,0,0,0,0,0
2,201392387,2170660915,22663,36895,2024-10-04 19:31:03,0,0,0,0,0,0
2,201392387,1145490690,36583,47873,2024-10-04 19:31:03,2016,32045,34061,20,24,44
2,201392387,2170660915,0,0,2024-10-04 19:31:03,0,0,0,0,0,0
2,201392387,2170660915,2759,36895,2024-10-04 19:31:03,0,0,0,0,0,0
2,201392387,2170660915,39639,36895,2024-10-04 19:31:04,0,0,0,0,0,0
2,201392387,2170660915,22663,36895,2024-10-04 19:31:04,0,0,0,0,0,0
2,201392387,1145490690,36583,47873,2024-10-04 19:31:04,0,0,0,0,0,0
2,201392387,2170660915,0,0,2024-10-04 19:31:04,0,0,0,0,0,0
2,201392387,2170660915,2759,36895,2024-10-04 19:31:04,0,0,0,0,0,0
2,201392387,2170660915,39639,36895,2024-10-04 19:31:05,0,0,0,0,0,0
2,201392387,2170660915,22663,36895,2024-10-04 19:31:05,0,0,0,0,0,0
2,201392387,1145490690,36583,47873,2024-10-04 19:31:05,0,0,0,0,0,0
2,201392387,2170660915,0,0,2024-10-04 19:31:05,0,0,0,0,0,0
2,201392387,2170660915,2759,36895,2024-10-04 19:31:05,0,0,0,0,0,0
2,201392387,2170660915,39639,36895,2024-10-04 19:31:06,0,0,0,0,0,0
2,201392387,2170660915,22663,36895,2024-10-04 19:31:06,0,0,0,0,0,0
2,201392387,1145490690,36583,47873,2024-10-04 19:31:06,0,0,0,0,0,0
2,201392387,2170660915,0,0,2024-10-04 19:31:06,0,0,0,0,0,0
2,201392387,2170660915,2759,36895,2024-10-04 19:31:06,0,0,0,0,0,0
2,201392387,2170660915,39639,36895,2024-10-04 19:31:07,0,0,0,0,0,0
2,201392387,2170660915,22663,36895,2024-10-04 19:31:07,0,0,0,0,0,0
2,201392387,1145490690,36583,47873,2024-10-04 19:31:07,0,0,0,0,0,0
2,201392387,2170660915,0,0,2024-10-04 19:31:07,0,0,0,0,0,0
2,201392387,2170660915,2759,36895,2024-10-04 19:31:07,0,0,0,0,0,0
2,201392387,2170660915,39639,36895,2024-10-04 19:31:08,0,0,0,0,0,0
2,201392387,2170660915,22663,36895,2024-10-04 19:31:08,0,0,0,0,0,0
2,201392387,1145490690,36583,47873,2024-10-04 19:31:08,0,0,0,0,0,0
2,201392387,2170660915,0,0,2024-10-04 19:31:08,0,0,0,0,0,0
2,201392387,2170660915,2759,36895,2024-10-04 19:31:08,0,0,0,0,0,0
2,201392387,2170660915,39639,36895,2024-10-04 19:31:09,0,0,0,0,0,0
2,201392387,2170660915,22663,36895,2024-10-04 19:31:09,0,0,0,0,0,0
2,201392387,1145490690,36583,47873,2024-10-04 19:31:09,0,0,0,0,0,0
2,201392387,2170660915,0,0,2024-10-04 19:31:09,0,0,0,0,0,0
2,201392387,2170660915,2759,36895,2024-10-04 19:31:09,0,0,0,0,0,0
2,201392387,2170660915,39639,36895,2024-10-04 19:31:10,0,0,0,0,0,0
2,201392387,2170660915,22663,36895,2024-10-04 19:31:10,0,0,0,0,0,0
2,201392387,1145490690,36583,47873,2024-10-04 19:31:10,0,0,0,0,0,0
2,201392387,2170660915,0,0,2024-10-04 19:31:10,128,84,212,1,1,2
2,201392387,2170660915,2759,36895,2024-10-04 19:31:10,0,0,0,0,0,0
2,201392387,2170660915,39639,36895,2024-10-04 19:31:11,0,0,0,0,0,0
2,201392387,2170660915,22663,36895,2024-10-04 19:31:11,0,0,0,0,0,0
2,201392387,1145490690,36583,47873,2024-10-04 19:31:11,0,0,0,0,0,0
2,201392387,2170660915,0,0,2024-10-04 19:31:11,128,84,212,1,1,2
2,201392387,2170660915,2759,36895,2024-10-04 19:31:11,0,0,0,0,0,0
2,201392387,2170660915,39639,36895,2024-10-04 19:31:12,0,0,0,0,0,0
2,201392387,2170660915,22663,36895,2024-10-04 19:31:12,0,0,0,0,0,0
2,201392387,1145490690,36583,47873,2024-10-04 19:31:12,0,0,0,0,0,0
2,201392387,2170660915,0,0,2024-10-04 19:31:12,128,84,212,1,1,2
2,201392387,2170660915,2759,36895,2024-10-04 19:31:12,0,0,0,0,0,0
2,201392387,2170660915,39639,36895,2024-10-04 19:31:13,0,0,0,0,0,0
2,201392387,2170660915,22663,36895,2024-10-04 19:31:13,0,0,0,0,0,0
2,201392387,1145490690,36583,47873,2024-10-04 19:31:13,0,0,0,0,0,0
2,201392387,2170660915,0,0,2024-10-04 19:31:13,128,84,212,1,1,2
2,201392387,2170660915,2759,36895,2024-10-04 19:31:13,0,0,0,0,0,0
2,201392387,2170660915,39639,36895,2024-10-04 19:31:14,0,0,0,0,0,0
2,201392387,2170660915,22663,36895,2024-10-04 19:31:14,0,0,0,0,0,0
2,201392387,2170660915,0,0,2024-10-04 19:31:14,128,84,212,1,1,2
2,201392387,2170660915,2759,36895,2024-10-04 19:31:14,0,0,0,0,0,0
2,201392387,2170660915,39639,36895,2024-10-04 19:31:15,0,0,0,0,0,0
2,201392387,2170660915,22663,36895,2024-10-04 19:31:15,0,0,0,0,0,0
2,201392387,2170660915,0,0,2024-10-04 19:31:15,128,84,212,1,1,2
2,201392387,2170660915,2759,36895,2024-10-04 19:31:15,0,0,0,0,0,0
2,201392387,2170660915,39639,36895,2024-10-04 19:31:16,0,0,0,0,0,0
2,201392387,2170660915,22663,36895,2024-10-04 19:31:16,0,0,0,0,0,0
2,201392387,2170660915,0,0,2024-10-04 19:31:16,128,84,212,1,1,2
2,201392387,2170660915,2759,36895,2024-10-04 19:31:16,0,0,0,0,0,0
2,201392387,2170660915,39639,36895,2024-10-04 19:31:17,0,0,0,0,0,0
2,201392387,2170660915,22663,36895,2024-10-04 19:31:17,0,0,0,0,0,0
2,201392387,2170660915,0,0,2024-10-04 19:31:17,128,84,212,1,1,2
2,201392387,2170660915,2759,36895,2024-10-04 19:31:17,0,0,0,0,0,0
2,201392387,2170660915,39639,36895,2024-10-04 19:31:18,0,0,0,0,0,0
2,201392387,2170660915,22663,36895,2024-10-04 19:31:18,0,0,0,0,0,0
2,201392387,2170660915,0,0,2024-10-04 19:31:18,128,84,212,1,1,2
2,201392387,2170660915,2759,36895,2024-10-04 19:31:18,0,0,0,0,0,0
2,201392387,2170660915,39639,36895,2024-10-04 19:31:19,0,0,0,0,0,0
2,201392387,2170660915,22663,36895,2024-10-04 19:31:19,0,0,0,0,0,0
2,201392387,2170660915,0,0,2024-10-04 19:31:19,128,84,212,1,1,2
2,201392387,2170660915,2759,36895,2024-10-04 19:31:19,0,0,0,0,0,0
2,201392387,2170660915,39639,36895,2024-10-04 19:31:20,0,0,0,0,0,0
2,201392387,2170660915,22663,36895,2024-10-04 19:31:20,0,0,0,0,0,0
2,201392387,2170660915,0,0,2024-10-04 19:31:20,0,0,0,0,0,0
2,201392387,2170660915,2759,36895,2024-10-04 19:31:20,0,0,0,0,0,0
2,201392387,2170660915,39639,36895,2024-10-04 19:31:21,0,0,0,0,0,0
2,201392387,2170660915,22663,36895,2024-10-04 19:31:21,0,0,0,0,0,0
2,201392387,2170660915,0,0,2024-10-04 19:31:21,0,0,0,0,0,0
2,201392387,2170660915,2759,36895,2024-10-04 19:31:21,0,0,0,0,0,0
2,201392387,2170660915,39639,36895,2024-10-04 19:31:22,0,0,0,0,0,0
2,201392387,2170660915,22663,36895,2024-10-04 19:31:22,0,0,0,0,0,0
2,201392387,2170660915,49896,36895,2024-10-04 19:31:22,570,455,1025,5,5,10
2,201392387,2170660915,0,0,2024-10-04 19:31:22,128,84,212,1,1,2
2,201392387,2170660915,2759,36895,2024-10-04 19:31:22,0,0,0,0,0,0
2,201392387,2170660915,39639,36895,2024-10-04 19:31:23,0,0,0,0,0,0
2,201392387,2170660915,22663,36895,2024-10-04 19:31:23,0,0,0,0,0,0
2,201392387,2170660915,49896,36895,2024-10-04 19:31:23,0,0,0,0,0,0
2,201392387,2170660915,0,0,2024-10-04 19:31:23,128,84,212,1,1,2
2,201392387,2170660915,2759,36895,2024-10-04 19:31:23,0,0,0,0,0,0
2,201392387,2170660915,39639,36895,2024-10-04 19:31:24,0,0,0,0,0,0
2,201392387,2170660915,22663,36895,2024-10-04 19:31:24,0,0,0,0,0,0
2,201392387,2170660915,49896,36895,2024-10-04 19:31:24,0,0,0,0,0,0
2,201392387,2170660915,0,0,2024-10-04 19:31:24,128,84,212,1,1,2
2,201392387,2170660915,2759,36895,2024-10-04 19:31:24,0,0,0,0,0,0
2,201392387,2170660915,39639,36895,2024-10-04 19:31:25,0,0,0,0,0,0
2,201392387,2170660915,22663,36895,2024-10-04 19:31:25,0,0,0,0,0,0
2,201392387,2170660915,49896,36895,2024-10-04 19:31:25,0,0,0,0,0,0
2,201392387,2170660915,0,0,2024-10-04 19:31:25,0,0,0,0,0,0
2,201392387,2170660915,2759,36895,2024-10-04 19:31:25,0,0,0,0,0,0
2,201392387,2170660915,39639,36895,2024-10-04 19:31:26,0,0,0,0,0,0
2,201392387,2170660915,22663,36895,2024-10-04 19:31:26,0,0,0,0,0,0
2,201392387,2170660915,49896,36895,2024-10-04 19:31:26,0,0,0,0,0,0
2,201392387,2170660915,0,0,2024-10-04 19:31:26,0,0,0,0,0,0
2,201392387,2170660915,2759,36895,2024-10-04 19:31:26,0,0,0,0,0,0
2,201392387,2170660915,39639,36895,2024-10-04 19:31:27,0,0,0,0,0,0
2,201392387,2170660915,22663,36895,2024-10-04 19:31:27,0,0,0,0,0,0
2,201392387,2170660915,49896,36895,2024-10-04 19:31:27,0,0,0,0,0,0
2,201392387,2170660915,0,0,2024-10-04 19:31:27,0,0,0,0,0,0
2,201392387,2170660915,2759,36895,2024-10-04 19:31:27,0,0,0,0,0,0
2,201392387,2170660915,39639,36895,2024-10-04 19:31:28,0,0,0,0,0,0
2,201392387,2170660915,22663,36895,2024-10-04 19:31:28,0,0,0,0,0,0
2,201392387,2170660915,49896,36895,2024-10-04 19:31:28,0,0,0,0,0,0
2,201392387,2170660915,0,0,2024-10-04 19:31:28,128,0,128,1,0,1
2,201392387,2170660915,2759,36895,2024-10-04 19:31:28,0,0,0,0,0,0
2,201392387,2170660915,39639,36895,2024-10-04 19:31:29,0,0,0,0,0,0
2,201392387,2170660915,22663,36895,2024-10-04 19:31:29,0,0,0,0,0,0
2,201392387,2170660915,49896,36895,2024-10-04 19:31:29,0,0,0,0,0,0
2,201392387,2170660915,0,0,2024-10-04 19:31:29,128,168,296,1,2,3
2,201392387,2170660915,2759,36895,2024-10-04 19:31:29,0,0,0,0,0,0
2,201392387,2170660915,39639,36895,2024-10-04 19:31:30,0,0,0,0,0,0
2,201392387,2170660915,22663,36895,2024-10-04 19:31:30,0,0,0,0,0,0
2,201392387,1145490690,48342,47873,2024-10-04 19:31:30,4276,69853,74129,34,54,88
2,201392387,2170660915,49896,36895,2024-10-04 19:31:30,0,0,0,0,0,0
2,201392387,2170660915,0,0,2024-10-04 19:31:30,128,84,212,1,1,2
2,201392387,2170660915,2759,36895,2024-10-04 19:31:30,0,0,0,0,0,0
2,201392387,2170660915,39639,36895,2024-10-04 19:31:31,0,0,0,0,0,0
2,201392387,2170660915,22663,36895,2024-10-04 19:31:31,0,0,0,0,0,0
2,201392387,1145490690,48342,47873,2024-10-04 19:31:31,0,0,0,0,0,0
2,201392387,2170660915,49896,36895,2024-10-04 19:31:31,0,0,0,0,0,0
2,201392387,2170660915,0,0,2024-10-04 19:31:31,0,0,0,0,0,0
2,201392387,2170660915,2759,36895,2024-10-04 19:31:31,0,0,0,0,0,0
2,201392387,2170660915,39639,36895,2024-10-04 19:31:32,0,0,0,0,0,0
2,201392387,2170660915,22663,36895,2024-10-04 19:31:32,0,0,0,0,0,0
2,201392387,1145490690,48342,47873,2024-10-04 19:31:32,0,0,0,0,0,0
2,201392387,2170660915,49896,36895,2024-10-04 19:31:32,0,0,0,0,0,0
2,201392387,2170660915,0,0,2024-10-04 19:31:32,0,0,0,0,0,0
2,201392387,2170660915,2759,36895,2024-10-04 19:31:32,0,0,0,0,0,0
2,201392387,2170660915,39639,36895,2024-10-04 19:31:33,0,0,0,0,0,0
2,201392387,2170660915,22663,36895,2024-10-04 19:31:33,0,0,0,0,0,0
2,201392387,1145490690,48342,47873,2024-10-04 19:31:33,0,0,0,0,0,0
2,201392387,2170660915,49896,36895,2024-10-04 19:31:33,0,0,0,0,0,0
2,201392387,2170660915,0,0,2024-10-04 19:31:33,0,0,0,0,0,0
2,201392387,2170660915,2759,36895,2024-10-04 19:31:33,0,0,0,0,0,0
2,201392387,2170660915,39639,36895,2024-10-04 19:31:34,0,0,0,0,0,0
2,201392387,2170660915,22663,36895,2024-10-04 19:31:34,0,0,0,0,0,0
2,201392387,1145490690,48342,47873,2024-10-04 19:31:34,0,0,0,0,0,0
2,201392387,2170660915,49896,36895,2024-10-04 19:31:34,0,0,0,0,0,0
2,201392387,2170660915,0,0,2024-10-04 19:31:34,0,0,0,0,0,0
2,201392387,2170660915,2759,36895,2024-10-04 19:31:34,0,0,0,0,0,0
2,201392387,2170660915,39639,36895,2024-10-04 19:31:35,0,0,0,0,0,0
2,201392387,2170660915,22663,36895,2024-10-04 19:31:35,0,0,0,0,0,0
2,201392387,1145490690,48342,47873,2024-10-04 19:31:35,2220,31431,33651,22,24,46
2,201392387,2170660915,49896,36895,2024-10-04 19:31:35,0,0,0,0,0,0
2,201392387,2170660915,0,0,2024-10-04 19:31:35,0,0,0,0,0,0
2,201392387,2170660915,2759,36895,2024-10-04 19:31:35,0,0,0,0,0,0
2,201392387,2170660915,39639,36895,2024-10-04 19:31:36,0,0,0,0,0,0
2,201392387,2170660915,22663,36895,2024-10-04 19:31:36,0,0,0,0,0,0
2,201392387,1145490690,48342,47873,2024-10-04 19:31:36,0,0,0,0,0,0
2,201392387,2170660915,49896,36895,2024-10-04 19:31:36,0,0,0,0,0,0
2,201392387,2170660915,0,0,2024-10-04 19:31:36,0,0,0,0,0,0
2,201392387,2170660915,2759,36895,2024-10-04 19:31:36,0,0,0,0,0,0
2,201392387,2170660915,39639,36895,2024-10-04 19:31:37,0,0,0,0,0,0
2,201392387,2170660915,22663,36895,2024-10-04 19:31:37,0,0,0,0,0,0
2,201392387,1145490690,48342,47873,2024-10-04 19:31:37,0,0,0,0,0,0
2,201392387,2170660915,49896,36895,2024-10-04 19:31:37,0,0,0,0,0,0
2,201392387,2170660915,0,0,2024-10-04 19:31:37,0,0,0,0,0,0
2,201392387,2170660915,2759,36895,2024-10-04 19:31:37,0,0,0,0,0,0
2,201392387,2170660915,39639,36895,2024-10-04 19:31:38,0,0,0,0,0,0
2,201392387,2170660915,22663,36895,2024-10-04 19:31:38,0,0,0,0,0,0
2,201392387,1145490690,48342,47873,2024-10-04 19:31:38,0,0,0,0,0,0
2,201392387,2170660915,49896,36895,2024-10-04 19:31:38,0,0,0,0,0,0
2,201392387,2170660915,0,0,2024-10-04 19:31:38,0,0,0,0,0,0
2,201392387,2170660915,2759,36895,2024-10-04 19:31:38,0,0,0,0,0,0
2,201392387,2170660915,39639,36895,2024-10-04 19:31:39,0,0,0,0,0,0
2,201392387,2170660915,22663,36895,2024-10-04 19:31:39,0,0,0,0,0,0
2,201392387,1145490690,48342,47873,2024-10-04 19:31:39,0,0,0,0,0,0
2,201392387,2170660915,49896,36895,2024-10-04 19:31:39,0,0,0,0,0,0
2,201392387,2170660915,0,0,2024-10-04 19:31:39,0,0,0,0,0,0
2,201392387,2170660915,2759,36895,2024-10-04 19:31:39,0,0,0,0,0,0
2,201392387,2170660915,39639,36895,2024-10-04 19:31:40,0,0,0,0,0,0
2,201392387,2170660915,22663,36895,2024-10-04 19:31:40,0,0,0,0,0,0
2,201392387,1145490690,48342,47873,2024-10-04 19:31:40,0,0,0,0,0,0
2,201392387,2170660915,49896,36895,2024-10-04 19:31:40,0,0,0,0,0,0
2,201392387,2170660915,0,0,2024-10-04 19:31:40,0,0,0,0,0,0
2,201392387,2170660915,2759,36895,2024-10-04 19:31:40,0,0,0,0,0,0
2,201392387,2170660915,39639,36895,2024-10-04 19:31:41,0,0,0,0,0,0
2,201392387,2170660915,22663,36895,2024-10-04 19:31:41,0,0,0,0,0,0
2,201392387,1145490690,48342,47873,2024-10-04 19:31:41,0,0,0,0,0,0
2,201392387,2170660915,49896,36895,2024-10-04 19:31:41,0,0,0,0,0,0
2,201392387,2170660915,0,0,2024-10-04 19:31:41,128,84,212,1,1,2
2,201392387,2170660915,2759,36895,2024-10-04 19:31:41,0,0,0,0,0,0
2,201392387,2170660915,39639,36895,2024-10-04 19:31:42,0,0,0,0,0,0
2,201392387,2170660915,22663,36895,2024-10-04 19:31:42,0,0,0,0,0,0
2,201392387,1145490690,48342,47873,2024-10-04 19:31:42,0,0,0,0,0,0
2,201392387,2170660915,49896,36895,2024-10-04 19:31:42,0,0,0,0,0,0
2,201392387,2170660915,0,0,2024-10-04 19:31:42,128,84,212,1,1,2
2,201392387,2170660915,2759,36895,2024-10-04 19:31:42,0,0,0,0,0,0
2,201392387,2170660915,39639,36895,2024-10-04 19:31:43,0,0,0,0,0,0
2,201392387,2170660915,22663,36895,2024-10-04 19:31:43,0,0,0,0,0,0
2,201392387,1145490690,48342,47873,2024-10-04 19:31:43,0,0,0,0,0,0
2,201392387,2170660915,49896,36895,2024-10-04 19:31:43,0,0,0,0,0,0
2,201392387,2170660915,0,0,2024-10-04 19:31:43,128,84,212,1,1,2
2,201392387,2170660915,2759,36895,2024-10-04 19:31:43,0,0,0,0,0,0
2,201392387,2170660915,39639,36895,2024-10-04 19:31:44,0,0,0,0,0,0
2,201392387,2170660915,22663,36895,2024-10-04 19:31:44,0,0,0,0,0,0
2,201392387,1145490690,48342,47873,2024-10-04 19:31:44,0,0,0,0,0,0
2,201392387,2170660915,49896,36895,2024-10-04 19:31:44,0,0,0,0,0,0
2,201392387,2170660915,0,0,2024-10-04 19:31:44,0,0,0,0,0,0
2,201392387,2170660915,2759,36895,2024-10-04 19:31:44,0,0,0,0,0,0
2,201392387,2170660915,39639,36895,2024-10-04 19:31:45,0,0,0,0,0,0
2,201392387,2170660915,22663,36895,2024-10-04 19:31:45,0,0,0,0,0,0
2,201392387,1145490690,48342,47873,2024-10-04 19:31:45,0,0,0,0,0,0
2,201392387,2170660915,49896,36895,2024-10-04 19:31:45,0,0,0,0,0,0
2,201392387,2170660915,0,0,2024-10-04 19:31:45,128,84,212,1,1,2
2,201392387,2170660915,2759,36895,2024-10-04 19:31:45,0,0,0,0,0,0
2,201392387,2170660915,39639,36895,2024-10-04 19:31:46,0,0,0,0,0,0
2,201392387,2170660915,22663,36895,2024-10-04 19:31:46,0,0,0,0,0,0
2,201392387,2170660915,49896,36895,2024-10-04 19:31:46,0,0,0,0,0,0
2,201392387,2170660915,0,0,2024-10-04 19:31:46,128,84,212,1,1,2
2,201392387,2170660915,2759,36895,2024-10-04 19:31:46,0,0,0,0,0,0
2,201392387,2170660915,39639,36895,2024-10-04 19:31:47,0,0,0,0,0,0
2,201392387,2170660915,22663,36895,2024-10-04 19:31:47,0,0,0,0,0,0
2,201392387,2170660915,49896,36895,2024-10-04 19:31:47,0,0,0,0,0,0
2,201392387,2170660915,0,0,2024-10-04 19:31:47,128,84,212,1,1,2
2,201392387,2170660915,2759,36895,2024-10-04 19:31:47,0,0,0,0,0,0
2,201392387,2170660915,39639,36895,2024-10-04 19:31:48,0,0,0,0,0,0
2,201392387,2170660915,22663,36895,2024-10-04 19:31:48,0,0,0,0,0,0
2,201392387,2170660915,49896,36895,2024-10-04 19:31:48,0,0,0,0,0,0
2,201392387,2170660915,0,0,2024-10-04 19:31:48,128,84,212,1,1,2
2,201392387,2170660915,2759,36895,2024-10-04 19:31:48,0,0,0,0,0,0
2,201392387,2170660915,39639,36895,2024-10-04 19:31:49,0,0,0,0,0,0
2,201392387,2170660915,22663,36895,2024-10-04 19:31:49,0,0,0,0,0,0
2,201392387,2170660915,49896,36895,2024-10-04 19:31:49,0,0,0,0,0,0
2,201392387,2170660915,0,0,2024-10-04 19:31:49,128,84,212,1,1,2
2,201392387,2170660915,2759,36895,2024-10-04 19:31:49,0,0,0,0,0,0
2,201392387,2170660915,39639,36895,2024-10-04 19:31:50,0,0,0,0,0,0
2,201392387,2170660915,22663,36895,2024-10-04 19:31:50,0,0,0,0,0,0
2,201392387,2170660915,49896,36895,2024-10-04 19:31:50,0,0,0,0,0,0
2,201392387,2170660915,0,0,2024-10-04 19:31:50,128,84,212,1,1,2
2,201392387,2170660915,2759,36895,2024-10-04 19:31:50,0,0,0,0,0,0
2,201392387,2170660915,39639,36895,2024-10-04 19:31:51,0,0,0,0,0,0
2,201392387,2170660915,22663,36895,2024-10-04 19:31:51,0,0,0,0,0,0
2,201392387,2170660915,0,0,2024-10-04 19:31:51,128,84,212,1,1,2
2,201392387,2170660915,2759,36895,2024-10-04 19:31:51,0,0,0,0,0,0
2,201392387,2170660915,39639,36895,2024-10-04 19:31:52,0,0,0,0,0,0
2,201392387,2170660915,22663,36895,2024-10-04 19:31:52,0,0,0,0,0,0
2,201392387,2170660915,0,0,2024-10-04 19:31:52,0,0,0,0,0,0
2,201392387,2170660915,2759,36895,2024-10-04 19:31:52,0,0,0,0,0,0
2,201392387,2170660915,39639,36895,2024-10-04 19:31:53,0,0,0,0,0,0
2,201392387,2170660915,22663,36895,2024-10-04 19:31:53,0,0,0,0,0,0
2,201392387,2170660915,60571,36895,2024-10-04 19:31:53,666,507,1173,6,6,12
2,201392387,2170660915,0,0,2024-10-04 19:31:53,0,0,0,0,0,0
2,201392387,2170660915,2759,36895,2024-10-04 19:31:53,0,0,0,0,0,0
2,201392387,2170660915,39639,36895,2024-10-04 19:31:54,0,0,0,0,0,0
2,201392387,2170660915,22663,36895,2024-10-04 19:31:54,0,0,0,0,0,0
2,201392387,2170660915,60571,36895,2024-10-04 19:31:54,0,0,0,0,0,0
2,201392387,2170660915,0,0,2024-10-04 19:31:54,256,168,424,2,2,4
2,201392387,2170660915,2759,36895,2024-10-04 19:31:54,0,0,0,0,0,0
2,201392387,2170660915,39639,36895,2024-10-04 19:31:55,0,0,0,0,0,0
2,201392387,2170660915,22663,36895,2024-10-04 19:31:55,0,0,0,0,0,0
2,201392387,2170660915,60571,36895,2024-10-04 19:31:55,0,0,0,0,0,0
2,201392387,2170660915,0,0,2024-10-04 19:31:55,128,84,212,1,1,2
2,201392387,2170660915,2759,36895,2024-10-04 19:31:55,0,0,0,0,0,0
2,201392387,2170660915,39639,36895,2024-10-04 19:31:56,0,0,0,0,0,0
2,201392387,2170660915,22663,36895,2024-10-04 19:31:56,0,0,0,0,0,0
2,201392387,2170660915,60571,36895,2024-10-04 19:31:56,0,0,0,0,0,0
2,201392387,2170660915,0,0,2024-10-04 19:31:56,0,0,0,0,0,0
2,201392387,2170660915,2759,36895,2024-10-04 19:31:56,0,0,0,0,0,0
2,201392387,2170660915,39639,36895,2024-10-04 19:31:57,0,0,0,0,0,0
2,201392387,2170660915,22663,36895,2024-10-04 19:31:57,0,0,0,0,0,0
2,201392387,2170660915,60571,36895,2024-10-04 19:31:57,0,0,0,0,0,0
2,201392387,2170660915,0,0,2024-10-04 19:31:57,0,0,0,0,0,0
2,201392387,2170660915,2759,36895,2024-10-04 19:31:57,0,0,0,0,0,0
2,201392387,2170660915,39639,36895,2024-10-04 19:31:58,0,0,0,0,0,0
2,201392387,2170660915,22663,36895,2024-10-04 19:31:58,0,0,0,0,0,0
2,201392387,2170660915,60571,36895,2024-10-04 19:31:58,0,0,0,0,0,0
2,201392387,2170660915,0,0,2024-10-04 19:31:58,0,0,0,0,0,0
2,201392387,2170660915,2759,36895,2024-10-04 19:31:58,0,0,0,0,0,0
2,201392387,2170660915,39639,36895,2024-10-04 19:31:59,0,0,0,0,0,0
2,201392387,2170660915,22663,36895,2024-10-04 19:31:59,0,0,0,0,0,0
2,201392387,2170660915,60571,36895,2024-10-04 19:31:59,0,0,0,0,0,0
2,201392387,2170660915,0,0,2024-10-04 19:31:59,128,84,212,1,1,2
2,201392387,2170660915,2759,36895,2024-10-04 19:31:59,0,0,0,0,0,0
2,201392387,2170660915,39639,36895,2024-10-04 19:32:00,0,0,0,0,0,0
2,201392387,2170660915,22663,36895,2024-10-04 19:32:00,0,0,0,0,0,0
2,201392387,2170660915,60571,36895,2024-10-04 19:32:00,0,0,0,0,0,0
2,201392387,2170660915,0,0,2024-10-04 19:32:00,0,0,0,0,0,0
2,201392387,2170660915,2759,36895,2024-10-04 19:32:00,0,0,0,0,0,0
2,201392387,2170660915,39639,36895,2024-10-04 19:32:01,0,0,0,0,0,0
2,201392387,2170660915,22663,36895,2024-10-04 19:32:01,0,0,0,0,0,0
2,201392387,2170660915,60571,36895,2024-10-04 19:32:01,0,0,0,0,0,0
2,201392387,1145490689,62100,47873,2024-10-04 19:32:01,2424,20781,23205,16,23,39
2,201392387,2170660915,0,0,2024-10-04 19:32:01,256,168,424,2,2,4
2,201392387,2170660915,2759,36895,2024-10-04 19:32:01,0,0,0,0,0,0
2,201392387,2170660915,39639,36895,2024-10-04 19:32:02,0,0,0,0,0,0
2,201392387,2170660915,22663,36895,2024-10-04 19:32:02,0,0,0,0,0,0
2,201392387,2170660915,60571,36895,2024-10-04 19:32:02,0,0,0,0,0,0
2,201392387,1145490689,62100,47873,2024-10-04 19:32:02,0,0,0,0,0,0
2,201392387,2170660915,0,0,2024-10-04 19:32:02,0,0,0,0,0,0
2,201392387,2170660915,2759,36895,2024-10-04 19:32:02,0,0,0,0,0,0
2,201392387,2170660915,39639,36895,2024-10-04 19:32:03,0,0,0,0,0,0
2,201392387,2170660915,22663,36895,2024-10-04 19:32:03,0,0,0,0,0,0
2,201392387,2170660915,60571,36895,2024-10-04 19:32:03,0,0,0,0,0,0
2,201392387,1145490689,62100,47873,2024-10-04 19:32:03,0,0,0,0,0,0
2,201392387,2170660915,0,0,2024-10-04 19:32:03,0,0,0,0,0,0
2,201392387,2170660915,2759,36895,2024-10-04 19:32:03,0,0,0,0,0,0
2,201392387,2170660915,39639,36895,2024-10-04 19:32:04,0,0,0,0,0,0
2,201392387,2170660915,22663,36895,2024-10-04 19:32:04,0,0,0,0,0,0
2,201392387,2170660915,60571,36895,2024-10-04 19:32:04,0,0,0,0,0,0
2,201392387,1145490689,62100,47873,2024-10-04 19:32:04,0,0,0,0,0,0
2,201392387,2170660915,0,0,2024-10-04 19:32:04,0,0,0,0,0,0
2,201392387,2170660915,2759,36895,2024-10-04 19:32:04,0,0,0,0,0,0
2,201392387,2170660915,39639,36895,2024-10-04 19:32:05,0,0,0,0,0,0
2,201392387,2170660915,22663,36895,2024-10-04 19:32:05,0,0,0,0,0,0
2,201392387,2170660915,60571,36895,2024-10-04 19:32:05,0,0,0,0,0,0
2,201392387,1145490689,62100,47873,2024-10-04 19:32:05,0,0,0,0,0,0
2,201392387,2170660915,0,0,2024-10-04 19:32:05,0,0,0,0,0,0
2,201392387,2170660915,2759,36895,2024-10-04 19:32:05,0,0,0,0,0,0
2,201392387,2170660915,39639,36895,2024-10-04 19:32:06,0,0,0,0,0,0
2,201392387,2170660915,22663,36895,2024-10-04 19:32:06,0,0,0,0,0,0
2,201392387,2170660915,60571,36895,2024-10-04 19:32:06,0,0,0,0,0,0
2,201392387,1145490689,62100,47873,2024-10-04 19:32:06,3756,76383,80139,37,52,89
2,201392387,2170660915,0,0,2024-10-04 19:32:06,0,0,0,0,0,0
2,201392387,2170660915,2759,36895,2024-10-04 19:32:06,0,0,0,0,0,0
2,201392387,2170660915,39639,36895,2024-10-04 19:32:07,0,0,0,0,0,0
2,201392387,2170660915,22663,36895,2024-10-04 19:32:07,0,0,0,0,0,0
2,201392387,2170660915,60571,36895,2024-10-04 19:32:07,0,0,0,0,0,0
2,201392387,1145490689,62100,47873,2024-10-04 19:32:07,0,0,0,0,0,0
2,201392387,2170660915,0,0,2024-10-04 19:32:07,0,0,0,0,0,0
2,201392387,2170660915,2759,36895,2024-10-04 19:32:07,0,0,0,0,0,0
2,201392387,2170660915,39639,36895,2024-10-04 19:32:08,0,0,0,0,0,0
2,201392387,2170660915,22663,36895,2024-10-04 19:32:08,0,0,0,0,0,0
2,201392387,2170660915,60571,36895,2024-10-04 19:32:08,0,0,0,0,0,0
2,201392387,1145490689,62100,47873,2024-10-04 19:32:08,0,0,0,0,0,0
2,201392387,2170660915,0,0,2024-10-04 19:32:08,0,0,0,0,0,0
2,201392387,2170660915,2759,36895,2024-10-04 19:32:08,0,0,0,0,0,0
2,201392387,2170660915,39639,36895,2024-10-04 19:32:09,0,0,0,0,0,0
2,201392387,2170660915,22663,36895,2024-10-04 19:32:09,0,0,0,0,0,0
2,201392387,2170660915,60571,36895,2024-10-04 19:32:09,0,0,0,0,0,0
2,201392387,1145490689,62100,47873,2024-10-04 19:32:09,0,0,0,0,0,0
2,201392387,2170660915,0,0,2024-10-04 19:32:09,0,0,0,0,0,0
2,201392387,2170660915,2759,36895,2024-10-04 19:32:09,0,0,0,0,0,0
2,201392387,2170660915,39639,36895,2024-10-04 19:32:10,0,0,0,0,0,0
2,201392387,2170660915,22663,36895,2024-10-04 19:32:10,0,0,0,0,0,0
2,201392387,2170660915,60571,36895,2024-10-04 19:32:10,0,0,0,0,0,0
2,201392387,1145490689,62100,47873,2024-10-04 19:32:10,0,0,0,0,0,0
2,201392387,2170660915,0,0,2024-10-04 19:32:10,0,0,0,0,0,0
2,201392387,2170660915,2759,36895,2024-10-04 19:32:10,0,0,0,0,0,0
2,201392387,2170660915,39639,36895,2024-10-04 19:32:11,0,0,0,0,0,0
2,201392387,2170660915,22663,36895,2024-10-04 19:32:11,0,0,0,0,0,0
2,201392387,2170660915,60571,36895,2024-10-04 19:32:11,0,0,0,0,0,0
2,201392387,1145490689,62100,47873,2024-10-04 19:32:11,0,0,0,0,0,0
2,201392387,2170660915,0,0,2024-10-04 19:32:11,0,0,0,0,0,0
2,201392387,2170660915,2759,36895,2024-10-04 19:32:11,0,0,0,0,0,0
2,201392387,2170660915,39639,36895,2024-10-04 19:32:12,0,0,0,0,0,0
2,201392387,2170660915,22663,36895,2024-10-04 19:32:12,0,0,0,0,0,0
2,201392387,2170660915,60571,36895,2024-10-04 19:32:12,0,0,0,0,0,0
2,201392387,1145490689,62100,47873,2024-10-04 19:32:12,0,0,0,0,0,0
2,201392387,2170660915,0,0,2024-10-04 19:32:12,0,0,0,0,0,0
2,201392387,2170660915,2759,36895,2024-10-04 19:32:12,0,0,0,0,0,0
2,201392387,2170660915,39639,36895,2024-10-04 19:32:13,0,0,0,0,0,0
2,201392387,2170660915,22663,36895,2024-10-04 19:32:13,0,0,0,0,0,0
2,201392387,2170660915,60571,36895,2024-10-04 19:32:13,0,0,0,0,0,0
2,201392387,1145490689,62100,47873,2024-10-04 19:32:13,0,0,0,0,0,0
2,201392387,2170660915,0,0,2024-10-04 19:32:13,128,84,212,1,1,2
2,201392387,2170660915,2759,36895,2024-10-04 19:32:13,0,0,0,0,0,0
2,201392387,2170660915,39639,36895,2024-10-04 19:32:14,0,0,0,0,0,0
2,201392387,2170660915,22663,36895,2024-10-04 19:32:14,0,0,0,0,0,0
2,201392387,2170660915,60571,36895,2024-10-04 19:32:14,0,0,0,0,0,0
2,201392387,1145490689,62100,47873,2024-10-04 19:32:14,0,0,0,0,0,0
2,201392387,2170660915,0,0,2024-10-04 19:32:14,128,84,212,1,1,2
2,201392387,2170660915,2759,36895,2024-10-04 19:32:14,0,0,0,0,0,0
2,201392387,2170660915,39639,36895,2024-10-04 19:32:15,0,0,0,0,0,0
2,201392387,2170660915,22663,36895,2024-10-04 19:32:15,0,0,0,0,0,0
2,201392387,2170660915,60571,36895,2024-10-04 19:32:15,0,0,0,0,0,0
2,201392387,1145490689,62100,47873,2024-10-04 19:32:15,0,0,0,0,0,0
2,201392387,2170660915,0,0,2024-10-04 19:32:15,128,84,212,1,1,2
2,201392387,2170660915,2759,36895,2024-10-04 19:32:15,0,0,0,0,0,0
2,201392387,2170660915,39639,36895,2024-10-04 19:32:16,0,0,0,0,0,0
2,201392387,2170660915,22663,36895,2024-10-04 19:32:16,0,0,0,0,0,0
2,201392387,2170660915,60571,36895,2024-10-04 19:32:16,0,0,0,0,0,0
2,201392387,2170660915,0,0,2024-10-04 19:32:16,128,84,212,1,1,2
2,201392387,2170660915,2759,36895,2024-10-04 19:32:16,0,0,0,0,0,0
2,201392387,2170660915,39639,36895,2024-10-04 19:32:17,0,0,0,0,0,0
2,201392387,2170660915,22663,36895,2024-10-04 19:32:17,0,0,0,0,0,0
2,201392387,2170660915,60571,36895,2024-10-04 19:32:17,0,0,0,0,0,0
2,201392387,2170660915,0,0,2024-10-04 19:32:17,128,84,212,1,1,2
2,201392387,2170660915,2759,36895,2024-10-04 19:32:17,0,0,0,0,0,0
2,201392387,2170660915,39639,36895,2024-10-04 19:32:18,0,0,0,0,0,0
2,201392387,2170660915,22663,36895,2024-10-04 19:32:18,0,0,0,0,0,0
2,201392387,2170660915,60571,36895,2024-10-04 19:32:18,0,0,0,0,0,0
2,201392387,2170660915,0,0,2024-10-04 19:32:18,128,84,212,1,1,2
2,201392387,2170660915,2759,36895,2024-10-04 19:32:18,0,0,0,0,0,0
2,201392387,2170660915,39639,36895,2024-10-04 19:32:19,0,0,0,0,0,0
2,201392387,2170660915,22663,36895,2024-10-04 19:32:19,0,0,0,0,0,0
2,201392387,2170660915,60571,36895,2024-10-04 19:32:19,0,0,0,0,0,0
2,201392387,2170660915,0,0,2024-10-04 19:32:19,128,84,212,1,1,2
2,201392387,2170660915,2759,36895,2024-10-04 19:32:19,0,0,0,0,0,0
2,201392387,2170660915,39639,36895,2024-10-04 19:32:20,0,0,0,0,0,0
2,201392387,2170660915,22663,36895,2024-10-04 19:32:20,0,0,0,0,0,0
2,201392387,2170660915,60571,36895,2024-10-04 19:32:20,0,0,0,0,0,0
2,201392387,2170660915,0,0,2024-10-04 19:32:20,256,84,340,2,1,3
2,201392387,2170660915,2759,36895,2024-10-04 19:32:20,0,0,0,0,0,0
2,201392387,2170660915,39639,36895,2024-10-04 19:32:21,0,0,0,0,0,0
2,201392387,2170660915,22663,36895,2024-10-04 19:32:21,0,0,0,0,0,0
2,201392387,2170660915,60571,36895,2024-10-04 19:32:21,0,0,0,0,0,0
2,201392387,2170660915,0,0,2024-10-04 19:32:21,128,84,212,1,1,2
2,201392387,2170660915,2759,36895,2024-10-04 19:32:21,0,0,0,0,0,0
2,201392387,2170660915,39639,36895,2024-10-04 19:32:22,0,0,0,0,0,0
2,201392387,2170660915,22663,36895,2024-10-04 19:32:22,0,0,0,0,0,0
2,201392387,2170660915,60571,36895,2024-10-04 19:32:22,0,0,0,0,0,0
2,201392387,2170660915,0,0,2024-10-04 19:32:22,0,84,84,0,1,1
2,201392387,2170660915,2759,36895,2024-10-04 19:32:22,0,0,0,0,0,0
2,201392387,2170660915,39639,36895,2024-10-04 19:32:23,0,0,0,0,0,0
2,201392387,2170660915,22663,36895,2024-10-04 19:32:23,0,0,0,0,0,0
2,201392387,2170660915,14991,36895,2024-10-04 19:32:23,666,507,1173,6,6,12
2,201392387,2170660915,0,0,2024-10-04 19:32:23,0,0,0,0,0,0
2,201392387,2170660915,2759,36895,2024-10-04 19:32:23,0,0,0,0,0,0
2,201392387,2170660915,39639,36895,2024-10-04 19:32:24,0,0,0,0,0,0
2,201392387,2170660915,22663,36895,2024-10-04 19:32:24,0,0,0,0,0,0
2,201392387,2170660915,14991,36895,2024-10-04 19:32:24,0,0,0,0,0,0
2,201392387,2170660915,0,0,2024-10-04 19:32:24,128,84,212,1,1,2
2,201392387,2170660915,2759,36895,2024-10-04 19:32:24,0,0,0,0,0,0
2,201392387,2170660915,39639,36895,2024-10-04 19:32:25,0,0,0,0,0,0
2,201392387,2170660915,22663,36895,2024-10-04 19:32:25,0,0,0,0,0,0
2,201392387,2170660915,14991,36895,2024-10-04 19:32:25,0,0,0,0,0,0
2,201392387,2170660915,0,0,2024-10-04 19:32:25,128,0,128,1,0,1
2,201392387,2170660915,2759,36895,2024-10-04 19:32:25,0,0,0,0,0,0
2,201392387,2170660915,39639,36895,2024-10-04 19:32:26,0,0,0,0,0,0
2,201392387,2170660915,22663,36895,2024-10-04 19:32:26,0,0,0,0,0,0
2,201392387,2170660915,14991,36895,2024-10-04 19:32:26,0,0,0,0,0,0
2,201392387,2170660915,0,0,2024-10-04 19:32:26,128,84,212,1,1,2
2,201392387,2170660915,2759,36895,2024-10-04 19:32:26,0,0,0,0,0,0
2,201392387,2170660915,39639,36895,2024-10-04 19:32:27,0,0,0,0,0,0
2,201392387,2170660915,22663,36895,2024-10-04 19:32:27,0,0,0,0,0,0
2,201392387,2170660915,14991,36895,2024-10-04 19:32:27,0,0,0,0,0,0
2,201392387,2170660915,0,0,2024-10-04 19:32:27,0,0,0,0,0,0
2,201392387,2170660915,2759,36895,2024-10-04 19:32:27,0,0,0,0,0,0
2,201392387,2170660915,39639,36895,2024-10-04 19:32:28,0,0,0,0,0,0
2,201392387,2170660915,22663,36895,2024-10-04 19:32:28,0,0,0,0,0,0
2,201392387,2170660915,14991,36895,2024-10-04 19:32:28,0,0,0,0,0,0
2,201392387,2170660915,0,0,2024-10-04 19:32:28,0,84,84,0,1,1
2,201392387,2170660915,2759,36895,2024-10-04 19:32:28,0,0,0,0,0,0
2,201392387,2170660915,39639,36895,2024-10-04 19:32:29,0,0,0,0,0,0
2,201392387,2170660915,22663,36895,2024-10-04 19:32:29,0,0,0,0,0,0
2,201392387,2170660915,14991,36895,2024-10-04 19:32:29,0,0,0,0,0,0
2,201392387,2170660915,0,0,2024-10-04 19:32:29,0,0,0,0,0,0
2,201392387,2170660915,2759,36895,2024-10-04 19:32:29,0,0,0,0,0,0
2,201392387,2170660915,39639,36895,2024-10-04 19:32:30,0,0,0,0,0,0
2,201392387,2170660915,22663,36895,2024-10-04 19:32:30,0,0,0,0,0,0
2,201392387,2170660915,14991,36895,2024-10-04 19:32:30,0,0,0,0,0,0
2,201392387,2170660915,0,0,2024-10-04 19:32:30,0,0,0,0,0,0
2,201392387,2170660915,2759,36895,2024-10-04 19:32:30,0,0,0,0,0,0
2,201392387,2170660915,39639,36895,2024-10-04 19:32:31,0,0,0,0,0,0
2,201392387,2170660915,22663,36895,2024-10-04 19:32:31,0,0,0,0,0,0
2,201392387,2170660915,14991,36895,2024-10-04 19:32:31,0,0,0,0,0,0
2,201392387,2170660915,0,0,2024-10-04 19:32:31,256,84,340,2,1,3
2,201392387,2170660915,2759,36895,2024-10-04 19:32:31,0,0,0,0,0,0
2,201392387,2170660915,39639,36895,2024-10-04 19:32:32,0,0,0,0,0,0
2,201392387,2170660915,22663,36895,2024-10-04 19:32:32,0,0,0,0,0,0
2,201392387,2170660915,14991,36895,2024-10-04 19:32:32,0,0,0,0,0,0
2,201392387,1145490689,60133,47873,2024-10-04 19:32:32,2412,22201,24613,16,24,40
2,201392387,2170660915,0,0,2024-10-04 19:32:32,128,168,296,1,2,3
2,201392387,2170660915,2759,36895,2024-10-04 19:32:32,0,0,0,0,0,0
2,201392387,2170660915,39639,36895,2024-10-04 19:32:33,0,0,0,0,0,0
2,201392387,2170660915,22663,36895,2024-10-04 19:32:33,0,0,0,0,0,0
2,201392387,2170660915,14991,36895,2024-10-04 19:32:33,0,0,0,0,0,0
2,201392387,1145490689,60133,47873,2024-10-04 19:32:33,0,0,0,0,0,0
2,201392387,2170660915,0,0,2024-10-04 19:32:33,0,0,0,0,0,0
2,201392387,2170660915,2759,36895,2024-10-04 19:32:33,0,0,0,0,0,0
2,201392387,2170660915,39639,36895,2024-10-04 19:32:34,0,0,0,0,0,0
2,201392387,2170660915,22663,36895,2024-10-04 19:32:34,0,0,0,0,0,0
2,201392387,2170660915,14991,36895,2024-10-04 19:32:34,0,0,0,0,0,0
2,201392387,1145490689,60133,47873,2024-10-04 19:32:34,0,0,0,0,0,0
2,201392387,2170660915,0,0,2024-10-04 19:32:34,0,0,0,0,0,0
2,201392387,2170660915,2759,36895,2024-10-04 19:32:34,0,0,0,0,0,0
2,201392387,2170660915,39639,36895,2024-10-04 19:32:35,0,0,0,0,0,0
2,201392387,2170660915,22663,36895,2024-10-04 19:32:35,0,0,0,0,0,0
2,201392387,2170660915,14991,36895,2024-10-04 19:32:35,0,0,0,0,0,0
2,201392387,1145490689,60133,47873,2024-10-04 19:32:35,3576,68965,72541,35,50,85
2,201392387,2170660915,0,0,2024-10-04 19:32:35,0,0,0,0,0,0
2,201392387,2170660915,2759,36895,2024-10-04 19:32:35,0,0,0,0,0,0
2,201392387,2170660915,39639,36895,2024-10-04 19:32:36,0,0,0,0,0,0
2,201392387,2170660915,22663,36895,2024-10-04 19:32:36,0,0,0,0,0,0
2,201392387,2170660915,14991,36895,2024-10-04 19:32:36,0,0,0,0,0,0
2,201392387,1145490689,60133,47873,2024-10-04 19:32:36,0,0,0,0,0,0
2,201392387,2170660915,0,0,2024-10-04 19:32:36,0,0,0,0,0,0
2,201392387,2170660915,2759,36895,2024-10-04 19:32:36,0,0,0,0,0,0
2,201392387,2170660915,39639,36895,2024-10-04 19:32:37,0,0,0,0,0,0
2,201392387,2170660915,22663,36895,2024-10-04 19:32:37,0,0,0,0,0,0
2,201392387,2170660915,14991,36895,2024-10-04 19:32:37,0,0,0,0,0,0
2,201392387,1145490689,60133,47873,2024-10-04 19:32:37,0,0,0,0,0,0
2,201392387,2170660915,0,0,2024-10-04 19:32:37,0,0,0,0,0,0
2,201392387,2170660915,2759,36895,2024-10-04 19:32:37,0,0,0,0,0,0
2,201392387,2170660915,39639,36895,2024-10-04 19:32:38,0,0,0,0,0,0
2,201392387,2170660915,22663,36895,2024-10-04 19:32:38,0,0,0,0,0,0
2,201392387,2170660915,14991,36895,2024-10-04 19:32:38,0,0,0,0,0,0
2,201392387,1145490689,60133,47873,2024-10-04 19:32:38,0,0,0,0,0,0
2,201392387,2170660915,0,0,2024-10-04 19:32:38,0,0,0,0,0,0
2,201392387,2170660915,2759,36895,2024-10-04 19:32:38,0,0,0,0,0,0
2,201392387,2170660915,39639,36895,2024-10-04 19:32:39,0,0,0,0,0,0
2,201392387,2170660915,22663,36895,2024-10-04 19:32:39,0,0,0,0,0,0
2,201392387,2170660915,14991,36895,2024-10-04 19:32:39,0,0,0,0,0,0
2,201392387,1145490689,60133,47873,2024-10-04 19:32:39,0,0,0,0,0,0
2,201392387,2170660915,0,0,2024-10-04 19:32:39,0,0,0,0,0,0
2,201392387,2170660915,2759,36895,2024-10-04 19:32:39,0,0,0,0,0,0
2,201392387,2170660915,39639,36895,2024-10-04 19:32:40,0,0,0,0,0,0
2,201392387,2170660915,22663,36895,2024-10-04 19:32:40,0,0,0,0,0,0
2,201392387,2170660915,14991,36895,2024-10-04 19:32:40,0,0,0,0,0,0
2,201392387,1145490689,60133,47873,2024-10-04 19:32:40,0,0,0,0,0,0
2,201392387,2170660915,0,0,2024-10-04 19:32:40,0,0,0,0,0,0
2,201392387,2170660915,2759,36895,2024-10-04 19:32:40,0,0,0,0,0,0
2,201392387,2170660915,39639,36895,2024-10-04 19:32:41,0,0,0,0,0,0
2,201392387,2170660915,22663,36895,2024-10-04 19:32:41,0,0,0,0,0,0
2,201392387,2170660915,14991,36895,2024-10-04 19:32:41,0,0,0,0,0,0
2,201392387,1145490689,60133,47873,2024-10-04 19:32:41,0,0,0,0,0,0
2,201392387,2170660915,0,0,2024-10-04 19:32:41,0,0,0,0,0,0
2,201392387,2170660915,2759,36895,2024-10-04 19:32:41,0,0,0,0,0,0
2,201392387,2170660915,39639,36895,2024-10-04 19:32:42,0,0,0,0,0,0
2,201392387,2170660915,22663,36895,2024-10-04 19:32:42,0,0,0,0,0,0
2,201392387,2170660915,14991,36895,2024-10-04 19:32:42,0,0,0,0,0,0
2,201392387,1145490689,60133,47873,2024-10-04 19:32:42,0,0,0,0,0,0
2,201392387,2170660915,0,0,2024-10-04 19:32:42,0,0,0,0,0,0
2,201392387,2170660915,2759,36895,2024-10-04 19:32:42,0,0,0,0,0,0
2,201392387,2170660915,39639,36895,2024-10-04 19:32:43,0,0,0,0,0,0
2,201392387,2170660915,22663,36895,2024-10-04 19:32:43,0,0,0,0,0,0
2,201392387,2170660915,14991,36895,2024-10-04 19:32:43,0,0,0,0,0,0
2,201392387,1145490689,60133,47873,2024-10-04 19:32:43,0,0,0,0,0,0
2,201392387,2170660915,0,0,2024-10-04 19:32:43,128,84,212,1,1,2
2,201392387,2170660915,2759,36895,2024-10-04 19:32:43,0,0,0,0,0,0
2,201392387,2170660915,39639,36895,2024-10-04 19:32:44,0,0,0,0,0,0
2,201392387,2170660915,22663,36895,2024-10-04 19:32:44,0,0,0,0,0,0
2,201392387,2170660915,14991,36895,2024-10-04 19:32:44,0,0,0,0,0,0
2,201392387,1145490689,60133,47873,2024-10-04 19:32:44,0,0,0,0,0,0
2,201392387,2170660915,0,0,2024-10-04 19:32:44,128,84,212,1,1,2
2,201392387,2170660915,2759,36895,2024-10-04 19:32:44,0,0,0,0,0,0
2,201392387,2170660915,39639,36895,2024-10-04 19:32:45,0,0,0,0,0,0
2,201392387,2170660915,22663,36895,2024-10-04 19:32:45,0,0,0,0,0,0
2,201392387,2170660915,14991,36895,2024-10-04 19:32:45,0,0,0,0,0,0
2,201392387,2170660915,0,0,2024-10-04 19:32:45,128,84,212,1,1,2
2,201392387,2170660915,2759,36895,2024-10-04 19:32:45,0,0,0,0,0,0
2,201392387,2170660915,39639,36895,2024-10-04 19:32:46,0,0,0,0,0,0
2,201392387,2170660915,22663,36895,2024-10-04 19:32:46,0,0,0,0,0,0
2,201392387,2170660915,14991,36895,2024-10-04 19:32:46,0,0,0,0,0,0
2,201392387,2170660915,0,0,2024-10-04 19:32:46,128,84,212,1,1,2
2,201392387,2170660915,2759,36895,2024-10-04 19:32:46,0,0,0,0,0,0
2,201392387,2170660915,39639,36895,2024-10-04 19:32:47,0,0,0,0,0,0
2,201392387,2170660915,22663,36895,2024-10-04 19:32:47,0,0,0,0,0,0
2,201392387,2170660915,14991,36895,2024-10-04 19:32:47,0,0,0,0,0,0
2,201392387,2170660915,0,0,2024-10-04 19:32:47,128,84,212,1,1,2
2,201392387,2170660915,2759,36895,2024-10-04 19:32:47,0,0,0,0,0,0
2,201392387,2170660915,39639,36895,2024-10-04 19:32:48,0,0,0,0,0,0
2,201392387,2170660915,22663,36895,2024-10-04 19:32:48,0,0,0,0,0,0
2,201392387,2170660915,14991,36895,2024-10-04 19:32:48,0,0,0,0,0,0
2,201392387,2170660915,0,0,2024-10-04 19:32:48,128,84,212,1,1,2
2,201392387,2170660915,2759,36895,2024-10-04 19:32:48,0,0,0,0,0,0
2,201392387,2170660915,39639,36895,2024-10-04 19:32:49,0,0,0,0,0,0
2,201392387,2170660915,22663,36895,2024-10-04 19:32:49,0,0,0,0,0,0
2,201392387,2170660915,14991,36895,2024-10-04 19:32:49,0,0,0,0,0,0
2,201392387,2170660915,0,0,2024-10-04 19:32:49,128,84,212,1,1,2
2,201392387,2170660915,2759,36895,2024-10-04 19:32:49,0,0,0,0,0,0
2,201392387,2170660915,39639,36895,2024-10-04 19:32:50,0,0,0,0,0,0
2,201392387,2170660915,22663,36895,2024-10-04 19:32:50,0,0,0,0,0,0
2,201392387,2170660915,14991,36895,2024-10-04 19:32:50,0,0,0,0,0,0
2,201392387,2170660915,0,0,2024-10-04 19:32:50,128,84,212,1,1,2
2,201392387,2170660915,2759,36895,2024-10-04 19:32:50,0,0,0,0,0,0
2,201392387,2170660915,39639,36895,2024-10-04 19:32:51,0,0,0,0,0,0
2,201392387,2170660915,22663,36895,2024-10-04 19:32:51,0,0,0,0,0,0
2,201392387,2170660915,14991,36895,2024-10-04 19:32:51,0,0,0,0,0,0
2,201392387,2170660915,0,0,2024-10-04 19:32:51,0,0,0,0,0,0
2,201392387,2170660915,2759,36895,2024-10-04 19:32:51,0,0,0,0,0,0
2,201392387,2170660915,39639,36895,2024-10-04 19:32:52,0,0,0,0,0,0
2,201392387,2170660915,22663,36895,2024-10-04 19:32:52,0,0,0,0,0,0
2,201392387,2170660915,14991,36895,2024-10-04 19:32:52,0,0,0,0,0,0
2,201392387,2170660915,0,0,2024-10-04 19:32:52,128,84,212,1,1,2
2,201392387,2170660915,2759,36895,2024-10-04 19:32:52,0,0,0,0,0,0
2,201392387,2170660915,39639,36895,2024-10-04 19:32:53,0,0,0,0,0,0
2,201392387,2170660915,22663,36895,2024-10-04 19:32:53,0,0,0,0,0,0
2,201392387,2170660915,14991,36895,2024-10-04 19:32:53,0,0,0,0,0,0
2,201392387,2170660915,0,0,2024-10-04 19:32:53,128,84,212,1,1,2
2,201392387,2170660915,2759,36895,2024-10-04 19:32:53,0,0,0,0,0,0
2,201392387,2170660915,39639,36895,2024-10-04 19:32:54,0,0,0,0,0,0
2,201392387,2170660915,22663,36895,2024-10-04 19:32:54,0,0,0,0,0,0
2,201392387,2170660915,14991,36895,2024-10-04 19:32:54,0,0,0,0,0,0
2,201392387,2170660915,0,0,2024-10-04 19:32:54,0,0,0,0,0,0
2,201392387,2170660915,2759,36895,2024-10-04 19:32:54,0,0,0,0,0,0
2,201392387,2170660915,39639,36895,2024-10-04 19:32:55,0,0,0,0,0,0
2,201392387,2170660915,58579,36895,2024-10-04 19:32:55,666,507,1173,6,6,12
2,201392387,2170660915,22663,36895,2024-10-04 19:32:55,0,0,0,0,0,0
2,201392387,2170660915,0,0,2024-10-04 19:32:55,128,84,212,1,1,2
2,201392387,2170660915,2759,36895,2024-10-04 19:32:55,0,0,0,0,0,0
2,201392387,2170660915,39639,36895,2024-10-04 19:32:56,0,0,0,0,0,0
2,201392387,2170660915,58579,36895,2024-10-04 19:32:56,0,0,0,0,0,0
2,201392387,2170660915,22663,36895,2024-10-04 19:32:56,0,0,0,0,0,0
2,201392387,2170660915,0,0,2024-10-04 19:32:56,128,84,212,1,1,2
2,201392387,2170660915,2759,36895,2024-10-04 19:32:56,0,0,0,0,0,0
2,201392387,2170660915,39639,36895,2024-10-04 19:32:57,0,0,0,0,0,0
2,201392387,2170660915,58579,36895,2024-10-04 19:32:57,0,0,0,0,0,0
2,201392387,2170660915,22663,36895,2024-10-04 19:32:57,0,0,0,0,0,0
2,201392387,2170660915,0,0,2024-10-04 19:32:57,128,84,212,1,1,2
2,201392387,2170660915,2759,36895,2024-10-04 19:32:57,0,0,0,0,0,0
2,201392387,2170660915,39639,36895,2024-10-04 19:32:58,0,0,0,0,0,0
2,201392387,2170660915,58579,36895,2024-10-04 19:32:58,0,0,0,0,0,0
2,201392387,2170660915,22663,36895,2024-10-04 19:32:58,0,0,0,0,0,0
2,201392387,2170660915,0,0,2024-10-04 19:32:58,0,0,0,0,0,0
2,201392387,2170660915,2759,36895,2024-10-04 19:32:58,0,0,0,0,0,0
2,201392387,2170660915,39639,36895,2024-10-04 19:32:59,0,0,0,0,0,0
2,201392387,2170660915,58579,36895,2024-10-04 19:32:59,0,0,0,0,0,0
2,201392387,2170660915,22663,36895,2024-10-04 19:32:59,0,0,0,0,0,0
2,201392387,2170660915,0,0,2024-10-04 19:32:59,0,0,0,0,0,0
2,201392387,2170660915,2759,36895,2024-10-04 19:32:59,0,0,0,0,0,0
2,201392387,2170660915,39639,36895,2024-10-04 19:33:00,0,0,0,0,0,0
2,201392387,2170660915,22663,36895,2024-10-04 19:33:00,0,0,0,0,0,0
2,201392387,2170660915,0,0,2024-10-04 19:33:00,0,0,0,0,0,0
2,201392387,2170660915,2759,36895,2024-10-04 19:33:00,0,0,0,0,0,0
2,201392387,2170660915,39639,36895,2024-10-04 19:33:01,0,0,0,0,0,0
2,201392387,2170660915,22663,36895,2024-10-04 19:33:01,0,0,0,0,0,0
2,201392387,2170660915,0,0,2024-10-04 19:33:01,256,84,340,2,1,3
2,201392387,2170660915,2759,36895,2024-10-04 19:33:01,0,0,0,0,0,0
2,201392387,2170660915,39639,36895,2024-10-04 19:33:02,0,0,0,0,0,0
2,201392387,2170660915,22663,36895,2024-10-04 19:33:02,0,0,0,0,0,0
2,201392387,2170660915,0,0,2024-10-04 19:33:02,128,84,212,1,1,2
2,201392387,2170660915,2759,36895,2024-10-04 19:33:02,0,0,0,0,0,0
2,201392387,2170660915,39639,36895,2024-10-04 19:33:03,0,0,0,0,0,0
2,201392387,2170660915,22663,36895,2024-10-04 19:33:03,0,0,0,0,0,0
2,201392387,2170660915,0,0,2024-10-04 19:33:03,0,0,0,0,0,0
2,201392387,2170660915,2759,36895,2024-10-04 19:33:03,0,0,0,0,0,0
2,201392387,2170660915,39639,36895,2024-10-04 19:33:04,0,0,0,0,0,0
2,201392387,2170660915,22663,36895,2024-10-04 19:33:04,0,0,0,0,0,0
2,201392387,2170660915,0,0,2024-10-04 19:33:04,0,0,0,0,0,0
2,201392387,2170660915,2759,36895,2024-10-04 19:33:04,0,0,0,0,0,0
2,201392387,2170660915,39639,36895,2024-10-04 19:33:05,0,0,0,0,0,0
2,201392387,2170660915,22663,36895,2024-10-04 19:33:05,0,0,0,0,0,0
2,201392387,2170660915,0,0,2024-10-04 19:33:05,0,0,0,0,0,0
2,201392387,2170660915,2759,36895,2024-10-04 19:33:05,0,0,0,0,0,0
2,201392387,2170660915,39639,36895,2024-10-04 19:33:06,0,0,0,0,0,0
2,201392387,2170660915,22663,36895,2024-10-04 19:33:06,0,0,0,0,0,0
2,201392387,2170660915,0,0,2024-10-04 19:33:06,0,0,0,0,0,0
2,201392387,2170660915,2759,36895,2024-10-04 19:33:06,0,0,0,0,0,0
2,201392387,2170660915,39639,36895,2024-10-04 19:33:07,0,0,0,0,0,0
2,201392387,2170660915,22663,36895,2024-10-04 19:33:07,0,0,0,0,0,0
2,201392387,1145490689,38056,47873,2024-10-04 19:33:07,6312,93096,99408,54,73,127
2,201392387,2170660915,0,0,2024-10-04 19:33:07,0,84,84,0,1,1
2,201392387,2170660915,2759,36895,2024-10-04 19:33:07,0,0,0,0,0,0
2,201392387,2170660915,39639,36895,2024-10-04 19:33:08,0,0,0,0,0,0
2,201392387,2170660915,22663,36895,2024-10-04 19:33:08,0,0,0,0,0,0
2,201392387,1145490689,38056,47873,2024-10-04 19:33:08,0,0,0,0,0,0
2,201392387,2170660915,0,0,2024-10-04 19:33:08,0,0,0,0,0,0
2,201392387,2170660915,2759,36895,2024-10-04 19:33:08,0,0,0,0,0,0
2,201392387,2170660915,39639,36895,2024-10-04 19:33:09,0,0,0,0,0,0
2,201392387,2170660915,22663,36895,2024-10-04 19:33:09,0,0,0,0,0,0
2,201392387,1145490689,38056,47873,2024-10-04 19:33:09,0,0,0,0,0,0
2,201392387,2170660915,0,0,2024-10-04 19:33:09,0,0,0,0,0,0
2,201392387,2170660915,2759,36895,2024-10-04 19:33:09,0,0,0,0,0,0
2,201392387,2170660915,39639,36895,2024-10-04 19:33:10,0,0,0,0,0,0
2,201392387,2170660915,22663,36895,2024-10-04 19:33:10,0,0,0,0,0,0
2,201392387,1145490689,38056,47873,2024-10-04 19:33:10,0,0,0,0,0,0
2,201392387,2170660915,0,0,2024-10-04 19:33:10,0,0,0,0,0,0
2,201392387,2170660915,2759,36895,2024-10-04 19:33:10,0,0,0,0,0,0
2,201392387,2170660915,39639,36895,2024-10-04 19:33:11,0,0,0,0,0,0
2,201392387,2170660915,22663,36895,2024-10-04 19:33:11,0,0,0,0,0,0
2,201392387,1145490689,38056,47873,2024-10-04 19:33:11,0,0,0,0,0,0
2,201392387,2170660915,0,0,2024-10-04 19:33:11,0,0,0,0,0,0
2,201392387,2170660915,2759,36895,2024-10-04 19:33:11,0,0,0,0,0,0
2,201392387,2170660915,39639,36895,2024-10-04 19:33:12,0,0,0,0,0,0
2,201392387,2170660915,22663,36895,2024-10-04 19:33:12,0,0,0,0,0,0
2,201392387,1145490689,38056,47873,2024-10-04 19:33:12,0,0,0,0,0,0
2,201392387,2170660915,0,0,2024-10-04 19:33:12,0,0,0,0,0,0
2,201392387,2170660915,2759,36895,2024-10-04 19:33:12,0,0,0,0,0,0
2,201392387,2170660915,39639,36895,2024-10-04 19:33:13,0,0,0,0,0,0
2,201392387,2170660915,22663,36895,2024-10-04 19:33:13,0,0,0,0,0,0
2,201392387,1145490689,38056,47873,2024-10-04 19:33:13,0,0,0,0,0,0
2,201392387,2170660915,0,0,2024-10-04 19:33:13,128,84,212,1,1,2
2,201392387,2170660915,2759,36895,2024-10-04 19:33:13,0,0,0,0,0,0
2,201392387,2170660915,39639,36895,2024-10-04 19:33:14,0,0,0,0,0,0
2,201392387,2170660915,22663,36895,2024-10-04 19:33:14,0,0,0,0,0,0
2,201392387,1145490689,38056,47873,2024-10-04 19:33:14,0,0,0,0,0,0
2,201392387,2170660915,0,0,2024-10-04 19:33:14,128,84,212,1,1,2
2,201392387,2170660915,2759,36895,2024-10-04 19:33:14,0,0,0,0,0,0
2,201392387,2170660915,39639,36895,2024-10-04 19:33:15,0,0,0,0,0,0
2,201392387,2170660915,22663,36895,2024-10-04 19:33:15,0,0,0,0,0,0
2,201392387,1145490689,38056,47873,2024-10-04 19:33:15,0,0,0,0,0,0
2,201392387,2170660915,0,0,2024-10-04 19:33:15,128,84,212,1,1,2
2,201392387,2170660915,2759,36895,2024-10-04 19:33:15,0,0,0,0,0,0
2,201392387,2170660915,39639,36895,2024-10-04 19:33:16,0,0,0,0,0,0
2,201392387,2170660915,22663,36895,2024-10-04 19:33:16,0,0,0,0,0,0
2,201392387,1145490689,38056,47873,2024-10-04 19:33:16,0,0,0,0,0,0
2,201392387,2170660915,0,0,2024-10-04 19:33:16,0,0,0,0,0,0
2,201392387,2170660915,2759,36895,2024-10-04 19:33:16,0,0,0,0,0,0
2,201392387,2170660915,39639,36895,2024-10-04 19:33:17,0,0,0,0,0,0
2,201392387,2170660915,22663,36895,2024-10-04 19:33:17,0,0,0,0,0,0
2,201392387,1145490689,38056,47873,2024-10-04 19:33:17,0,0,0,0,0,0
2,201392387,2170660915,0,0,2024-10-04 19:33:17,128,84,212,1,1,2
2,201392387,2170660915,2759,36895,2024-10-04 19:33:17,0,0,0,0,0,0
2,201392387,2170660915,39639,36895,2024-10-04 19:33:18,0,0,0,0,0,0
2,201392387,2170660915,22663,36895,2024-10-04 19:33:18,0,0,0,0,0,0
2,201392387,2170660915,0,0,2024-10-04 19:33:18,128,84,212,1,1,2
2,201392387,2170660915,2759,36895,2024-10-04 19:33:18,0,0,0,0,0,0
2,201392387,2170660915,39639,36895,2024-10-04 19:33:19,0,0,0,0,0,0
2,201392387,2170660915,22663,36895,2024-10-04 19:33:19,0,0,0,0,0,0
2,201392387,2170660915,0,0,2024-10-04 19:33:19,128,84,212,1,1,2
2,201392387,2170660915,2759,36895,2024-10-04 19:33:19,0,0,0,0,0,0
2,201392387,2170660915,39639,36895,2024-10-04 19:33:20,0,0,0,0,0,0
2,201392387,2170660915,22663,36895,2024-10-04 19:33:20,0,0,0,0,0,0
2,201392387,2170660915,0,0,2024-10-04 19:33:20,128,84,212,1,1,2
2,201392387,2170660915,2759,36895,2024-10-04 19:33:20,0,0,0,0,0,0
2,201392387,2170660915,39639,36895,2024-10-04 19:33:21,0,0,0,0,0,0
2,201392387,2170660915,22663,36895,2024-10-04 19:33:21,0,0,0,0,0,0
2,201392387,2170660915,0,0,2024-10-04 19:33:21,256,84,340,2,1,3
2,201392387,2170660915,2759,36895,2024-10-04 19:33:21,0,0,0,0,0,0
2,201392387,2170660915,39639,36895,2024-10-04 19:33:22,0,0,0,0,0,0
2,201392387,2170660915,22663,36895,2024-10-04 19:33:22,0,0,0,0,0,0
2,201392387,2170660915,0,0,2024-10-04 19:33:22,128,84,212,1,1,2
2,201392387,2170660915,2759,36895,2024-10-04 19:33:22,0,0,0,0,0,0
2,201392387,2170660915,39639,36895,2024-10-04 19:33:23,0,0,0,0,0,0
2,201392387,2170660915,22663,36895,2024-10-04 19:33:23,0,0,0,0,0,0
2,201392387,2170660915,0,0,2024-10-04 19:33:23,0,84,84,0,1,1
2,201392387,2170660915,2759,36895,2024-10-04 19:33:23,0,0,0,0,0,0
2,201392387,2170660915,39639,36895,2024-10-04 19:33:24,0,0,0,0,0,0
2,201392387,2170660915,22663,36895,2024-10-04 19:33:24,0,0,0,0,0,0
2,201392387,2170660915,0,0,2024-10-04 19:33:24,0,0,0,0,0,0
2,201392387,2170660915,2759,36895,2024-10-04 19:33:24,0,0,0,0,0,0
2,201392387,2170660915,39639,36895,2024-10-04 19:33:25,0,0,0,0,0,0
2,201392387,2170660915,22663,36895,2024-10-04 19:33:25,0,0,0,0,0,0
2,201392387,2170660915,35989,36895,2024-10-04 19:33:25,666,507,1173,6,6,12
2,201392387,2170660915,0,0,2024-10-04 19:33:25,128,0,128,1,0,1
2,201392387,2170660915,2759,36895,2024-10-04 19:33:25,0,0,0,0,0,0
2,201392387,2170660915,39639,36895,2024-10-04 19:33:26,0,0,0,0,0,0
2,201392387,2170660915,22663,36895,2024-10-04 19:33:26,0,0,0,0,0,0
2,201392387,2170660915,35989,36895,2024-10-04 19:33:26,0,0,0,0,0,0
2,201392387,2170660915,0,0,2024-10-04 19:33:26,128,84,212,1,1,2
2,201392387,2170660915,2759,36895,2024-10-04 19:33:26,0,0,0,0,0,0
2,201392387,2170660915,39639,36895,2024-10-04 19:33:27,0,0,0,0,0,0
2,201392387,2170660915,22663,36895,2024-10-04 19:33:27,0,0,0,0,0,0
2,201392387,2170660915,0,0,2024-10-04 19:33:27,128,168,296,1,2,3
2,201392387,2170660915,2759,36895,2024-10-04 19:33:27,0,0,0,0,0,0
2,201392387,2170660915,39639,36895,2024-10-04 19:33:28,0,0,0,0,0,0
2,201392387,2170660915,22663,36895,2024-10-04 19:33:28,0,0,0,0,0,0
2,201392387,2170660915,0,0,2024-10-04 19:33:28,0,0,0,0,0,0
2,201392387,2170660915,2759,36895,2024-10-04 19:33:28,0,0,0,0,0,0
2,201392387,2170660915,39639,36895,2024-10-04 19:33:29,0,0,0,0,0,0
2,201392387,2170660915,22663,36895,2024-10-04 19:33:29,0,0,0,0,0,0
2,201392387,2170660915,0,0,2024-10-04 19:33:29,0,0,0,0,0,0
2,201392387,2170660915,2759,36895,2024-10-04 19:33:29,0,0,0,0,0,0
2,201392387,2170660915,39639,36895,2024-10-04 19:33:30,0,0,0,0,0,0
2,201392387,2170660915,22663,36895,2024-10-04 19:33:30,0,0,0,0,0,0
2,201392387,2170660915,0,0,2024-10-04 19:33:30,0,0,0,0,0,0
2,201392387,2170660915,2759,36895,2024-10-04 19:33:30,0,0,0,0,0,0
2,201392387,2170660915,39639,36895,2024-10-04 19:33:31,0,0,0,0,0,0
2,201392387,2170660915,22663,36895,2024-10-04 19:33:31,0,0,0,0,0,0
2,201392387,2170660915,0,0,2024-10-04 19:33:31,256,84,340,2,1,3
2,201392387,2170660915,2759,36895,2024-10-04 19:33:31,0,0,0,0,0,0
2,201392387,2170660915,39639,36895,2024-10-04 19:33:32,0,0,0,0,0,0
2,201392387,2170660915,22663,36895,2024-10-04 19:33:32,0,0,0,0,0,0
2,201392387,2170660915,0,0,2024-10-04 19:33:32,128,84,212,1,1,2
2,201392387,2170660915,2759,36895,2024-10-04 19:33:32,0,0,0,0,0,0
2,201392387,2170660915,39639,36895,2024-10-04 19:33:33,0,0,0,0,0,0
2,201392387,2170660915,22663,36895,2024-10-04 19:33:33,0,0,0,0,0,0
2,201392387,1145490689,54476,47873,2024-10-04 19:33:33,5376,93732,99108,45,73,118
2,201392387,2170660915,0,0,2024-10-04 19:33:33,0,84,84,0,1,1
2,201392387,2170660915,2759,36895,2024-10-04 19:33:33,0,0,0,0,0,0
2,201392387,2170660915,39639,36895,2024-10-04 19:33:34,0,0,0,0,0,0
2,201392387,2170660915,22663,36895,2024-10-04 19:33:34,0,0,0,0,0,0
2,201392387,1145490689,54476,47873,2024-10-04 19:33:34,0,0,0,0,0,0
2,201392387,2170660915,0,0,2024-10-04 19:33:34,0,0,0,0,0,0
2,201392387,2170660915,2759,36895,2024-10-04 19:33:34,0,0,0,0,0,0
2,201392387,2170660915,39639,36895,2024-10-04 19:33:35,0,0,0,0,0,0
2,201392387,2170660915,22663,36895,2024-10-04 19:33:35,0,0,0,0,0,0
2,201392387,1145490689,54476,47873,2024-10-04 19:33:35,0,0,0,0,0,0
2,201392387,2170660915,0,0,2024-10-04 19:33:35,0,0,0,0,0,0
2,201392387,2170660915,2759,36895,2024-10-04 19:33:35,0,0,0,0,0,0
2,201392387,2170660915,39639,36895,2024-10-04 19:33:36,0,0,0,0,0,0
2,201392387,2170660915,22663,36895,2024-10-04 19:33:36,0,0,0,0,0,0
2,201392387,1145490689,54476,47873,2024-10-04 19:33:36,0,0,0,0,0,0
2,201392387,2170660915,0,0,2024-10-04 19:33:36,0,0,0,0,0,0
2,201392387,2170660915,2759,36895,2024-10-04 19:33:36,0,0,0,0,0,0
2,201392387,2170660915,39639,36895,2024-10-04 19:33:37,0,0,0,0,0,0
2,201392387,2170660915,22663,36895,2024-10-04 19:33:37,0,0,0,0,0,0
2,201392387,1145490689,54476,47873,2024-10-04 19:33:37,0,0,0,0,0,0
2,201392387,2170660915,0,0,2024-10-04 19:33:37,0,0,0,0,0,0
2,201392387,2170660915,2759,36895,2024-10-04 19:33:37,0,0,0,0,0,0
2,201392387,2170660915,39639,36895,2024-10-04 19:33:38,0,0,0,0,0,0
2,201392387,2170660915,22663,36895,2024-10-04 19:33:38,0,0,0,0,0,0
2,201392387,1145490689,54476,47873,2024-10-04 19:33:38,0,0,0,0,0,0
2,201392387,2170660915,0,0,2024-10-04 19:33:38,0,0,0,0,0,0
2,201392387,2170660915,2759,36895,2024-10-04 19:33:38,0,0,0,0,0,0
2,201392387,2170660915,39639,36895,2024-10-04 19:33:39,0,0,0,0,0,0
2,201392387,2170660915,22663,36895,2024-10-04 19:33:39,0,0,0,0,0,0
2,201392387,1145490689,54476,47873,2024-10-04 19:33:39,516,1576,2092,5,4,9
2,201392387,2170660915,0,0,2024-10-04 19:33:39,0,0,0,0,0,0
2,201392387,2170660915,2759,36895,2024-10-04 19:33:39,0,0,0,0,0,0
2,201392387,2170660915,39639,36895,2024-10-04 19:33:40,0,0,0,0,0,0
2,201392387,2170660915,22663,36895,2024-10-04 19:33:40,0,0,0,0,0,0
2,201392387,1145490689,54476,47873,2024-10-04 19:33:40,0,0,0,0,0,0
2,201392387,2170660915,0,0,2024-10-04 19:33:40,0,0,0,0,0,0
2,201392387,2170660915,2759,36895,2024-10-04 19:33:40,0,0,0,0,0,0
2,201392387,2170660915,39639,36895,2024-10-04 19:33:41,0,0,0,0,0,0
2,201392387,2170660915,22663,36895,2024-10-04 19:33:41,0,0,0,0,0,0
2,201392387,1145490689,54476,47873,2024-10-04 19:33:41,0,0,0,0,0,0
2,201392387,2170660915,0,0,2024-10-04 19:33:41,0,0,0,0,0,0
2,201392387,2170660915,2759,36895,2024-10-04 19:33:41,0,0,0,0,0,0
2,201392387,2170660915,39639,36895,2024-10-04 19:33:42,0,0,0,0,0,0
2,201392387,2170660915,22663,36895,2024-10-04 19:33:42,0,0,0,0,0,0
2,201392387,1145490689,54476,47873,2024-10-04 19:33:42,0,0,0,0,0,0
2,201392387,2170660915,0,0,2024-10-04 19:33:42,0,0,0,0,0,0
2,201392387,2170660915,2759,36895,2024-10-04 19:33:42,0,0,0,0,0,0
2,201392387,2170660915,39639,36895,2024-10-04 19:33:43,0,0,0,0,0,0
2,201392387,2170660915,22663,36895,2024-10-04 19:33:43,0,0,0,0,0,0
2,201392387,1145490689,54476,47873,2024-10-04 19:33:43,0,0,0,0,0,0
2,201392387,2170660915,0,0,2024-10-04 19:33:43,128,0,128,1,0,1
2,201392387,2170660915,2759,36895,2024-10-04 19:33:43,0,0,0,0,0,0
2,201392387,2170660915,39639,36895,2024-10-04 19:33:44,0,0,0,0,0,0
2,201392387,2170660915,22663,36895,2024-10-04 19:33:44,0,0,0,0,0,0
2,201392387,1145490689,54476,47873,2024-10-04 19:33:44,0,0,0,0,0,0
2,201392387,2170660915,0,0,2024-10-04 19:33:44,128,84,212,1,1,2
2,201392387,2170660915,2759,36895,2024-10-04 19:33:44,0,0,0,0,0,0
2,201392387,2170660915,39639,36895,2024-10-04 19:33:45,0,0,0,0,0,0
2,201392387,2170660915,22663,36895,2024-10-04 19:33:45,0,0,0,0,0,0
2,201392387,1145490689,54476,47873,2024-10-04 19:33:45,0,0,0,0,0,0
2,201392387,2170660915,0,0,2024-10-04 19:33:45,128,84,212,1,1,2
2,201392387,2170660915,2759,36895,2024-10-04 19:33:45,0,0,0,0,0,0
2,201392387,2170660915,39639,36895,2024-10-04 19:33:46,0,0,0,0,0,0
2,201392387,2170660915,22663,36895,2024-10-04 19:33:46,0,0,0,0,0,0
2,201392387,1145490689,54476,47873,2024-10-04 19:33:46,0,0,0,0,0,0
2,201392387,2170660915,0,0,2024-10-04 19:33:46,128,84,212,1,1,2
2,201392387,2170660915,2759,36895,2024-10-04 19:33:46,0,0,0,0,0,0
2,201392387,2170660915,39639,36895,2024-10-04 19:33:47,0,0,0,0,0,0
2,201392387,2170660915,22663,36895,2024-10-04 19:33:47,0,0,0,0,0,0
2,201392387,1145490689,54476,47873,2024-10-04 19:33:47,0,0,0,0,0,0
2,201392387,2170660915,0,0,2024-10-04 19:33:47,128,84,212,1,1,2
2,201392387,2170660915,2759,36895,2024-10-04 19:33:47,0,0,0,0,0,0
2,201392387,2170660915,39639,36895,2024-10-04 19:33:48,0,0,0,0,0,0
2,201392387,2170660915,22663,36895,2024-10-04 19:33:48,0,0,0,0,0,0
2,201392387,1145490689,54476,47873,2024-10-04 19:33:48,0,0,0,0,0,0
2,201392387,2170660915,0,0,2024-10-04 19:33:48,128,84,212,1,1,2
2,201392387,2170660915,2759,36895,2024-10-04 19:33:48,0,0,0,0,0,0
2,201392387,2170660915,39639,36895,2024-10-04 19:33:49,0,0,0,0,0,0
2,201392387,2170660915,22663,36895,2024-10-04 19:33:49,0,0,0,0,0,0
2,201392387,2170660915,0,0,2024-10-04 19:33:49,128,84,212,1,1,2
2,201392387,2170660915,2759,36895,2024-10-04 19:33:49,0,0,0,0,0,0
2,201392387,2170660915,39639,36895,2024-10-04 19:33:50,0,0,0,0,0,0
2,201392387,2170660915,22663,36895,2024-10-04 19:33:50,0,0,0,0,0,0
2,201392387,2170660915,0,0,2024-10-04 19:33:50,128,84,212,1,1,2
2,201392387,2170660915,2759,36895,2024-10-04 19:33:50,0,0,0,0,0,0
2,201392387,2170660915,39639,36895,2024-10-04 19:33:51,0,0,0,0,0,0
2,201392387,2170660915,22663,36895,2024-10-04 19:33:51,0,0,0,0,0,0
2,201392387,2170660915,0,0,2024-10-04 19:33:51,0,84,84,0,1,1
2,201392387,2170660915,2759,36895,2024-10-04 19:33:51,0,0,0,0,0,0
2,201392387,2170660915,39639,36895,2024-10-04 19:33:52,0,0,0,0,0,0
2,201392387,2170660915,22663,36895,2024-10-04 19:33:52,0,0,0,0,0,0
2,201392387,2170660915,0,0,2024-10-04 19:33:52,256,84,340,2,1,3
2,201392387,2170660915,2759,36895,2024-10-04 19:33:52,0,0,0,0,0,0
2,201392387,2170660915,39639,36895,2024-10-04 19:33:53,0,0,0,0,0,0
2,201392387,2170660915,22663,36895,2024-10-04 19:33:53,0,0,0,0,0,0
2,201392387,2170660915,0,0,2024-10-04 19:33:53,0,84,84,0,1,1
2,201392387,2170660915,2759,36895,2024-10-04 19:33:53,0,0,0,0,0,0
2,201392387,2170660915,39639,36895,2024-10-04 19:33:54,0,0,0,0,0,0
2,201392387,2170660915,22663,36895,2024-10-04 19:33:54,0,0,0,0,0,0
2,201392387,2170660915,0,0,2024-10-04 19:33:54,0,0,0,0,0,0
2,201392387,2170660915,2759,36895,2024-10-04 19:33:54,0,0,0,0,0,0
2,201392387,2170660915,39639,36895,2024-10-04 19:33:55,0,0,0,0,0,0
2,201392387,2170660915,22663,36895,2024-10-04 19:33:55,0,0,0,0,0,0
2,201392387,2170660915,55008,36895,2024-10-04 19:33:55,570,455,1025,5,5,10
2,201392387,2170660915,0,0,2024-10-04 19:33:55,128,0,128,1,0,1
2,201392387,2170660915,2759,36895,2024-10-04 19:33:55,0,0,0,0,0,0
2,201392387,2170660915,39639,36895,2024-10-04 19:33:56,0,0,0,0,0,0
2,201392387,2170660915,22663,36895,2024-10-04 19:33:56,0,0,0,0,0,0
2,201392387,2170660915,55008,36895,2024-10-04 19:33:56,0,0,0,0,0,0
2,201392387,2170660915,0,0,2024-10-04 19:33:56,128,84,212,1,1,2
2,201392387,2170660915,2759,36895,2024-10-04 19:33:56,0,0,0,0,0,0
2,201392387,2170660915,39639,36895,2024-10-04 19:33:57,0,0,0,0,0,0
2,201392387,2170660915,22663,36895,2024-10-04 19:33:57,0,0,0,0,0,0
2,201392387,2170660915,55008,36895,2024-10-04 19:33:57,0,0,0,0,0,0
2,201392387,2170660915,0,0,2024-10-04 19:33:57,128,84,212,1,1,2
2,201392387,2170660915,2759,36895,2024-10-04 19:33:57,0,0,0,0,0,0
2,201392387,2170660915,39639,36895,2024-10-04 19:33:58,0,0,0,0,0,0
2,201392387,2170660915,22663,36895,2024-10-04 19:33:58,0,0,0,0,0,0
2,201392387,2170660915,55008,36895,2024-10-04 19:33:58,0,0,0,0,0,0
2,201392387,2170660915,0,0,2024-10-04 19:33:58,0,84,84,0,1,1
2,201392387,2170660915,2759,36895,2024-10-04 19:33:58,0,0,0,0,0,0
2,201392387,2170660915,39639,36895,2024-10-04 19:33:59,0,0,0,0,0,0
2,201392387,2170660915,22663,36895,2024-10-04 19:33:59,0,0,0,0,0,0
2,201392387,2170660915,55008,36895,2024-10-04 19:33:59,0,0,0,0,0,0
2,201392387,2170660915,0,0,2024-10-04 19:33:59,0,0,0,0,0,0
2,201392387,2170660915,2759,36895,2024-10-04 19:33:59,0,0,0,0,0,0
2,201392387,2170660915,39639,36895,2024-10-04 19:34:00,0,0,0,0,0,0
2,201392387,2170660915,22663,36895,2024-10-04 19:34:00,0,0,0,0,0,0
2,201392387,2170660915,55008,36895,2024-10-04 19:34:00,0,0,0,0,0,0
2,201392387,2170660915,0,0,2024-10-04 19:34:00,0,0,0,0,0,0
2,201392387,2170660915,2759,36895,2024-10-04 19:34:00,0,0,0,0,0,0
2,201392387,2170660915,39639,36895,2024-10-04 19:34:01,0,0,0,0,0,0
2,201392387,2170660915,22663,36895,2024-10-04 19:34:01,0,0,0,0,0,0
2,201392387,2170660915,0,0,2024-10-04 19:34:01,128,84,212,1,1,2
2,201392387,2170660915,2759,36895,2024-10-04 19:34:01,0,0,0,0,0,0
2,201392387,2170660915,39639,36895,2024-10-04 19:34:02,0,0,0,0,0,0
2,201392387,2170660915,22663,36895,2024-10-04 19:34:02,0,0,0,0,0,0
2,201392387,2170660915,0,0,2024-10-04 19:34:02,0,0,0,0,0,0
2,201392387,2170660915,2759,36895,2024-10-04 19:34:02,0,0,0,0,0,0
2,201392387,2170660915,39639,36895,2024-10-04 19:34:03,0,0,0,0,0,0
2,201392387,2170660915,22663,36895,2024-10-04 19:34:03,0,0,0,0,0,0
2,201392387,1145490691,42128,47873,2024-10-04 19:34:03,3160,39381,42541,23,36,59
2,201392387,2170660915,0,0,2024-10-04 19:34:03,256,168,424,2,2,4
2,201392387,2170660915,2759,36895,2024-10-04 19:34:03,0,0,0,0,0,0
2,201392387,2170660915,39639,36895,2024-10-04 19:34:04,0,0,0,0,0,0
2,201392387,2170660915,22663,36895,2024-10-04 19:34:04,0,0,0,0,0,0
2,201392387,1145490691,42128,47873,2024-10-04 19:34:04,0,0,0,0,0,0
2,201392387,2170660915,0,0,2024-10-04 19:34:04,0,0,0,0,0,0
2,201392387,2170660915,2759,36895,2024-10-04 19:34:04,0,0,0,0,0,0
2,201392387,2170660915,39639,36895,2024-10-04 19:34:05,0,0,0,0,0,0
2,201392387,2170660915,22663,36895,2024-10-04 19:34:05,0,0,0,0,0,0
2,201392387,1145490691,42128,47873,2024-10-04 19:34:05,0,0,0,0,0,0
2,201392387,2170660915,0,0,2024-10-04 19:34:05,0,0,0,0,0,0
2,201392387,2170660915,2759,36895,2024-10-04 19:34:05,0,0,0,0,0,0
2,201392387,2170660915,39639,36895,2024-10-04 19:34:06,0,0,0,0,0,0
2,201392387,2170660915,22663,36895,2024-10-04 19:34:06,0,0,0,0,0,0
2,201392387,1145490691,42128,47873,2024-10-04 19:34:06,0,0,0,0,0,0
2,201392387,2170660915,0,0,2024-10-04 19:34:06,0,0,0,0,0,0
2,201392387,2170660915,2759,36895,2024-10-04 19:34:06,0,0,0,0,0,0
2,201392387,2170660915,39639,36895,2024-10-04 19:34:07,0,0,0,0,0,0
2,201392387,2170660915,22663,36895,2024-10-04 19:34:07,0,0,0,0,0,0
2,201392387,1145490691,42128,47873,2024-10-04 19:34:07,0,0,0,0,0,0
2,201392387,2170660915,0,0,2024-10-04 19:34:07,0,0,0,0,0,0
2,201392387,2170660915,2759,36895,2024-10-04 19:34:07,0,0,0,0,0,0
2,201392387,2170660915,39639,36895,2024-10-04 19:34:08,0,0,0,0,0,0
2,201392387,2170660915,22663,36895,2024-10-04 19:34:08,0,0,0,0,0,0
2,201392387,1145490691,42128,47873,2024-10-04 19:34:08,0,0,0,0,0,0
2,201392387,2170660915,0,0,2024-10-04 19:34:08,0,0,0,0,0,0
2,201392387,2170660915,2759,36895,2024-10-04 19:34:08,0,0,0,0,0,0
2,201392387,2170660915,39639,36895,2024-10-04 19:34:09,0,0,0,0,0,0
2,201392387,2170660915,22663,36895,2024-10-04 19:34:09,0,0,0,0,0,0
2,201392387,1145490691,42128,47873,2024-10-04 19:34:09,0,0,0,0,0,0
2,201392387,2170660915,0,0,2024-10-04 19:34:09,0,0,0,0,0,0
2,201392387,2170660915,2759,36895,2024-10-04 19:34:09,0,0,0,0,0,0
2,201392387,2170660915,39639,36895,2024-10-04 19:34:10,0,0,0,0,0,0
2,201392387,2170660915,22663,36895,2024-10-04 19:34:10,0,0,0,0,0,0
2,201392387,1145490691,42128,47873,2024-10-04 19:34:10,2100,43597,45697,21,33,54
2,201392387,2170660915,0,0,2024-10-04 19:34:10,0,0,0,0,0,0
2,201392387,2170660915,2759,36895,2024-10-04 19:34:10,0,0,0,0,0,0
2,201392387,2170660915,39639,36895,2024-10-04 19:34:11,0,0,0,0,0,0
2,201392387,2170660915,22663,36895,2024-10-04 19:34:11,0,0,0,0,0,0
2,201392387,1145490691,42128,47873,2024-10-04 19:34:11,0,0,0,0,0,0
2,201392387,2170660915,0,0,2024-10-04 19:34:11,0,0,0,0,0,0
2,201392387,2170660915,2759,36895,2024-10-04 19:34:11,0,0,0,0,0,0
2,201392387,2170660915,39639,36895,2024-10-04 19:34:12,0,0,0,0,0,0
2,201392387,2170660915,22663,36895,2024-10-04 19:34:12,0,0,0,0,0,0
2,201392387,1145490691,42128,47873,2024-10-04 19:34:12,0,0,0,0,0,0
2,201392387,2170660915,0,0,2024-10-04 19:34:12,0,0,0,0,0,0
2,201392387,2170660915,2759,36895,2024-10-04 19:34:12,0,0,0,0,0,0
2,201392387,2170660915,39639,36895,2024-10-04 19:34:13,0,0,0,0,0,0
2,201392387,2170660915,22663,36895,2024-10-04 19:34:13,0,0,0,0,0,0
2,201392387,1145490691,42128,47873,2024-10-04 19:34:13,0,0,0,0,0,0
2,201392387,2170660915,0,0,2024-10-04 19:34:13,0,0,0,0,0,0
2,201392387,2170660915,2759,36895,2024-10-04 19:34:13,0,0,0,0,0,0
2,201392387,2170660915,39639,36895,2024-10-04 19:34:14,0,0,0,0,0,0
2,201392387,2170660915,22663,36895,2024-10-04 19:34:14,0,0,0,0,0,0
2,201392387,1145490691,42128,47873,2024-10-04 19:34:14,0,0,0,0,0,0
2,201392387,2170660915,0,0,2024-10-04 19:34:14,128,84,212,1,1,2
2,201392387,2170660915,2759,36895,2024-10-04 19:34:14,0,0,0,0,0,0
2,201392387,2170660915,39639,36895,2024-10-04 19:34:15,0,0,0,0,0,0
2,201392387,2170660915,22663,36895,2024-10-04 19:34:15,0,0,0,0,0,0
2,201392387,1145490691,42128,47873,2024-10-04 19:34:15,0,0,0,0,0,0
2,201392387,2170660915,0,0,2024-10-04 19:34:15,128,84,212,1,1,2
2,201392387,2170660915,2759,36895,2024-10-04 19:34:15,0,0,0,0,0,0
2,201392387,2170660915,39639,36895,2024-10-04 19:34:16,0,0,0,0,0,0
2,201392387,2170660915,22663,36895,2024-10-04 19:34:16,0,0,0,0,0,0
2,201392387,1145490691,42128,47873,2024-10-04 19:34:16,0,0,0,0,0,0
2,201392387,2170660915,0,0,2024-10-04 19:34:16,128,84,212,1,1,2
2,201392387,2170660915,2759,36895,2024-10-04 19:34:16,0,0,0,0,0,0
2,201392387,2170660915,39639,36895,2024-10-04 19:34:17,0,0,0,0,0,0
2,201392387,2170660915,22663,36895,2024-10-04 19:34:17,0,0,0,0,0,0
2,201392387,1145490691,42128,47873,2024-10-04 19:34:17,0,0,0,0,0,0
2,201392387,2170660915,0,0,2024-10-04 19:34:17,128,84,212,1,1,2
2,201392387,2170660915,2759,36895,2024-10-04 19:34:17,0,0,0,0,0,0
2,201392387,2170660915,39639,36895,2024-10-04 19:34:18,0,0,0,0,0,0
2,201392387,2170660915,22663,36895,2024-10-04 19:34:18,0,0,0,0,0,0
2,201392387,1145490691,42128,47873,2024-10-04 19:34:18,0,0,0,0,0,0
2,201392387,2170660915,0,0,2024-10-04 19:34:18,128,84,212,1,1,2
2,201392387,2170660915,2759,36895,2024-10-04 19:34:18,0,0,0,0,0,0
2,201392387,2170660915,39639,36895,2024-10-04 19:34:19,0,0,0,0,0,0
2,201392387,2170660915,22663,36895,2024-10-04 19:34:19,0,0,0,0,0,0
2,201392387,1145490691,42128,47873,2024-10-04 19:34:19,0,0,0,0,0,0
2,201392387,2170660915,0,0,2024-10-04 19:34:19,128,84,212,1,1,2
2,201392387,2170660915,2759,36895,2024-10-04 19:34:19,0,0,0,0,0,0
2,201392387,2170660915,39639,36895,2024-10-04 19:34:20,0,0,0,0,0,0
2,201392387,2170660915,22663,36895,2024-10-04 19:34:20,0,0,0,0,0,0
2,201392387,2170660915,0,0,2024-10-04 19:34:20,128,84,212,1,1,2
2,201392387,2170660915,2759,36895,2024-10-04 19:34:20,0,0,0,0,0,0
2,201392387,2170660915,39639,36895,2024-10-04 19:34:21,0,0,0,0,0,0
2,201392387,2170660915,22663,36895,2024-10-04 19:34:21,0,0,0,0,0,0
2,201392387,2170660915,0,0,2024-10-04 19:34:21,128,84,212,1,1,2
2,201392387,2170660915,2759,36895,2024-10-04 19:34:21,0,0,0,0,0,0
2,201392387,2170660915,39639,36895,2024-10-04 19:34:22,0,0,0,0,0,0
2,201392387,2170660915,22663,36895,2024-10-04 19:34:22,0,0,0,0,0,0
2,201392387,2170660915,0,0,2024-10-04 19:34:22,128,84,212,1,1,2
2,201392387,2170660915,2759,36895,2024-10-04 19:34:22,0,0,0,0,0,0
2,201392387,2170660915,39639,36895,2024-10-04 19:34:23,0,0,0,0,0,0
2,201392387,2170660915,22663,36895,2024-10-04 19:34:23,0,0,0,0,0,0
2,201392387,2170660915,0,0,2024-10-04 19:34:23,128,84,212,1,1,2
2,201392387,2170660915,2759,36895,2024-10-04 19:34:23,0,0,0,0,0,0
2,201392387,2170660915,39639,36895,2024-10-04 19:34:24,0,0,0,0,0,0
2,201392387,2170660915,22663,36895,2024-10-04 19:34:24,0,0,0,0,0,0
2,201392387,2170660915,3754,36895,2024-10-04 19:34:24,666,507,1173,6,6,12
2,201392387,2170660915,0,0,2024-10-04 19:34:24,0,0,0,0,0,0
2,201392387,2170660915,2759,36895,2024-10-04 19:34:24,0,0,0,0,0,0
2,201392387,2170660915,39639,36895,2024-10-04 19:34:25,0,0,0,0,0,0
2,201392387,2170660915,22663,36895,2024-10-04 19:34:25,0,0,0,0,0,0
2,201392387,2170660915,3754,36895,2024-10-04 19:34:25,0,0,0,0,0,0
2,201392387,2170660915,0,0,2024-10-04 19:34:25,0,0,0,0,0,0
2,201392387,2170660915,2759,36895,2024-10-04 19:34:25,0,0,0,0,0,0
2,201392387,2170660915,39639,36895,2024-10-04 19:34:26,0,0,0,0,0,0
2,201392387,2170660915,22663,36895,2024-10-04 19:34:26,0,0,0,0,0,0
2,201392387,2170660915,3754,36895,2024-10-04 19:34:26,0,0,0,0,0,0
2,201392387,2170660915,0,0,2024-10-04 19:34:26,128,84,212,1,1,2
2,201392387,2170660915,2759,36895,2024-10-04 19:34:26,0,0,0,0,0,0
2,201392387,2170660915,39639,36895,2024-10-04 19:34:27,0,0,0,0,0,0
2,201392387,2170660915,22663,36895,2024-10-04 19:34:27,0,0,0,0,0,0
2,201392387,2170660915,3754,36895,2024-10-04 19:34:27,0,0,0,0,0,0
2,201392387,2170660915,0,0,2024-10-04 19:34:27,256,84,340,2,1,3
2,201392387,2170660915,2759,36895,2024-10-04 19:34:27,0,0,0,0,0,0
2,201392387,2170660915,39639,36895,2024-10-04 19:34:28,0,0,0,0,0,0
2,201392387,2170660915,22663,36895,2024-10-04 19:34:28,0,0,0,0,0,0
2,201392387,2170660915,3754,36895,2024-10-04 19:34:28,0,0,0,0,0,0
2,201392387,2170660915,0,0,2024-10-04 19:34:28,0,84,84,0,1,1
2,201392387,2170660915,2759,36895,2024-10-04 19:34:28,0,0,0,0,0,0
2,201392387,2170660915,39639,36895,2024-10-04 19:34:29,0,0,0,0,0,0
2,201392387,2170660915,22663,36895,2024-10-04 19:34:29,0,0,0,0,0,0
2,201392387,2170660915,3754,36895,2024-10-04 19:34:29,0,0,0,0,0,0
2,201392387,2170660915,0,0,2024-10-04 19:34:29,0,0,0,0,0,0
2,201392387,2170660915,2759,36895,2024-10-04 19:34:29,0,0,0,0,0,0
2,201392387,2170660915,39639,36895,2024-10-04 19:34:30,0,0,0,0,0,0
2,201392387,2170660915,22663,36895,2024-10-04 19:34:30,0,0,0,0,0,0
2,201392387,2170660915,3754,36895,2024-10-04 19:34:30,0,0,0,0,0,0
2,201392387,2170660915,0,0,2024-10-04 19:34:30,0,0,0,0,0,0
2,201392387,2170660915,2759,36895,2024-10-04 19:34:30,0,0,0,0,0,0
2,201392387,2170660915,39639,36895,2024-10-04 19:34:31,0,0,0,0,0,0
2,201392387,2170660915,22663,36895,2024-10-04 19:34:31,0,0,0,0,0,0
2,201392387,2170660915,3754,36895,2024-10-04 19:34:31,0,0,0,0,0,0
2,201392387,2170660915,0,0,2024-10-04 19:34:31,128,84,212,1,1,2
2,201392387,2170660915,2759,36895,2024-10-04 19:34:31,0,0,0,0,0,0
2,201392387,2170660915,39639,36895,2024-10-04 19:34:32,0,0,0,0,0,0
2,201392387,2170660915,22663,36895,2024-10-04 19:34:32,0,0,0,0,0,0
2,201392387,2170660915,3754,36895,2024-10-04 19:34:32,0,0,0,0,0,0
2,201392387,2170660915,0,0,2024-10-04 19:34:32,128,84,212,1,1,2
2,201392387,2170660915,2759,36895,2024-10-04 19:34:32,0,0,0,0,0,0
2,201392387,2170660915,39639,36895,2024-10-04 19:34:33,0,0,0,0,0,0
2,201392387,2170660915,22663,36895,2024-10-04 19:34:33,0,0,0,0,0,0
2,201392387,1145490692,4313,47873,2024-10-04 19:34:33,3828,55230,59058,29,44,73
2,201392387,2170660915,0,0,2024-10-04 19:34:33,128,84,212,1,1,2
2,201392387,2170660915,2759,36895,2024-10-04 19:34:33,0,0,0,0,0,0
2,201392387,2170660915,39639,36895,2024-10-04 19:34:34,0,0,0,0,0,0
2,201392387,2170660915,22663,36895,2024-10-04 19:34:34,0,0,0,0,0,0
2,201392387,1145490692,4313,47873,2024-10-04 19:34:34,0,0,0,0,0,0
2,201392387,2170660915,0,0,2024-10-04 19:34:34,0,0,0,0,0,0
2,201392387,2170660915,2759,36895,2024-10-04 19:34:34,0,0,0,0,0,0
2,201392387,2170660915,39639,36895,2024-10-04 19:34:35,0,0,0,0,0,0
2,201392387,2170660915,22663,36895,2024-10-04 19:34:35,0,0,0,0,0,0
2,201392387,1145490692,4313,47873,2024-10-04 19:34:35,0,0,0,0,0,0
2,201392387,2170660915,0,0,2024-10-04 19:34:35,0,0,0,0,0,0
2,201392387,2170660915,2759,36895,2024-10-04 19:34:35,0,0,0,0,0,0
2,201392387,2170660915,39639,36895,2024-10-04 19:34:36,0,0,0,0,0,0
2,201392387,2170660915,22663,36895,2024-10-04 19:34:36,0,0,0,0,0,0
2,201392387,1145490692,4313,47873,2024-10-04 19:34:36,0,0,0,0,0,0
2,201392387,2170660915,0,0,2024-10-04 19:34:36,0,0,0,0,0,0
2,201392387,2170660915,2759,36895,2024-10-04 19:34:36,0,0,0,0,0,0
2,201392387,2170660915,39639,36895,2024-10-04 19:34:37,0,0,0,0,0,0
2,201392387,2170660915,22663,36895,2024-10-04 19:34:37,0,0,0,0,0,0
2,201392387,1145490692,4313,47873,2024-10-04 19:34:37,0,0,0,0,0,0
2,201392387,2170660915,0,0,2024-10-04 19:34:37,0,0,0,0,0,0
2,201392387,2170660915,2759,36895,2024-10-04 19:34:37,0,0,0,0,0,0
2,201392387,2170660915,39639,36895,2024-10-04 19:34:38,0,0,0,0,0,0
2,201392387,2170660915,22663,36895,2024-10-04 19:34:38,0,0,0,0,0,0
2,201392387,1145490692,4313,47873,2024-10-04 19:34:38,0,0,0,0,0,0
2,201392387,2170660915,0,0,2024-10-04 19:34:38,0,0,0,0,0,0
2,201392387,2170660915,2759,36895,2024-10-04 19:34:38,0,0,0,0,0,0
2,201392387,2170660915,39639,36895,2024-10-04 19:34:39,0,0,0,0,0,0
2,201392387,2170660915,22663,36895,2024-10-04 19:34:39,0,0,0,0,0,0
2,201392387,1145490692,4313,47873,2024-10-04 19:34:39,0,0,0,0,0,0
2,201392387,2170660915,0,0,2024-10-04 19:34:39,0,0,0,0,0,0
2,201392387,2170660915,2759,36895,2024-10-04 19:34:39,0,0,0,0,0,0
2,201392387,2170660915,39639,36895,2024-10-04 19:34:40,0,0,0,0,0,0
2,201392387,2170660915,22663,36895,2024-10-04 19:34:40,0,0,0,0,0,0
2,201392387,1145490692,4313,47873,2024-10-04 19:34:40,0,0,0,0,0,0
2,201392387,2170660915,0,0,2024-10-04 19:34:40,0,0,0,0,0,0
2,201392387,2170660915,2759,36895,2024-10-04 19:34:40,0,0,0,0,0,0
2,201392387,2170660915,39639,36895,2024-10-04 19:34:41,0,0,0,0,0,0
2,201392387,2170660915,22663,36895,2024-10-04 19:34:41,0,0,0,0,0,0
2,201392387,1145490692,4313,47873,2024-10-04 19:34:41,2640,46106,48746,27,35,62
2,201392387,2170660915,0,0,2024-10-04 19:34:41,0,0,0,0,0,0
2,201392387,2170660915,2759,36895,2024-10-04 19:34:41,0,0,0,0,0,0
2,201392387,2170660915,39639,36895,2024-10-04 19:34:42,0,0,0,0,0,0
2,201392387,2170660915,22663,36895,2024-10-04 19:34:42,0,0,0,0,0,0
2,201392387,1145490692,4313,47873,2024-10-04 19:34:42,0,0,0,0,0,0
2,201392387,2170660915,0,0,2024-10-04 19:34:42,0,0,0,0,0,0
2,201392387,2170660915,2759,36895,2024-10-04 19:34:42,0,0,0,0,0,0
2,201392387,2170660915,39639,36895,2024-10-04 19:34:43,0,0,0,0,0,0
2,201392387,2170660915,22663,36895,2024-10-04 19:34:43,0,0,0,0,0,0
2,201392387,1145490692,4313,47873,2024-10-04 19:34:43,0,0,0,0,0,0
2,201392387,2170660915,0,0,2024-10-04 19:34:43,0,0,0,0,0,0
2,201392387,2170660915,2759,36895,2024-10-04 19:34:43,0,0,0,0,0,0
2,201392387,2170660915,39639,36895,2024-10-04 19:34:44,0,0,0,0,0,0
2,201392387,2170660915,22663,36895,2024-10-04 19:34:44,0,0,0,0,0,0
2,201392387,1145490692,4313,47873,2024-10-04 19:34:44,0,0,0,0,0,0
2,201392387,2170660915,0,0,2024-10-04 19:34:44,128,84,212,1,1,2
2,201392387,2170660915,2759,36895,2024-10-04 19:34:44,0,0,0,0,0,0
2,201392387,2170660915,39639,36895,2024-10-04 19:34:45,0,0,0,0,0,0
2,201392387,2170660915,22663,36895,2024-10-04 19:34:45,0,0,0,0,0,0
2,201392387,1145490692,4313,47873,2024-10-04 19:34:45,0,0,0,0,0,0
2,201392387,2170660915,0,0,2024-10-04 19:34:45,128,84,212,1,1,2
2,201392387,2170660915,2759,36895,2024-10-04 19:34:45,0,0,0,0,0,0
2,201392387,2170660915,39639,36895,2024-10-04 19:34:46,0,0,0,0,0,0
2,201392387,2170660915,22663,36895,2024-10-04 19:34:46,0,0,0,0,0,0
2,201392387,1145490692,4313,47873,2024-10-04 19:34:46,0,0,0,0,0,0
2,201392387,2170660915,0,0,2024-10-04 19:34:46,128,84,212,1,1,2
2,201392387,2170660915,2759,36895,2024-10-04 19:34:46,0,0,0,0,0,0
2,201392387,2170660915,39639,36895,2024-10-04 19:34:47,0,0,0,0,0,0
2,201392387,2170660915,22663,36895,2024-10-04 19:34:47,0,0,0,0,0,0
2,201392387,1145490692,4313,47873,2024-10-04 19:34:47,0,0,0,0,0,0
2,201392387,2170660915,0,0,2024-10-04 19:34:47,128,84,212,1,1,2
2,201392387,2170660915,2759,36895,2024-10-04 19:34:47,0,0,0,0,0,0
2,201392387,2170660915,39639,36895,2024-10-04 19:34:48,0,0,0,0,0,0
2,201392387,2170660915,22663,36895,2024-10-04 19:34:48,0,0,0,0,0,0
2,201392387,1145490692,4313,47873,2024-10-04 19:34:48,0,0,0,0,0,0
2,201392387,2170660915,0,0,2024-10-04 19:34:48,128,84,212,1,1,2
2,201392387,2170660915,2759,36895,2024-10-04 19:34:48,0,0,0,0,0,0
2,201392387,2170660915,39639,36895,2024-10-04 19:34:49,0,0,0,0,0,0
2,201392387,2170660915,22663,36895,2024-10-04 19:34:49,0,0,0,0,0,0
2,201392387,1145490692,4313,47873,2024-10-04 19:34:49,0,0,0,0,0,0
2,201392387,2170660915,0,0,2024-10-04 19:34:49,128,84,212,1,1,2
2,201392387,2170660915,2759,36895,2024-10-04 19:34:49,0,0,0,0,0,0
2,201392387,2170660915,39639,36895,2024-10-04 19:34:50,0,0,0,0,0,0
2,201392387,2170660915,22663,36895,2024-10-04 19:34:50,0,0,0,0,0,0
2,201392387,1145490692,4313,47873,2024-10-04 19:34:50,0,0,0,0,0,0
2,201392387,2170660915,0,0,2024-10-04 19:34:50,128,84,212,1,1,2
2,201392387,2170660915,2759,36895,2024-10-04 19:34:50,0,0,0,0,0,0
2,201392387,2170660915,39639,36895,2024-10-04 19:34:51,0,0,0,0,0,0
2,201392387,2170660915,22663,36895,2024-10-04 19:34:51,0,0,0,0,0,0
2,201392387,1145490692,4313,47873,2024-10-04 19:34:51,0,0,0,0,0,0
2,201392387,2170660915,0,0,2024-10-04 19:34:51,0,0,0,0,0,0
2,201392387,2170660915,2759,36895,2024-10-04 19:34:51,0,0,0,0,0,0
2,201392387,2170660915,39639,36895,2024-10-04 19:34:52,0,0,0,0,0,0
2,201392387,2170660915,22663,36895,2024-10-04 19:34:52,0,0,0,0,0,0
2,201392387,2170660915,0,0,2024-10-04 19:34:52,256,168,424,2,2,4
2,201392387,2170660915,2759,36895,2024-10-04 19:34:52,0,0,0,0,0,0
2,201392387,2170660915,39639,36895,2024-10-04 19:34:53,0,0,0,0,0,0
2,201392387,2170660915,22663,36895,2024-10-04 19:34:53,0,0,0,0,0,0
2,201392387,2170660915,0,0,2024-10-04 19:34:53,128,84,212,1,1,2
2,201392387,2170660915,2759,36895,2024-10-04 19:34:53,0,0,0,0,0,0
2,201392387,2170660915,39639,36895,2024-10-04 19:34:54,0,0,0,0,0,0
2,201392387,2170660915,22663,36895,2024-10-04 19:34:54,0,0,0,0,0,0
2,201392387,2170660915,0,0,2024-10-04 19:34:54,0,0,0,0,0,0
2,201392387,2170660915,2759,36895,2024-10-04 19:34:54,0,0,0,0,0,0
2,201392387,2170660915,39639,36895,2024-10-04 19:34:55,0,0,0,0,0,0
2,201392387,2170660915,41676,36895,2024-10-04 19:34:55,666,507,1173,6,6,12
2,201392387,2170660915,22663,36895,2024-10-04 19:34:55,0,0,0,0,0,0
2,201392387,2170660915,0,0,2024-10-04 19:34:55,0,0,0,0,0,0
2,201392387,2170660915,2759,36895,2024-10-04 19:34:55,0,0,0,0,0,0
2,201392387,2170660915,39639,36895,2024-10-04 19:34:56,0,0,0,0,0,0
2,201392387,2170660915,41676,36895,2024-10-04 19:34:56,0,0,0,0,0,0
2,201392387,2170660915,22663,36895,2024-10-04 19:34:56,0,0,0,0,0,0
2,201392387,2170660915,0,0,2024-10-04 19:34:56,0,0,0,0,0,0
2,201392387,2170660915,2759,36895,2024-10-04 19:34:56,0,0,0,0,0,0
2,201392387,2170660915,39639,36895,2024-10-04 19:34:57,0,0,0,0,0,0
2,201392387,2170660915,41676,36895,2024-10-04 19:34:57,0,0,0,0,0,0
2,201392387,2170660915,22663,36895,2024-10-04 19:34:57,0,0,0,0,0,0
2,201392387,2170660915,0,0,2024-10-04 19:34:57,256,84,340,2,1,3
2,201392387,2170660915,2759,36895,2024-10-04 19:34:57,0,0,0,0,0,0
2,201392387,2170660915,39639,36895,2024-10-04 19:34:58,0,0,0,0,0,0
2,201392387,2170660915,41676,36895,2024-10-04 19:34:58,0,0,0,0,0,0
2,201392387,2170660915,22663,36895,2024-10-04 19:34:58,0,0,0,0,0,0
2,201392387,2170660915,0,0,2024-10-04 19:34:58,128,84,212,1,1,2
2,201392387,2170660915,2759,36895,2024-10-04 19:34:58,0,0,0,0,0,0
2,201392387,2170660915,39639,36895,2024-10-04 19:34:59,0,0,0,0,0,0
2,201392387,2170660915,41676,36895,2024-10-04 19:34:59,0,0,0,0,0,0
2,201392387,2170660915,22663,36895,2024-10-04 19:34:59,0,0,0,0,0,0
2,201392387,2170660915,0,0,2024-10-04 19:34:59,0,84,84,0,1,1
2,201392387,2170660915,2759,36895,2024-10-04 19:34:59,0,0,0,0,0,0
2,201392387,2170660915,39639,36895,2024-10-04 19:35:00,0,0,0,0,0,0
2,201392387,2170660915,41676,36895,2024-10-04 19:35:00,0,0,0,0,0,0
2,201392387,2170660915,22663,36895,2024-10-04 19:35:00,0,0,0,0,0,0
2,201392387,2170660915,0,0,2024-10-04 19:35:00,0,0,0,0,0,0
2,201392387,2170660915,2759,36895,2024-10-04 19:35:00,0,0,0,0,0,0
2,201392387,2170660915,39639,36895,2024-10-04 19:35:01,0,0,0,0,0,0
2,201392387,2170660915,41676,36895,2024-10-04 19:35:01,0,0,0,0,0,0
2,201392387,2170660915,22663,36895,2024-10-04 19:35:01,0,0,0,0,0,0
2,201392387,2170660915,0,0,2024-10-04 19:35:01,128,84,212,1,1,2
2,201392387,2170660915,2759,36895,2024-10-04 19:35:01,0,0,0,0,0,0
2,201392387,2170660915,39639,36895,2024-10-04 19:35:02,0,0,0,0,0,0
2,201392387,2170660915,41676,36895,2024-10-04 19:35:02,0,0,0,0,0,0
2,201392387,2170660915,22663,36895,2024-10-04 19:35:02,0,0,0,0,0,0
2,201392387,2170660915,0,0,2024-10-04 19:35:02,128,0,128,1,0,1
2,201392387,2170660915,2759,36895,2024-10-04 19:35:02,0,0,0,0,0,0
2,201392387,2170660915,39639,36895,2024-10-04 19:35:03,0,0,0,0,0,0
2,201392387,2170660915,41676,36895,2024-10-04 19:35:03,0,0,0,0,0,0
2,201392387,2170660915,22663,36895,2024-10-04 19:35:03,0,0,0,0,0,0
2,201392387,2170660915,0,0,2024-10-04 19:35:03,0,84,84,0,1,1
2,201392387,2170660915,2759,36895,2024-10-04 19:35:03,0,0,0,0,0,0
2,201392387,2170660915,39639,36895,2024-10-04 19:35:04,0,0,0,0,0,0
2,201392387,1145490692,19675,47873,2024-10-04 19:35:04,3852,46097,49949,30,39,69
2,201392387,2170660915,22663,36895,2024-10-04 19:35:04,0,0,0,0,0,0
2,201392387,2170660915,0,0,2024-10-04 19:35:04,128,84,212,1,1,2
2,201392387,2170660915,2759,36895,2024-10-04 19:35:04,0,0,0,0,0,0
2,201392387,2170660915,39639,36895,2024-10-04 19:35:05,0,0,0,0,0,0
2,201392387,1145490692,19675,47873,2024-10-04 19:35:05,0,0,0,0,0,0
2,201392387,2170660915,22663,36895,2024-10-04 19:35:05,0,0,0,0,0,0
2,201392387,2170660915,0,0,2024-10-04 19:35:05,0,0,0,0,0,0
2,201392387,2170660915,2759,36895,2024-10-04 19:35:05,0,0,0,0,0,0
2,201392387,2170660915,39639,36895,2024-10-04 19:35:06,0,0,0,0,0,0
2,201392387,1145490692,19675,47873,2024-10-04 19:35:06,0,0,0,0,0,0
2,201392387,2170660915,22663,36895,2024-10-04 19:35:06,0,0,0,0,0,0
2,201392387,2170660915,0,0,2024-10-04 19:35:06,0,0,0,0,0,0
2,201392387,2170660915,2759,36895,2024-10-04 19:35:06,0,0,0,0,0,0
2,201392387,2170660915,39639,36895,2024-10-04 19:35:07,0,0,0,0,0,0
2,201392387,1145490692,19675,47873,2024-10-04 19:35:07,0,0,0,0,0,0
2,201392387,2170660915,22663,36895,2024-10-04 19:35:07,0,0,0,0,0,0
2,201392387,2170660915,0,0,2024-10-04 19:35:07,0,0,0,0,0,0
2,201392387,2170660915,2759,36895,2024-10-04 19:35:07,0,0,0,0,0,0
2,201392387,2170660915,39639,36895,2024-10-04 19:35:08,0,0,0,0,0,0
2,201392387,1145490692,19675,47873,2024-10-04 19:35:08,0,0,0,0,0,0
2,201392387,2170660915,22663,36895,2024-10-04 19:35:08,0,0,0,0,0,0
2,201392387,2170660915,0,0,2024-10-04 19:35:08,0,0,0,0,0,0
2,201392387,2170660915,2759,36895,2024-10-04 19:35:08,0,0,0,0,0,0
2,201392387,2170660915,39639,36895,2024-10-04 19:35:09,0,0,0,0,0,0
2,201392387,1145490692,19675,47873,2024-10-04 19:35:09,0,0,0,0,0,0
2,201392387,2170660915,22663,36895,2024-10-04 19:35:09,0,0,0,0,0,0
2,201392387,2170660915,0,0,2024-10-04 19:35:09,0,0,0,0,0,0
2,201392387,2170660915,2759,36895,2024-10-04 19:35:09,0,0,0,0,0,0
2,201392387,2170660915,39639,36895,2024-10-04 19:35:10,0,0,0,0,0,0
2,201392387,1145490692,19675,47873,2024-10-04 19:35:10,0,0,0,0,0,0
2,201392387,2170660915,22663,36895,2024-10-04 19:35:10,0,0,0,0,0,0
2,201392387,2170660915,0,0,2024-10-04 19:35:10,0,0,0,0,0,0
2,201392387,2170660915,2759,36895,2024-10-04 19:35:10,0,0,0,0,0,0
2,201392387,2170660915,39639,36895,2024-10-04 19:35:11,0,0,0,0,0,0
2,201392387,1145490692,19675,47873,2024-10-04 19:35:11,0,0,0,0,0,0
2,201392387,2170660915,22663,36895,2024-10-04 19:35:11,0,0,0,0,0,0
2,201392387,2170660915,0,0,2024-10-04 19:35:11,0,0,0,0,0,0
2,201392387,2170660915,2759,36895,2024-10-04 19:35:11,0,0,0,0,0,0
2,201392387,2170660915,39639,36895,2024-10-04 19:35:12,0,0,0,0,0,0
2,201392387,1145490692,19675,47873,2024-10-04 19:35:12,2748,53153,55901,27,38,65
2,201392387,2170660915,22663,36895,2024-10-04 19:35:12,0,0,0,0,0,0
2,201392387,2170660915,0,0,2024-10-04 19:35:12,0,0,0,0,0,0
2,201392387,2170660915,2759,36895,2024-10-04 19:35:12,0,0,0,0,0,0
2,201392387,2170660915,39639,36895,2024-10-04 19:35:13,0,0,0,0,0,0
2,201392387,1145490692,19675,47873,2024-10-04 19:35:13,0,0,0,0,0,0
2,201392387,2170660915,22663,36895,2024-10-04 19:35:13,0,0,0,0,0,0
2,201392387,2170660915,0,0,2024-10-04 19:35:13,0,0,0,0,0,0
2,201392387,2170660915,2759,36895,2024-10-04 19:35:13,0,0,0,0,0,0
2,201392387,2170660915,39639,36895,2024-10-04 19:35:14,0,0,0,0,0,0
2,201392387,1145490692,19675,47873,2024-10-04 19:35:14,0,0,0,0,0,0
2,201392387,2170660915,22663,36895,2024-10-04 19:35:14,0,0,0,0,0,0
2,201392387,2170660915,0,0,2024-10-04 19:35:14,0,0,0,0,0,0
2,201392387,2170660915,2759,36895,2024-10-04 19:35:14,0,0,0,0,0,0
2,201392387,2170660915,39639,36895,2024-10-04 19:35:15,0,0,0,0,0,0
2,201392387,1145490692,19675,47873,2024-10-04 19:35:15,0,0,0,0,0,0
2,201392387,2170660915,22663,36895,2024-10-04 19:35:15,0,0,0,0,0,0
2,201392387,2170660915,0,0,2024-10-04 19:35:15,128,84,212,1,1,2
2,201392387,2170660915,2759,36895,2024-10-04 19:35:15,0,0,0,0,0,0
2,201392387,2170660915,39639,36895,2024-10-04 19:35:16,0,0,0,0,0,0
2,201392387,1145490692,19675,47873,2024-10-04 19:35:16,0,0,0,0,0,0
2,201392387,2170660915,22663,36895,2024-10-04 19:35:16,0,0,0,0,0,0
2,201392387,2170660915,0,0,2024-10-04 19:35:16,128,84,212,1,1,2
2,201392387,2170660915,2759,36895,2024-10-04 19:35:16,0,0,0,0,0,0
2,201392387,2170660915,39639,36895,2024-10-04 19:35:17,0,0,0,0,0,0
2,201392387,1145490692,19675,47873,2024-10-04 19:35:17,0,0,0,0,0,0
2,201392387,2170660915,22663,36895,2024-10-04 19:35:17,0,0,0,0,0,0
2,201392387,2170660915,0,0,2024-10-04 19:35:17,128,84,212,1,1,2
2,201392387,2170660915,2759,36895,2024-10-04 19:35:17,0,0,0,0,0,0
2,201392387,2170660915,39639,36895,2024-10-04 19:35:18,0,0,0,0,0,0
2,201392387,1145490692,19675,47873,2024-10-04 19:35:18,0,0,0,0,0,0
2,201392387,2170660915,22663,36895,2024-10-04 19:35:18,0,0,0,0,0,0
2,201392387,2170660915,0,0,2024-10-04 19:35:18,128,84,212,1,1,2
2,201392387,2170660915,2759,36895,2024-10-04 19:35:18,0,0,0,0,0,0
2,201392387,2170660915,39639,36895,2024-10-04 19:35:19,0,0,0,0,0,0
2,201392387,1145490692,19675,47873,2024-10-04 19:35:19,0,0,0,0,0,0
2,201392387,2170660915,22663,36895,2024-10-04 19:35:19,0,0,0,0,0,0
2,201392387,2170660915,0,0,2024-10-04 19:35:19,128,84,212,1,1,2
2,201392387,2170660915,2759,36895,2024-10-04 19:35:19,0,0,0,0,0,0
2,201392387,2170660915,39639,36895,2024-10-04 19:35:20,0,0,0,0,0,0
2,201392387,1145490692,19675,47873,2024-10-04 19:35:20,0,0,0,0,0,0
2,201392387,2170660915,22663,36895,2024-10-04 19:35:20,0,0,0,0,0,0
2,201392387,2170660915,0,0,2024-10-04 19:35:20,128,84,212,1,1,2
2,201392387,2170660915,2759,36895,2024-10-04 19:35:20,0,0,0,0,0,0
2,201392387,2170660915,39639,36895,2024-10-04 19:35:21,0,0,0,0,0,0
2,201392387,1145490692,19675,47873,2024-10-04 19:35:21,0,0,0,0,0,0
2,201392387,2170660915,22663,36895,2024-10-04 19:35:21,0,0,0,0,0,0
2,201392387,2170660915,0,0,2024-10-04 19:35:21,128,84,212,1,1,2
2,201392387,2170660915,2759,36895,2024-10-04 19:35:21,0,0,0,0,0,0
2,201392387,2170660915,39639,36895,2024-10-04 19:35:22,0,0,0,0,0,0
2,201392387,2170660915,22663,36895,2024-10-04 19:35:22,0,0,0,0,0,0
2,201392387,2170660915,0,0,2024-10-04 19:35:22,128,84,212,1,1,2
2,201392387,2170660915,2759,36895,2024-10-04 19:35:22,0,0,0,0,0,0
2,201392387,2170660915,39639,36895,2024-10-04 19:35:23,0,0,0,0,0,0
2,201392387,2170660915,22663,36895,2024-10-04 19:35:23,0,0,0,0,0,0
2,201392387,2170660915,0,0,2024-10-04 19:35:23,128,84,212,1,1,2
2,201392387,2170660915,2759,36895,2024-10-04 19:35:23,0,0,0,0,0,0
2,201392387,2170660915,39639,36895,2024-10-04 19:35:24,0,0,0,0,0,0
2,201392387,2170660915,22663,36895,2024-10-04 19:35:24,0,0,0,0,0,0
2,201392387,2170660915,0,0,2024-10-04 19:35:24,128,84,212,1,1,2
2,201392387,2170660915,2759,36895,2024-10-04 19:35:24,0,0,0,0,0,0
2,201392387,2170660915,39639,36895,2024-10-04 19:35:25,0,0,0,0,0,0
2,201392387,2170660915,22663,36895,2024-10-04 19:35:25,0,0,0,0,0,0
2,201392387,2170660915,0,0,2024-10-04 19:35:25,0,0,0,0,0,0
2,201392387,2170660915,2759,36895,2024-10-04 19:35:25,0,0,0,0,0,0
2,201392387,2170660915,39639,36895,2024-10-04 19:35:26,0,0,0,0,0,0
2,201392387,2170660915,22663,36895,2024-10-04 19:35:26,0,0,0,0,0,0
2,201392387,2170660915,43742,36895,2024-10-04 19:35:26,666,507,1173,6,6,12
2,201392387,2170660915,0,0,2024-10-04 19:35:26,0,0,0,0,0,0
2,201392387,2170660915,2759,36895,2024-10-04 19:35:26,0,0,0,0,0,0
2,201392387,2170660915,39639,36895,2024-10-04 19:35:27,0,0,0,0,0,0
2,201392387,2170660915,22663,36895,2024-10-04 19:35:27,0,0,0,0,0,0
2,201392387,2170660915,43742,36895,2024-10-04 19:35:27,0,0,0,0,0,0
2,201392387,2170660915,0,0,2024-10-04 19:35:27,128,84,212,1,1,2
2,201392387,2170660915,2759,36895,2024-10-04 19:35:27,0,0,0,0,0,0
2,201392387,2170660915,39639,36895,2024-10-04 19:35:28,0,0,0,0,0,0
2,201392387,2170660915,22663,36895,2024-10-04 19:35:28,0,0,0,0,0,0
2,201392387,2170660915,43742,36895,2024-10-04 19:35:28,0,0,0,0,0,0
2,201392387,2170660915,0,0,2024-10-04 19:35:28,256,84,340,2,1,3
2,201392387,2170660915,2759,36895,2024-10-04 19:35:28,0,0,0,0,0,0
2,201392387,2170660915,39639,36895,2024-10-04 19:35:29,0,0,0,0,0,0
2,201392387,2170660915,22663,36895,2024-10-04 19:35:29,0,0,0,0,0,0
2,201392387,2170660915,43742,36895,2024-10-04 19:35:29,0,0,0,0,0,0
2,201392387,2170660915,0,0,2024-10-04 19:35:29,0,84,84,0,1,1
2,201392387,2170660915,2759,36895,2024-10-04 19:35:29,0,0,0,0,0,0
2,201392387,2170660915,39639,36895,2024-10-04 19:35:30,0,0,0,0,0,0
2,201392387,2170660915,22663,36895,2024-10-04 19:35:30,0,0,0,0,0,0
2,201392387,2170660915,43742,36895,2024-10-04 19:35:30,0,0,0,0,0,0
2,201392387,2170660915,0,0,2024-10-04 19:35:30,0,0,0,0,0,0
2,201392387,2170660915,2759,36895,2024-10-04 19:35:30,0,0,0,0,0,0
2,201392387,2170660915,39639,36895,2024-10-04 19:35:31,0,0,0,0,0,0
2,201392387,2170660915,22663,36895,2024-10-04 19:35:31,0,0,0,0,0,0
2,201392387,2170660915,43742,36895,2024-10-04 19:35:31,0,0,0,0,0,0
2,201392387,2170660915,0,0,2024-10-04 19:35:31,0,0,0,0,0,0
2,201392387,2170660915,2759,36895,2024-10-04 19:35:31,0,0,0,0,0,0
2,201392387,2170660915,39639,36895,2024-10-04 19:35:32,0,0,0,0,0,0
2,201392387,2170660915,22663,36895,2024-10-04 19:35:32,0,0,0,0,0,0
2,201392387,2170660915,43742,36895,2024-10-04 19:35:32,0,0,0,0,0,0
2,201392387,2170660915,0,0,2024-10-04 19:35:32,128,84,212,1,1,2
2,201392387,2170660915,2759,36895,2024-10-04 19:35:32,0,0,0,0,0,0
2,201392387,2170660915,39639,36895,2024-10-04 19:35:33,0,0,0,0,0,0
2,201392387,2170660915,22663,36895,2024-10-04 19:35:33,0,0,0,0,0,0
2,201392387,2170660915,43742,36895,2024-10-04 19:35:33,0,0,0,0,0,0
2,201392387,2170660915,0,0,2024-10-04 19:35:33,128,84,212,1,1,2
2,201392387,2170660915,2759,36895,2024-10-04 19:35:33,0,0,0,0,0,0
2,201392387,2170660915,39639,36895,2024-10-04 19:35:34,0,0,0,0,0,0
2,201392387,2170660915,22663,36895,2024-10-04 19:35:34,0,0,0,0,0,0
2,201392387,1145490692,42217,47873,2024-10-04 19:35:34,1005,2952,3957,5,4,9
2,201392387,2170660915,0,0,2024-10-04 19:35:34,128,84,212,1,1,2
2,201392387,2170660915,2759,36895,2024-10-04 19:35:34,0,0,0,0,0,0
2,201392387,2170660915,39639,36895,2024-10-04 19:35:35,0,0,0,0,0,0
2,201392387,2170660915,22663,36895,2024-10-04 19:35:35,0,0,0,0,0,0
2,201392387,1145490692,42217,47873,2024-10-04 19:35:35,4127,81174,85301,37,60,97
2,201392387,2170660915,0,0,2024-10-04 19:35:35,0,0,0,0,0,0
2,201392387,2170660915,2759,36895,2024-10-04 19:35:35,0,0,0,0,0,0
2,201392387,2170660915,39639,36895,2024-10-04 19:35:36,0,0,0,0,0,0
2,201392387,2170660915,22663,36895,2024-10-04 19:35:36,0,0,0,0,0,0
2,201392387,1145490692,42217,47873,2024-10-04 19:35:36,0,0,0,0,0,0
2,201392387,2170660915,0,0,2024-10-04 19:35:36,0,0,0,0,0,0
2,201392387,2170660915,2759,36895,2024-10-04 19:35:36,0,0,0,0,0,0
2,201392387,2170660915,39639,36895,2024-10-04 19:35:37,0,0,0,0,0,0
2,201392387,2170660915,22663,36895,2024-10-04 19:35:37,0,0,0,0,0,0
2,201392387,1145490692,42217,47873,2024-10-04 19:35:37,0,0,0,0,0,0
2,201392387,2170660915,0,0,2024-10-04 19:35:37,0,0,0,0,0,0
2,201392387,2170660915,2759,36895,2024-10-04 19:35:37,0,0,0,0,0,0
2,201392387,2170660915,39639,36895,2024-10-04 19:35:38,0,0,0,0,0,0
2,201392387,2170660915,22663,36895,2024-10-04 19:35:38,0,0,0,0,0,0
2,201392387,1145490692,42217,47873,2024-10-04 19:35:38,0,0,0,0,0,0
2,201392387,2170660915,0,0,2024-10-04 19:35:38,0,0,0,0,0,0
2,201392387,2170660915,2759,36895,2024-10-04 19:35:38,0,0,0,0,0,0
2,201392387,2170660915,39639,36895,2024-10-04 19:35:39,0,0,0,0,0,0
2,201392387,2170660915,22663,36895,2024-10-04 19:35:39,0,0,0,0,0,0
2,201392387,1145490692,42217,47873,2024-10-04 19:35:39,0,0,0,0,0,0
2,201392387,2170660915,0,0,2024-10-04 19:35:39,0,0,0,0,0,0
2,201392387,2170660915,2759,36895,2024-10-04 19:35:39,0,0,0,0,0,0
2,201392387,2170660915,39639,36895,2024-10-04 19:35:40,0,0,0,0,0,0
2,201392387,2170660915,22663,36895,2024-10-04 19:35:40,0,0,0,0,0,0
2,201392387,1145490692,42217,47873,2024-10-04 19:35:40,0,0,0,0,0,0
2,201392387,2170660915,0,0,2024-10-04 19:35:40,0,0,0,0,0,0
2,201392387,2170660915,2759,36895,2024-10-04 19:35:40,0,0,0,0,0,0
2,201392387,2170660915,39639,36895,2024-10-04 19:35:41,0,0,0,0,0,0
2,201392387,2170660915,22663,36895,2024-10-04 19:35:41,0,0,0,0,0,0
2,201392387,1145490692,42217,47873,2024-10-04 19:35:41,0,0,0,0,0,0
2,201392387,2170660915,0,0,2024-10-04 19:35:41,0,0,0,0,0,0
2,201392387,2170660915,2759,36895,2024-10-04 19:35:41,0,0,0,0,0,0
2,201392387,2170660915,39639,36895,2024-10-04 19:35:42,0,0,0,0,0,0
2,201392387,2170660915,22663,36895,2024-10-04 19:35:42,0,0,0,0,0,0
2,201392387,1145490692,42217,47873,2024-10-04 19:35:42,0,0,0,0,0,0
2,201392387,2170660915,0,0,2024-10-04 19:35:42,0,0,0,0,0,0
2,201392387,2170660915,2759,36895,2024-10-04 19:35:42,0,0,0,0,0,0
2,201392387,2170660915,39639,36895,2024-10-04 19:35:43,0,0,0,0,0,0
2,201392387,2170660915,22663,36895,2024-10-04 19:35:43,0,0,0,0,0,0
2,201392387,1145490692,42217,47873,2024-10-04 19:35:43,0,0,0,0,0,0
2,201392387,2170660915,0,0,2024-10-04 19:35:43,0,0,0,0,0,0
2,201392387,2170660915,2759,36895,2024-10-04 19:35:43,0,0,0,0,0,0
2,201392387,2170660915,39639,36895,2024-10-04 19:35:44,0,0,0,0,0,0
2,201392387,2170660915,22663,36895,2024-10-04 19:35:44,0,0,0,0,0,0
2,201392387,1145490692,42217,47873,2024-10-04 19:35:44,1332,19318,20650,13,17,30
2,201392387,2170660915,0,0,2024-10-04 19:35:44,0,0,0,0,0,0
2,201392387,2170660915,2759,36895,2024-10-04 19:35:44,0,0,0,0,0,0
2,201392387,2170660915,39639,36895,2024-10-04 19:35:45,0,0,0,0,0,0
2,201392387,2170660915,22663,36895,2024-10-04 19:35:45,0,0,0,0,0,0
2,201392387,1145490692,42217,47873,2024-10-04 19:35:45,0,0,0,0,0,0
2,201392387,2170660915,0,0,2024-10-04 19:35:45,0,0,0,0,0,0
2,201392387,2170660915,2759,36895,2024-10-04 19:35:45,0,0,0,0,0,0
2,201392387,2170660915,39639,36895,2024-10-04 19:35:46,0,0,0,0,0,0
2,201392387,2170660915,22663,36895,2024-10-04 19:35:46,0,0,0,0,0,0
2,201392387,1145490692,42217,47873,2024-10-04 19:35:46,0,0,0,0,0,0
2,201392387,2170660915,0,0,2024-10-04 19:35:46,128,84,212,1,1,2
2,201392387,2170660915,2759,36895,2024-10-04 19:35:46,0,0,0,0,0,0
2,201392387,2170660915,39639,36895,2024-10-04 19:35:47,0,0,0,0,0,0
2,201392387,2170660915,22663,36895,2024-10-04 19:35:47,0,0,0,0,0,0
2,201392387,2170660915,0,0,2024-10-04 19:35:47,128,84,212,1,1,2
2,201392387,2170660915,2759,36895,2024-10-04 19:35:47,0,0,0,0,0,0
2,201392387,2170660915,39639,36895,2024-10-04 19:35:48,0,0,0,0,0,0
2,201392387,2170660915,22663,36895,2024-10-04 19:35:48,0,0,0,0,0,0
2,201392387,2170660915,0,0,2024-10-04 19:35:48,128,84,212,1,1,2
2,201392387,2170660915,2759,36895,2024-10-04 19:35:48,0,0,0,0,0,0
2,201392387,2170660915,39639,36895,2024-10-04 19:35:49,0,0,0,0,0,0
2,201392387,2170660915,22663,36895,2024-10-04 19:35:49,0,0,0,0,0,0
2,201392387,2170660915,0,0,2024-10-04 19:35:49,128,84,212,1,1,2
2,201392387,2170660915,2759,36895,2024-10-04 19:35:49,0,0,0,0,0,0
2,201392387,2170660915,39639,36895,2024-10-04 19:35:50,0,0,0,0,0,0
2,201392387,2170660915,22663,36895,2024-10-04 19:35:50,0,0,0,0,0,0
2,201392387,2170660915,0,0,2024-10-04 19:35:50,128,84,212,1,1,2
2,201392387,2170660915,2759,36895,2024-10-04 19:35:50,0,0,0,0,0,0
2,201392387,2170660915,39639,36895,2024-10-04 19:35:51,0,0,0,0,0,0
2,201392387,2170660915,22663,36895,2024-10-04 19:35:51,0,0,0,0,0,0
2,201392387,2170660915,0,0,2024-10-04 19:35:51,128,84,212,1,1,2
2,201392387,2170660915,2759,36895,2024-10-04 19:35:51,0,0,0,0,0,0
2,201392387,2170660915,39639,36895,2024-10-04 19:35:52,0,0,0,0,0,0
2,201392387,2170660915,22663,36895,2024-10-04 19:35:52,0,0,0,0,0,0
2,201392387,2170660915,0,0,2024-10-04 19:35:52,128,84,212,1,1,2
2,201392387,2170660915,2759,36895,2024-10-04 19:35:52,0,0,0,0,0,0
2,201392387,2170660915,39639,36895,2024-10-04 19:35:53,0,0,0,0,0,0
2,201392387,2170660915,22663,36895,2024-10-04 19:35:53,0,0,0,0,0,0
2,201392387,2170660915,0,0,2024-10-04 19:35:53,128,84,212,1,1,2
2,201392387,2170660915,2759,36895,2024-10-04 19:35:53,0,0,0,0,0,0
2,201392387,2170660915,39639,36895,2024-10-04 19:35:54,0,0,0,0,0,0
2,201392387,2170660915,22663,36895,2024-10-04 19:35:54,0,0,0,0,0,0
2,201392387,2170660915,0,0,2024-10-04 19:35:54,128,84,212,1,1,2
2,201392387,2170660915,2759,36895,2024-10-04 19:35:54,0,0,0,0,0,0
2,201392387,2170660915,39639,36895,2024-10-04 19:35:55,0,0,0,0,0,0
2,201392387,2170660915,22663,36895,2024-10-04 19:35:55,0,0,0,0,0,0
2,201392387,2170660915,0,0,2024-10-04 19:35:55,0,0,0,0,0,0
2,201392387,2170660915,2759,36895,2024-10-04 19:35:55,0,0,0,0,0,0
2,201392387,2170660915,39639,36895,2024-10-04 19:35:56,0,0,0,0,0,0
2,201392387,2170660915,22663,36895,2024-10-04 19:35:56,0,0,0,0,0,0
2,201392387,2170660915,0,0,2024-10-04 19:35:56,128,84,212,1,1,2
2,201392387,2170660915,39639,36895,2024-10-04 19:35:57,0,0,0,0,0,0
2,201392387,2170660915,22663,36895,2024-10-04 19:35:57,0,0,0,0,0,0
2,201392387,2170660915,0,0,2024-10-04 19:35:57,0,0,0,0,0,0
2,201392387,2170660915,39639,36895,2024-10-04 19:35:58,0,0,0,0,0,0
2,201392387,2170660915,22663,36895,2024-10-04 19:35:58,0,0,0,0,0,0
2,201392387,2170660915,16070,36895,2024-10-04 19:35:58,570,455,1025,5,5,10
2,201392387,2170660915,0,0,2024-10-04 19:35:58,128,0,128,1,0,1
2,201392387,2170660915,39639,36895,2024-10-04 19:35:59,0,0,0,0,0,0
2,201392387,2170660915,22663,36895,2024-10-04 19:35:59,0,0,0,0,0,0
2,201392387,2170660915,16070,36895,2024-10-04 19:35:59,0,0,0,0,0,0
2,201392387,2170660915,0,0,2024-10-04 19:35:59,128,84,212,1,1,2
2,201392387,2170660915,39639,36895,2024-10-04 19:36:00,0,0,0,0,0,0
2,201392387,2170660915,22663,36895,2024-10-04 19:36:00,0,0,0,0,0,0
2,201392387,2170660915,16070,36895,2024-10-04 19:36:00,0,0,0,0,0,0
2,201392387,2170660915,0,0,2024-10-04 19:36:00,128,84,212,1,1,2
2,201392387,2170660915,39639,36895,2024-10-04 19:36:01,0,0,0,0,0,0
2,201392387,2170660915,22663,36895,2024-10-04 19:36:01,0,0,0,0,0,0
2,201392387,2170660915,16070,36895,2024-10-04 19:36:01,0,0,0,0,0,0
2,201392387,2170660915,0,0,2024-10-04 19:36:01,0,84,84,0,1,1
2,201392387,2170660915,39639,36895,2024-10-04 19:36:02,0,0,0,0,0,0
2,201392387,2170660915,22663,36895,2024-10-04 19:36:02,0,0,0,0,0,0
2,201392387,2170660915,16070,36895,2024-10-04 19:36:02,0,0,0,0,0,0
2,201392387,2170660915,0,0,2024-10-04 19:36:02,0,0,0,0,0,0
2,201392387,2170660915,39639,36895,2024-10-04 19:36:03,0,0,0,0,0,0
2,201392387,2170660915,22663,36895,2024-10-04 19:36:03,0,0,0,0,0,0
2,201392387,2170660915,16070,36895,2024-10-04 19:36:03,0,0,0,0,0,0
2,201392387,2170660915,0,0,2024-10-04 19:36:03,128,0,128,1,0,1
2,201392387,2170660915,39639,36895,2024-10-04 19:36:04,0,0,0,0,0,0
2,201392387,2170660915,22663,36895,2024-10-04 19:36:04,0,0,0,0,0,0
2,201392387,2170660915,16070,36895,2024-10-04 19:36:04,0,0,0,0,0,0
2,201392387,2170660915,0,0,2024-10-04 19:36:04,128,84,212,1,1,2
2,201392387,2170660915,39639,36895,2024-10-04 19:36:05,0,0,0,0,0,0
2,201392387,2170660915,22663,36895,2024-10-04 19:36:05,0,0,0,0,0,0
2,201392387,2170660915,16070,36895,2024-10-04 19:36:05,0,0,0,0,0,0
2,201392387,2170660915,0,0,2024-10-04 19:36:05,128,84,212,1,1,2
2,201392387,2170660915,39639,36895,2024-10-04 19:36:06,0,0,0,0,0,0
2,201392387,2170660915,22663,36895,2024-10-04 19:36:06,0,0,0,0,0,0
2,201392387,1145490690,63146,47873,2024-10-04 19:36:06,4896,73729,78625,39,55,94
2,201392387,2170660915,16070,36895,2024-10-04 19:36:06,0,0,0,0,0,0
2,201392387,2170660915,0,0,2024-10-04 19:36:06,0,84,84,0,1,1
2,201392387,2170660915,39639,36895,2024-10-04 19:36:07,0,0,0,0,0,0
2,201392387,2170660915,22663,36895,2024-10-04 19:36:07,0,0,0,0,0,0
2,201392387,1145490690,63146,47873,2024-10-04 19:36:07,384,13816,14200,4,8,12
2,201392387,2170660915,16070,36895,2024-10-04 19:36:07,0,0,0,0,0,0
2,201392387,2170660915,0,0,2024-10-04 19:36:07,0,0,0,0,0,0
2,201392387,2170660915,39639,36895,2024-10-04 19:36:08,0,0,0,0,0,0
2,201392387,2170660915,22663,36895,2024-10-04 19:36:08,0,0,0,0,0,0
2,201392387,1145490690,63146,47873,2024-10-04 19:36:08,1188,27210,28398,12,17,29
2,201392387,2170660915,16070,36895,2024-10-04 19:36:08,0,0,0,0,0,0
2,201392387,2170660915,0,0,2024-10-04 19:36:08,0,0,0,0,0,0
2,201392387,2170660915,39639,36895,2024-10-04 19:36:09,0,0,0,0,0,0
2,201392387,2170660915,22663,36895,2024-10-04 19:36:09,0,0,0,0,0,0
2,201392387,1145490690,63146,47873,2024-10-04 19:36:09,0,0,0,0,0,0
2,201392387,2170660915,16070,36895,2024-10-04 19:36:09,0,0,0,0,0,0
2,201392387,2170660915,0,0,2024-10-04 19:36:09,0,0,0,0,0,0
2,201392387,2170660915,39639,36895,2024-10-04 19:36:10,0,0,0,0,0,0
2,201392387,2170660915,22663,36895,2024-10-04 19:36:10,0,0,0,0,0,0
2,201392387,1145490690,63146,47873,2024-10-04 19:36:10,0,0,0,0,0,0
2,201392387,2170660915,16070,36895,2024-10-04 19:36:10,0,0,0,0,0,0
2,201392387,2170660915,0,0,2024-10-04 19:36:10,0,0,0,0,0,0
2,201392387,2170660915,39639,36895,2024-10-04 19:36:11,0,0,0,0,0,0
2,201392387,2170660915,22663,36895,2024-10-04 19:36:11,0,0,0,0,0,0
2,201392387,1145490690,63146,47873,2024-10-04 19:36:11,0,0,0,0,0,0
2,201392387,2170660915,16070,36895,2024-10-04 19:36:11,0,0,0,0,0,0
2,201392387,2170660915,0,0,2024-10-04 19:36:11,0,0,0,0,0,0
2,201392387,2170660915,39639,36895,2024-10-04 19:36:12,0,0,0,0,0,0
2,201392387,2170660915,22663,36895,2024-10-04 19:36:12,0,0,0,0,0,0
2,201392387,1145490690,63146,47873,2024-10-04 19:36:12,0,0,0,0,0,0
2,201392387,2170660915,16070,36895,2024-10-04 19:36:12,0,0,0,0,0,0
2,201392387,2170660915,0,0,2024-10-04 19:36:12,0,0,0,0,0,0
2,201392387,2170660915,39639,36895,2024-10-04 19:36:13,0,0,0,0,0,0
2,201392387,2170660915,22663,36895,2024-10-04 19:36:13,0,0,0,0,0,0
2,201392387,1145490690,63146,47873,2024-10-04 19:36:13,0,0,0,0,0,0
2,201392387,2170660915,16070,36895,2024-10-04 19:36:13,0,0,0,0,0,0
2,201392387,2170660915,0,0,2024-10-04 19:36:13,0,0,0,0,0,0
2,201392387,2170660915,39639,36895,2024-10-04 19:36:14,0,0,0,0,0,0
2,201392387,2170660915,22663,36895,2024-10-04 19:36:14,0,0,0,0,0,0
2,201392387,1145490690,63146,47873,2024-10-04 19:36:14,0,0,0,0,0,0
2,201392387,2170660915,16070,36895,2024-10-04 19:36:14,0,0,0,0,0,0
2,201392387,2170660915,0,0,2024-10-04 19:36:14,0,0,0,0,0,0
2,201392387,2170660915,39639,36895,2024-10-04 19:36:15,0,0,0,0,0,0
2,201392387,2170660915,22663,36895,2024-10-04 19:36:15,0,0,0,0,0,0
2,201392387,1145490690,63146,47873,2024-10-04 19:36:15,900,6817,7717,9,7,16
2,201392387,2170660915,16070,36895,2024-10-04 19:36:15,0,0,0,0,0,0
2,201392387,2170660915,0,0,2024-10-04 19:36:15,0,0,0,0,0,0
2,201392387,2170660915,39639,36895,2024-10-04 19:36:16,0,0,0,0,0,0
2,201392387,2170660915,22663,36895,2024-10-04 19:36:16,0,0,0,0,0,0
2,201392387,1145490690,63146,47873,2024-10-04 19:36:16,0,0,0,0,0,0
2,201392387,2170660915,16070,36895,2024-10-04 19:36:16,0,0,0,0,0,0
2,201392387,2170660915,0,0,2024-10-04 19:36:16,0,0,0,0,0,0
2,201392387,2170660915,39639,36895,2024-10-04 19:36:17,0,0,0,0,0,0
2,201392387,2170660915,22663,36895,2024-10-04 19:36:17,0,0,0,0,0,0
2,201392387,1145490690,63146,47873,2024-10-04 19:36:17,0,0,0,0,0,0
2,201392387,2170660915,16070,36895,2024-10-04 19:36:17,0,0,0,0,0,0
2,201392387,2170660915,0,0,2024-10-04 19:36:17,0,0,0,0,0,0
2,201392387,2170660915,39639,36895,2024-10-04 19:36:18,0,0,0,0,0,0
2,201392387,2170660915,22663,36895,2024-10-04 19:36:18,0,0,0,0,0,0
2,201392387,1145490690,63146,47873,2024-10-04 19:36:18,0,0,0,0,0,0
2,201392387,2170660915,16070,36895,2024-10-04 19:36:18,0,0,0,0,0,0
2,201392387,2170660915,0,0,2024-10-04 19:36:18,0,0,0,0,0,0
2,201392387,2170660915,39639,36895,2024-10-04 19:36:19,0,0,0,0,0,0
2,201392387,2170660915,22663,36895,2024-10-04 19:36:19,0,0,0,0,0,0
2,201392387,1145490690,63146,47873,2024-10-04 19:36:19,0,0,0,0,0,0
2,201392387,2170660915,16070,36895,2024-10-04 19:36:19,0,0,0,0,0,0
2,201392387,2170660915,0,0,2024-10-04 19:36:19,128,84,212,1,1,2
2,201392387,2170660915,39639,36895,2024-10-04 19:36:20,0,0,0,0,0,0
2,201392387,2170660915,22663,36895,2024-10-04 19:36:20,0,0,0,0,0,0
2,201392387,1145490690,63146,47873,2024-10-04 19:36:20,0,0,0,0,0,0
2,201392387,2170660915,16070,36895,2024-10-04 19:36:20,0,0,0,0,0,0
2,201392387,2170660915,0,0,2024-10-04 19:36:20,128,84,212,1,1,2
2,201392387,2170660915,39639,36895,2024-10-04 19:36:21,0,0,0,0,0,0
2,201392387,2170660915,22663,36895,2024-10-04 19:36:21,0,0,0,0,0,0
2,201392387,1145490690,63146,47873,2024-10-04 19:36:21,0,0,0,0,0,0
2,201392387,2170660915,16070,36895,2024-10-04 19:36:21,0,0,0,0,0,0
2,201392387,2170660915,0,0,2024-10-04 19:36:21,128,84,212,1,1,2
2,201392387,2170660915,39639,36895,2024-10-04 19:36:22,0,0,0,0,0,0
2,201392387,2170660915,22663,36895,2024-10-04 19:36:22,0,0,0,0,0,0
2,201392387,1145490690,63146,47873,2024-10-04 19:36:22,0,0,0,0,0,0
2,201392387,2170660915,16070,36895,2024-10-04 19:36:22,0,0,0,0,0,0
2,201392387,2170660915,0,0,2024-10-04 19:36:22,128,84,212,1,1,2
2,201392387,2170660915,39639,36895,2024-10-04 19:36:23,0,0,0,0,0,0
2,201392387,2170660915,22663,36895,2024-10-04 19:36:23,0,0,0,0,0,0
2,201392387,1145490690,63146,47873,2024-10-04 19:36:23,0,0,0,0,0,0
2,201392387,2170660915,16070,36895,2024-10-04 19:36:23,0,0,0,0,0,0
2,201392387,2170660915,0,0,2024-10-04 19:36:23,128,84,212,1,1,2
2,201392387,2170660915,39639,36895,2024-10-04 19:36:24,0,0,0,0,0,0
2,201392387,2170660915,22663,36895,2024-10-04 19:36:24,0,0,0,0,0,0
2,201392387,1145490690,63146,47873,2024-10-04 19:36:24,0,0,0,0,0,0
2,201392387,2170660915,16070,36895,2024-10-04 19:36:24,0,0,0,0,0,0
2,201392387,2170660915,0,0,2024-10-04 19:36:24,128,84,212,1,1,2
2,201392387,2170660915,39639,36895,2024-10-04 19:36:25,0,0,0,0,0,0
2,201392387,2170660915,22663,36895,2024-10-04 19:36:25,0,0,0,0,0,0
2,201392387,2170660915,16070,36895,2024-10-04 19:36:25,0,0,0,0,0,0
2,201392387,2170660915,0,0,2024-10-04 19:36:25,128,84,212,1,1,2
2,201392387,2170660915,39639,36895,2024-10-04 19:36:26,0,0,0,0,0,0
2,201392387,2170660915,22663,36895,2024-10-04 19:36:26,0,0,0,0,0,0
2,201392387,2170660915,16070,36895,2024-10-04 19:36:26,0,0,0,0,0,0
2,201392387,2170660915,0,0,2024-10-04 19:36:26,0,0,0,0,0,0
2,201392387,2170660915,39639,36895,2024-10-04 19:36:27,0,0,0,0,0,0
2,201392387,2170660915,22663,36895,2024-10-04 19:36:27,0,0,0,0,0,0
2,201392387,2170660915,0,0,2024-10-04 19:36:27,256,84,340,2,1,3
2,201392387,2170660915,39639,36895,2024-10-04 19:36:28,0,0,0,0,0,0
2,201392387,2170660915,22663,36895,2024-10-04 19:36:28,0,0,0,0,0,0
2,201392387,2170660915,0,0,2024-10-04 19:36:28,128,84,212,1,1,2
2,201392387,2170660915,39639,36895,2024-10-04 19:36:29,0,0,0,0,0,0
2,201392387,2170660915,22663,36895,2024-10-04 19:36:29,0,0,0,0,0,0
2,201392387,2170660915,0,0,2024-10-04 19:36:29,0,84,84,0,1,1
2,201392387,2170660915,39639,36895,2024-10-04 19:36:30,0,0,0,0,0,0
2,201392387,2170660915,22663,36895,2024-10-04 19:36:30,0,0,0,0,0,0
2,201392387,2170660915,38058,36895,2024-10-04 19:36:30,666,507,1173,6,6,12
2,201392387,2170660915,0,0,2024-10-04 19:36:30,128,0,128,1,0,1
2,201392387,2170660915,39639,36895,2024-10-04 19:36:31,0,0,0,0,0,0
2,201392387,2170660915,22663,36895,2024-10-04 19:36:31,0,0,0,0,0,0
2,201392387,2170660915,38058,36895,2024-10-04 19:36:31,0,0,0,0,0,0
2,201392387,2170660915,0,0,2024-10-04 19:36:31,128,84,212,1,1,2
2,201392387,2170660915,39639,36895,2024-10-04 19:36:32,0,0,0,0,0,0
2,201392387,2170660915,22663,36895,2024-10-04 19:36:32,0,0,0,0,0,0
2,201392387,2170660915,38058,36895,2024-10-04 19:36:32,0,0,0,0,0,0
2,201392387,2170660915,0,0,2024-10-04 19:36:32,128,84,212,1,1,2
2,201392387,2170660915,39639,36895,2024-10-04 19:36:33,0,0,0,0,0,0
2,201392387,2170660915,22663,36895,2024-10-04 19:36:33,0,0,0,0,0,0
2,201392387,2170660915,38058,36895,2024-10-04 19:36:33,0,0,0,0,0,0
2,201392387,2170660915,0,0,2024-10-04 19:36:33,0,84,84,0,1,1
2,201392387,2170660915,39639,36895,2024-10-04 19:36:34,0,0,0,0,0,0
2,201392387,2170660915,22663,36895,2024-10-04 19:36:34,0,0,0,0,0,0
2,201392387,2170660915,38058,36895,2024-10-04 19:36:34,0,0,0,0,0,0
2,201392387,2170660915,0,0,2024-10-04 19:36:34,0,0,0,0,0,0
2,201392387,2170660915,39639,36895,2024-10-04 19:36:35,0,0,0,0,0,0
2,201392387,2170660915,22663,36895,2024-10-04 19:36:35,0,0,0,0,0,0
2,201392387,2170660915,38058,36895,2024-10-04 19:36:35,0,0,0,0,0,0
2,201392387,2170660915,0,0,2024-10-04 19:36:35,0,0,0,0,0,0
2,201392387,2170660915,39639,36895,2024-10-04 19:36:36,0,0,0,0,0,0
2,201392387,2170660915,22663,36895,2024-10-04 19:36:36,0,0,0,0,0,0
2,201392387,2170660915,0,0,2024-10-04 19:36:36,128,0,128,1,0,1
2,201392387,2170660915,39639,36895,2024-10-04 19:36:37,0,0,0,0,0,0
2,201392387,2170660915,22663,36895,2024-10-04 19:36:37,0,0,0,0,0,0
2,201392387,2170660915,0,0,2024-10-04 19:36:37,128,84,212,1,1,2
2,201392387,2170660915,39639,36895,2024-10-04 19:36:38,0,0,0,0,0,0
2,201392387,2170660915,22663,36895,2024-10-04 19:36:38,0,0,0,0,0,0
2,201392387,1145490691,14493,47873,2024-10-04 19:36:38,5316,77389,82705,44,62,106
2,201392387,2170660915,0,0,2024-10-04 19:36:38,128,168,296,1,2,3
2,201392387,2170660915,39639,36895,2024-10-04 19:36:39,0,0,0,0,0,0
2,201392387,2170660915,22663,36895,2024-10-04 19:36:39,0,0,0,0,0,0
2,201392387,1145490691,14493,47873,2024-10-04 19:36:39,0,0,0,0,0,0
2,201392387,2170660915,0,0,2024-10-04 19:36:39,0,0,0,0,0,0
2,201392387,2170660915,39639,36895,2024-10-04 19:36:40,0,0,0,0,0,0
2,201392387,2170660915,22663,36895,2024-10-04 19:36:40,0,0,0,0,0,0
2,201392387,1145490691,14493,47873,2024-10-04 19:36:40,0,0,0,0,0,0
2,201392387,2170660915,0,0,2024-10-04 19:36:40,0,0,0,0,0,0
2,201392387,2170660915,39639,36895,2024-10-04 19:36:41,0,0,0,0,0,0
2,201392387,2170660915,22663,36895,2024-10-04 19:36:41,0,0,0,0,0,0
2,201392387,1145490691,14493,47873,2024-10-04 19:36:41,0,0,0,0,0,0
2,201392387,2170660915,0,0,2024-10-04 19:36:41,0,0,0,0,0,0
2,201392387,2170660915,39639,36895,2024-10-04 19:36:42,0,0,0,0,0,0
2,201392387,2170660915,22663,36895,2024-10-04 19:36:42,0,0,0,0,0,0
2,201392387,1145490691,14493,47873,2024-10-04 19:36:42,0,0,0,0,0,0
2,201392387,2170660915,0,0,2024-10-04 19:36:42,0,0,0,0,0,0
2,201392387,2170660915,39639,36895,2024-10-04 19:36:43,0,0,0,0,0,0
2,201392387,2170660915,22663,36895,2024-10-04 19:36:43,0,0,0,0,0,0
2,201392387,1145490691,14493,47873,2024-10-04 19:36:43,0,0,0,0,0,0
2,201392387,2170660915,0,0,2024-10-04 19:36:43,0,0,0,0,0,0
2,201392387,2170660915,39639,36895,2024-10-04 19:36:44,0,0,0,0,0,0
2,201392387,2170660915,22663,36895,2024-10-04 19:36:44,0,0,0,0,0,0
2,201392387,1145490691,14493,47873,2024-10-04 19:36:44,0,0,0,0,0,0
2,201392387,2170660915,0,0,2024-10-04 19:36:44,0,0,0,0,0,0
2,201392387,2170660915,39639,36895,2024-10-04 19:36:45,0,0,0,0,0,0
2,201392387,2170660915,22663,36895,2024-10-04 19:36:45,0,0,0,0,0,0
2,201392387,1145490691,14493,47873,2024-10-04 19:36:45,912,11691,12603,9,10,19
2,201392387,2170660915,0,0,2024-10-04 19:36:45,0,0,0,0,0,0
2,201392387,2170660915,39639,36895,2024-10-04 19:36:46,0,0,0,0,0,0
2,201392387,2170660915,22663,36895,2024-10-04 19:36:46,0,0,0,0,0,0
2,201392387,1145490691,14493,47873,2024-10-04 19:36:46,0,0,0,0,0,0
2,201392387,2170660915,0,0,2024-10-04 19:36:46,0,0,0,0,0,0
2,201392387,2170660915,39639,36895,2024-10-04 19:36:47,0,0,0,0,0,0
2,201392387,2170660915,22663,36895,2024-10-04 19:36:47,0,0,0,0,0,0
2,201392387,1145490691,14493,47873,2024-10-04 19:36:47,0,0,0,0,0,0
2,201392387,2170660915,0,0,2024-10-04 19:36:47,0,0,0,0,0,0
2,201392387,2170660915,39639,36895,2024-10-04 19:36:48,0,0,0,0,0,0
2,201392387,2170660915,22663,36895,2024-10-04 19:36:48,0,0,0,0,0,0
2,201392387,1145490691,14493,47873,2024-10-04 19:36:48,0,0,0,0,0,0
2,201392387,2170660915,0,0,2024-10-04 19:36:48,0,0,0,0,0,0
2,201392387,2170660915,39639,36895,2024-10-04 19:36:49,0,0,0,0,0,0
2,201392387,2170660915,22663,36895,2024-10-04 19:36:49,0,0,0,0,0,0
2,201392387,1145490691,14493,47873,2024-10-04 19:36:49,0,0,0,0,0,0
2,201392387,2170660915,0,0,2024-10-04 19:36:49,128,84,212,1,1,2
2,201392387,2170660915,39639,36895,2024-10-04 19:36:50,0,0,0,0,0,0
2,201392387,2170660915,22663,36895,2024-10-04 19:36:50,0,0,0,0,0,0
2,201392387,1145490691,14493,47873,2024-10-04 19:36:50,0,0,0,0,0,0
2,201392387,2170660915,0,0,2024-10-04 19:36:50,128,84,212,1,1,2
2,201392387,2170660915,39639,36895,2024-10-04 19:36:51,0,0,0,0,0,0
2,201392387,2170660915,22663,36895,2024-10-04 19:36:51,0,0,0,0,0,0
2,201392387,1145490691,14493,47873,2024-10-04 19:36:51,0,0,0,0,0,0
2,201392387,2170660915,0,0,2024-10-04 19:36:51,128,84,212,1,1,2
2,201392387,2170660915,39639,36895,2024-10-04 19:36:52,0,0,0,0,0,0
2,201392387,2170660915,22663,36895,2024-10-04 19:36:52,0,0,0,0,0,0
2,201392387,1145490691,14493,47873,2024-10-04 19:36:52,0,0,0,0,0,0
2,201392387,2170660915,0,0,2024-10-04 19:36:52,128,84,212,1,1,2
2,201392387,2170660915,39639,36895,2024-10-04 19:36:53,0,0,0,0,0,0
2,201392387,2170660915,22663,36895,2024-10-04 19:36:53,0,0,0,0,0,0
2,201392387,1145490691,14493,47873,2024-10-04 19:36:53,0,0,0,0,0,0
2,201392387,2170660915,0,0,2024-10-04 19:36:53,128,84,212,1,1,2
2,201392387,2170660915,39639,36895,2024-10-04 19:36:54,0,0,0,0,0,0
2,201392387,2170660915,22663,36895,2024-10-04 19:36:54,0,0,0,0,0,0
2,201392387,1145490691,14493,47873,2024-10-04 19:36:54,0,0,0,0,0,0
2,201392387,2170660915,0,0,2024-10-04 19:36:54,128,84,212,1,1,2
2,201392387,2170660915,39639,36895,2024-10-04 19:36:55,0,0,0,0,0,0
2,201392387,2170660915,22663,36895,2024-10-04 19:36:55,0,0,0,0,0,0
2,201392387,1145490691,14493,47873,2024-10-04 19:36:55,0,0,0,0,0,0
2,201392387,2170660915,0,0,2024-10-04 19:36:55,128,84,212,1,1,2
2,201392387,2170660915,39639,36895,2024-10-04 19:36:56,0,0,0,0,0,0
2,201392387,2170660915,22663,36895,2024-10-04 19:36:56,0,0,0,0,0,0
2,201392387,2170660915,0,0,2024-10-04 19:36:56,256,84,340,2,1,3
2,201392387,2170660915,39639,36895,2024-10-04 19:36:57,0,0,0,0,0,0
2,201392387,2170660915,22663,36895,2024-10-04 19:36:57,0,0,0,0,0,0
2,201392387,2170660915,0,0,2024-10-04 19:36:57,128,84,212,1,1,2
2,201392387,2170660915,39639,36895,2024-10-04 19:36:58,0,0,0,0,0,0
2,201392387,2170660915,22663,36895,2024-10-04 19:36:58,0,0,0,0,0,0
2,201392387,2170660915,0,0,2024-10-04 19:36:58,0,84,84,0,1,1
2,201392387,2170660915,39639,36895,2024-10-04 19:36:59,0,0,0,0,0,0
2,201392387,2170660915,22663,36895,2024-10-04 19:36:59,0,0,0,0,0,0
2,201392387,2170660915,0,0,2024-10-04 19:36:59,0,0,0,0,0,0
2,201392387,2170660915,39639,36895,2024-10-04 19:37:00,0,0,0,0,0,0
2,201392387,2170660915,22663,36895,2024-10-04 19:37:00,0,0,0,0,0,0
2,201392387,2170660915,12440,36895,2024-10-04 19:37:00,666,507,1173,6,6,12
2,201392387,2170660915,0,0,2024-10-04 19:37:00,128,0,128,1,0,1
2,201392387,2170660915,39639,36895,2024-10-04 19:37:01,0,0,0,0,0,0
2,201392387,2170660915,22663,36895,2024-10-04 19:37:01,0,0,0,0,0,0
2,201392387,2170660915,12440,36895,2024-10-04 19:37:01,0,0,0,0,0,0
2,201392387,2170660915,0,0,2024-10-04 19:37:01,128,84,212,1,1,2
2,201392387,2170660915,39639,36895,2024-10-04 19:37:02,0,0,0,0,0,0
2,201392387,2170660915,22663,36895,2024-10-04 19:37:02,0,0,0,0,0,0
2,201392387,2170660915,12440,36895,2024-10-04 19:37:02,0,0,0,0,0,0
2,201392387,2170660915,0,0,2024-10-04 19:37:02,128,168,296,1,2,3
2,201392387,2170660915,39639,36895,2024-10-04 19:37:03,0,0,0,0,0,0
2,201392387,2170660915,22663,36895,2024-10-04 19:37:03,0,0,0,0,0,0
2,201392387,2170660915,12440,36895,2024-10-04 19:37:03,0,0,0,0,0,0
2,201392387,2170660915,0,0,2024-10-04 19:37:03,0,0,0,0,0,0
2,201392387,2170660915,39639,36895,2024-10-04 19:37:04,0,0,0,0,0,0
2,201392387,2170660915,22663,36895,2024-10-04 19:37:04,0,0,0,0,0,0
2,201392387,2170660915,12440,36895,2024-10-04 19:37:04,0,0,0,0,0,0
2,201392387,2170660915,0,0,2024-10-04 19:37:04,0,0,0,0,0,0
2,201392387,2170660915,39639,36895,2024-10-04 19:37:05,0,0,0,0,0,0
2,201392387,2170660915,22663,36895,2024-10-04 19:37:05,0,0,0,0,0,0
2,201392387,2170660915,0,0,2024-10-04 19:37:05,0,0,0,0,0,0
2,201392387,2170660915,39639,36895,2024-10-04 19:37:06,0,0,0,0,0,0
2,201392387,2170660915,22663,36895,2024-10-04 19:37:06,0,0,0,0,0,0
2,201392387,2170660915,0,0,2024-10-04 19:37:06,256,84,340,2,1,3
2,201392387,2170660915,39639,36895,2024-10-04 19:37:07,0,0,0,0,0,0
2,201392387,2170660915,22663,36895,2024-10-04 19:37:07,0,0,0,0,0,0
2,201392387,2170660915,0,0,2024-10-04 19:37:07,128,84,212,1,1,2
2,201392387,2170660915,39639,36895,2024-10-04 19:37:08,0,0,0,0,0,0
2,201392387,2170660915,22663,36895,2024-10-04 19:37:08,0,0,0,0,0,0
2,201392387,1145490691,2762,47873,2024-10-04 19:37:08,4596,62331,66927,37,50,87
2,201392387,2170660915,0,0,2024-10-04 19:37:08,0,84,84,0,1,1
2,201392387,2170660915,39639,36895,2024-10-04 19:37:09,0,0,0,0,0,0
2,201392387,2170660915,22663,36895,2024-10-04 19:37:09,0,0,0,0,0,0
2,201392387,1145490691,2762,47873,2024-10-04 19:37:09,0,0,0,0,0,0
2,201392387,2170660915,0,0,2024-10-04 19:37:09,0,0,0,0,0,0
2,201392387,2170660915,39639,36895,2024-10-04 19:37:10,0,0,0,0,0,0
2,201392387,2170660915,22663,36895,2024-10-04 19:37:10,0,0,0,0,0,0
2,201392387,1145490691,2762,47873,2024-10-04 19:37:10,0,0,0,0,0,0
2,201392387,2170660915,0,0,2024-10-04 19:37:10,0,0,0,0,0,0
2,201392387,2170660915,39639,36895,2024-10-04 19:37:11,0,0,0,0,0,0
2,201392387,2170660915,22663,36895,2024-10-04 19:37:11,0,0,0,0,0,0
2,201392387,1145490691,2762,47873,2024-10-04 19:37:11,0,0,0,0,0,0
2,201392387,2170660915,0,0,2024-10-04 19:37:11,0,0,0,0,0,0
2,201392387,2170660915,39639,36895,2024-10-04 19:37:12,0,0,0,0,0,0
2,201392387,2170660915,22663,36895,2024-10-04 19:37:12,0,0,0,0,0,0
2,201392387,1145490691,2762,47873,2024-10-04 19:37:12,0,0,0,0,0,0
2,201392387,2170660915,0,0,2024-10-04 19:37:12,0,0,0,0,0,0
2,201392387,2170660915,39639,36895,2024-10-04 19:37:13,0,0,0,0,0,0
2,201392387,2170660915,22663,36895,2024-10-04 19:37:13,0,0,0,0,0,0
2,201392387,1145490691,2762,47873,2024-10-04 19:37:13,0,0,0,0,0,0
2,201392387,2170660915,0,0,2024-10-04 19:37:13,0,0,0,0,0,0
2,201392387,2170660915,39639,36895,2024-10-04 19:37:14,0,0,0,0,0,0
2,201392387,2170660915,22663,36895,2024-10-04 19:37:14,0,0,0,0,0,0
2,201392387,1145490691,2762,47873,2024-10-04 19:37:14,0,0,0,0,0,0
2,201392387,2170660915,0,0,2024-10-04 19:37:14,0,0,0,0,0,0
2,201392387,2170660915,39639,36895,2024-10-04 19:37:15,0,0,0,0,0,0
2,201392387,2170660915,22663,36895,2024-10-04 19:37:15,0,0,0,0,0,0
2,201392387,1145490691,2762,47873,2024-10-04 19:37:15,2100,30765,32865,21,23,44
2,201392387,2170660915,0,0,2024-10-04 19:37:15,0,0,0,0,0,0
2,201392387,2170660915,39639,36895,2024-10-04 19:37:16,0,0,0,0,0,0
2,201392387,2170660915,22663,36895,2024-10-04 19:37:16,0,0,0,0,0,0
2,201392387,1145490691,2762,47873,2024-10-04 19:37:16,0,0,0,0,0,0
2,201392387,2170660915,0,0,2024-10-04 19:37:16,0,0,0,0,0,0
2,201392387,2170660915,39639,36895,2024-10-04 19:37:17,0,0,0,0,0,0
2,201392387,2170660915,22663,36895,2024-10-04 19:37:17,0,0,0,0,0,0
2,201392387,1145490691,2762,47873,2024-10-04 19:37:17,0,0,0,0,0,0
2,201392387,2170660915,0,0,2024-10-04 19:37:17,0,0,0,0,0,0
2,201392387,2170660915,39639,36895,2024-10-04 19:37:18,0,0,0,0,0,0
2,201392387,2170660915,22663,36895,2024-10-04 19:37:18,0,0,0,0,0,0
2,201392387,1145490691,2762,47873,2024-10-04 19:37:18,0,0,0,0,0,0
2,201392387,2170660915,0,0,2024-10-04 19:37:18,0,0,0,0,0,0
2,201392387,2170660915,39639,36895,2024-10-04 19:37:19,0,0,0,0,0,0
2,201392387,2170660915,22663,36895,2024-10-04 19:37:19,0,0,0,0,0,0
2,201392387,1145490691,2762,47873,2024-10-04 19:37:19,0,0,0,0,0,0
2,201392387,2170660915,0,0,2024-10-04 19:37:19,128,84,212,1,1,2
2,201392387,2170660915,39639,36895,2024-10-04 19:37:20,0,0,0,0,0,0
2,201392387,2170660915,22663,36895,2024-10-04 19:37:20,0,0,0,0,0,0
2,201392387,1145490691,2762,47873,2024-10-04 19:37:20,0,0,0,0,0,0
2,201392387,2170660915,0,0,2024-10-04 19:37:20,128,84,212,1,1,2
2,201392387,2170660915,39639,36895,2024-10-04 19:37:21,0,0,0,0,0,0
2,201392387,2170660915,22663,36895,2024-10-04 19:37:21,0,0,0,0,0,0
2,201392387,1145490691,2762,47873,2024-10-04 19:37:21,0,0,0,0,0,0
2,201392387,2170660915,0,0,2024-10-04 19:37:21,128,84,212,1,1,2
2,201392387,2170660915,39639,36895,2024-10-04 19:37:22,0,0,0,0,0,0
2,201392387,2170660915,22663,36895,2024-10-04 19:37:22,0,0,0,0,0,0
2,201392387,1145490691,2762,47873,2024-10-04 19:37:22,0,0,0,0,0,0
2,201392387,2170660915,0,0,2024-10-04 19:37:22,128,84,212,1,1,2
2,201392387,2170660915,39639,36895,2024-10-04 19:37:23,0,0,0,0,0,0
2,201392387,2170660915,22663,36895,2024-10-04 19:37:23,0,0,0,0,0,0
2,201392387,1145490691,2762,47873,2024-10-04 19:37:23,0,0,0,0,0,0
2,201392387,2170660915,0,0,2024-10-04 19:37:23,128,84,212,1,1,2
2,201392387,2170660915,39639,36895,2024-10-04 19:37:24,0,0,0,0,0,0
2,201392387,2170660915,22663,36895,2024-10-04 19:37:24,0,0,0,0,0,0
2,201392387,1145490691,2762,47873,2024-10-04 19:37:24,0,0,0,0,0,0
2,201392387,2170660915,0,0,2024-10-04 19:37:24,128,84,212,1,1,2
2,201392387,2170660915,39639,36895,2024-10-04 19:37:25,0,0,0,0,0,0
2,201392387,2170660915,22663,36895,2024-10-04 19:37:25,0,0,0,0,0,0
2,201392387,2170660915,0,0,2024-10-04 19:37:25,128,84,212,1,1,2
2,201392387,2170660915,39639,36895,2024-10-04 19:37:26,0,0,0,0,0,0
2,201392387,2170660915,22663,36895,2024-10-04 19:37:26,0,0,0,0,0,0
2,201392387,2170660915,0,0,2024-10-04 19:37:26,128,84,212,1,1,2
2,201392387,2170660915,39639,36895,2024-10-04 19:37:27,0,0,0,0,0,0
2,201392387,2170660915,22663,36895,2024-10-04 19:37:27,0,0,0,0,0,0
2,201392387,2170660915,0,0,2024-10-04 19:37:27,128,84,212,1,1,2
2,201392387,2170660915,39639,36895,2024-10-04 19:37:28,0,0,0,0,0,0
2,201392387,2170660915,22663,36895,2024-10-04 19:37:28,0,0,0,0,0,0
2,201392387,2170660915,0,0,2024-10-04 19:37:28,128,84,212,1,1,2
2,201392387,2170660915,39639,36895,2024-10-04 19:37:29,0,0,0,0,0,0
2,201392387,2170660915,22663,36895,2024-10-04 19:37:29,0,0,0,0,0,0
2,201392387,2170660915,0,0,2024-10-04 19:37:29,0,0,0,0,0,0
2,201392387,2170660915,39639,36895,2024-10-04 19:37:30,0,0,0,0,0,0
2,201392387,2170660915,22663,36895,2024-10-04 19:37:30,0,0,0,0,0,0
2,201392387,2170660915,24721,36895,2024-10-04 19:37:30,666,507,1173,6,6,12
2,201392387,2170660915,0,0,2024-10-04 19:37:30,128,0,128,1,0,1
2,201392387,2170660915,39639,36895,2024-10-04 19:37:31,0,0,0,0,0,0
2,201392387,2170660915,22663,36895,2024-10-04 19:37:31,0,0,0,0,0,0
2,201392387,2170660915,24721,36895,2024-10-04 19:37:31,0,0,0,0,0,0
2,201392387,2170660915,0,0,2024-10-04 19:37:31,128,84,212,1,1,2
2,201392387,2170660915,39639,36895,2024-10-04 19:37:32,0,0,0,0,0,0
2,201392387,2170660915,22663,36895,2024-10-04 19:37:32,0,0,0,0,0,0
2,201392387,2170660915,24721,36895,2024-10-04 19:37:32,0,0,0,0,0,0
2,201392387,2170660915,0,0,2024-10-04 19:37:32,128,84,212,1,1,2
2,201392387,2170660915,39639,36895,2024-10-04 19:37:33,0,0,0,0,0,0
2,201392387,2170660915,22663,36895,2024-10-04 19:37:33,0,0,0,0,0,0
2,201392387,2170660915,24721,36895,2024-10-04 19:37:33,0,0,0,0,0,0
2,201392387,2170660915,0,0,2024-10-04 19:37:33,0,0,0,0,0,0
2,201392387,2170660915,39639,36895,2024-10-04 19:37:34,0,0,0,0,0,0
2,201392387,2170660915,22663,36895,2024-10-04 19:37:34,0,0,0,0,0,0
2,201392387,2170660915,24721,36895,2024-10-04 19:37:34,0,0,0,0,0,0
2,201392387,2170660915,0,0,2024-10-04 19:37:34,0,84,84,0,1,1
2,201392387,2170660915,39639,36895,2024-10-04 19:37:35,0,0,0,0,0,0
2,201392387,2170660915,22663,36895,2024-10-04 19:37:35,0,0,0,0,0,0
2,201392387,2170660915,0,0,2024-10-04 19:37:35,0,0,0,0,0,0
2,201392387,2170660915,39639,36895,2024-10-04 19:37:36,0,0,0,0,0,0
2,201392387,2170660915,22663,36895,2024-10-04 19:37:36,0,0,0,0,0,0
2,201392387,2170660915,0,0,2024-10-04 19:37:36,128,84,212,1,1,2
2,201392387,2170660915,39639,36895,2024-10-04 19:37:37,0,0,0,0,0,0
2,201392387,2170660915,22663,36895,2024-10-04 19:37:37,0,0,0,0,0,0
2,201392387,2170660915,0,0,2024-10-04 19:37:37,128,84,212,1,1,2
2,201392387,2170660915,39639,36895,2024-10-04 19:37:38,0,0,0,0,0,0
2,201392387,2170660915,22663,36895,2024-10-04 19:37:38,0,0,0,0,0,0
2,201392387,1145490689,2217,47873,2024-10-04 19:37:38,813,60,873,3,1,4
2,201392387,2170660915,0,0,2024-10-04 19:37:38,128,84,212,1,1,2
2,201392387,2170660915,39639,36895,2024-10-04 19:37:39,0,0,0,0,0,0
2,201392387,2170660915,22663,36895,2024-10-04 19:37:39,0,0,0,0,0,0
2,201392387,1145490689,2217,47873,2024-10-04 19:37:39,1827,29663,31490,15,27,42
2,201392387,2170660915,0,0,2024-10-04 19:37:39,0,0,0,0,0,0
2,201392387,2170660915,39639,36895,2024-10-04 19:37:40,0,0,0,0,0,0
2,201392387,2170660915,22663,36895,2024-10-04 19:37:40,0,0,0,0,0,0
2,201392387,1145490689,2217,47873,2024-10-04 19:37:40,2436,59678,62114,24,39,63
2,201392387,2170660915,0,0,2024-10-04 19:37:40,0,0,0,0,0,0
2,201392387,2170660915,39639,36895,2024-10-04 19:37:41,0,0,0,0,0,0
2,201392387,2170660915,22663,36895,2024-10-04 19:37:41,0,0,0,0,0,0
2,201392387,1145490689,2217,47873,2024-10-04 19:37:41,0,0,0,0,0,0
2,201392387,2170660915,0,0,2024-10-04 19:37:41,0,0,0,0,0,0
2,201392387,2170660915,39639,36895,2024-10-04 19:37:42,0,0,0,0,0,0
2,201392387,2170660915,22663,36895,2024-10-04 19:37:42,0,0,0,0,0,0
2,201392387,1145490689,2217,47873,2024-10-04 19:37:42,0,0,0,0,0,0
2,201392387,2170660915,0,0,2024-10-04 19:37:42,0,0,0,0,0,0
2,201392387,2170660915,39639,36895,2024-10-04 19:37:43,0,0,0,0,0,0
2,201392387,2170660915,22663,36895,2024-10-04 19:37:43,0,0,0,0,0,0
2,201392387,1145490689,2217,47873,2024-10-04 19:37:43,0,0,0,0,0,0
2,201392387,2170660915,0,0,2024-10-04 19:37:43,0,0,0,0,0,0
2,201392387,2170660915,39639,36895,2024-10-04 19:37:44,0,0,0,0,0,0
2,201392387,2170660915,22663,36895,2024-10-04 19:37:44,0,0,0,0,0,0
2,201392387,1145490689,2217,47873,2024-10-04 19:37:44,0,0,0,0,0,0
2,201392387,2170660915,0,0,2024-10-04 19:37:44,0,0,0,0,0,0
2,201392387,2170660915,39639,36895,2024-10-04 19:37:45,0,0,0,0,0,0
2,201392387,2170660915,22663,36895,2024-10-04 19:37:45,0,0,0,0,0,0
2,201392387,1145490689,2217,47873,2024-10-04 19:37:45,0,0,0,0,0,0
2,201392387,2170660915,0,0,2024-10-04 19:37:45,0,0,0,0,0,0
2,201392387,2170660915,39639,36895,2024-10-04 19:37:46,0,0,0,0,0,0
2,201392387,2170660915,22663,36895,2024-10-04 19:37:46,0,0,0,0,0,0
2,201392387,1145490689,2217,47873,2024-10-04 19:37:46,1128,13969,15097,11,13,24
2,201392387,2170660915,0,0,2024-10-04 19:37:46,0,0,0,0,0,0
2,201392387,2170660915,39639,36895,2024-10-04 19:37:47,0,0,0,0,0,0
2,201392387,2170660915,22663,36895,2024-10-04 19:37:47,0,0,0,0,0,0
2,201392387,1145490689,2217,47873,2024-10-04 19:37:47,0,0,0,0,0,0
2,201392387,2170660915,0,0,2024-10-04 19:37:47,0,0,0,0,0,0
2,201392387,2170660915,39639,36895,2024-10-04 19:37:48,0,0,0,0,0,0
2,201392387,2170660915,22663,36895,2024-10-04 19:37:48,0,0,0,0,0,0
2,201392387,1145490689,2217,47873,2024-10-04 19:37:48,0,0,0,0,0,0
2,201392387,2170660915,0,0,2024-10-04 19:37:48,0,0,0,0,0,0
2,201392387,2170660915,39639,36895,2024-10-04 19:37:49,0,0,0,0,0,0
2,201392387,2170660915,22663,36895,2024-10-04 19:37:49,0,0,0,0,0,0
2,201392387,1145490689,2217,47873,2024-10-04 19:37:49,0,0,0,0,0,0
2,201392387,2170660915,0,0,2024-10-04 19:37:49,0,0,0,0,0,0
2,201392387,2170660915,39639,36895,2024-10-04 19:37:50,0,0,0,0,0,0
2,201392387,2170660915,22663,36895,2024-10-04 19:37:50,0,0,0,0,0,0
2,201392387,1145490689,2217,47873,2024-10-04 19:37:50,0,0,0,0,0,0
2,201392387,2170660915,0,0,2024-10-04 19:37:50,0,0,0,0,0,0
2,201392387,2170660915,39639,36895,2024-10-04 19:37:51,0,0,0,0,0,0
2,201392387,2170660915,22663,36895,2024-10-04 19:37:51,0,0,0,0,0,0
2,201392387,1145490689,2217,47873,2024-10-04 19:37:51,0,0,0,0,0,0
2,201392387,2170660915,0,0,2024-10-04 19:37:51,128,84,212,1,1,2
2,201392387,2170660915,39639,36895,2024-10-04 19:37:52,0,0,0,0,0,0
2,201392387,2170660915,22663,36895,2024-10-04 19:37:52,0,0,0,0,0,0
2,201392387,1145490689,2217,47873,2024-10-04 19:37:52,0,0,0,0,0,0
2,201392387,2170660915,0,0,2024-10-04 19:37:52,128,84,212,1,1,2
2,201392387,2170660915,39639,36895,2024-10-04 19:37:53,0,0,0,0,0,0
2,201392387,2170660915,22663,36895,2024-10-04 19:37:53,0,0,0,0,0,0
2,201392387,1145490689,2217,47873,2024-10-04 19:37:53,0,0,0,0,0,0
2,201392387,2170660915,0,0,2024-10-04 19:37:53,128,84,212,1,1,2
2,201392387,2170660915,39639,36895,2024-10-04 19:37:54,0,0,0,0,0,0
2,201392387,2170660915,22663,36895,2024-10-04 19:37:54,0,0,0,0,0,0
2,201392387,1145490689,2217,47873,2024-10-04 19:37:54,0,0,0,0,0,0
2,201392387,2170660915,0,0,2024-10-04 19:37:54,128,84,212,1,1,2
2,201392387,2170660915,39639,36895,2024-10-04 19:37:55,0,0,0,0,0,0
2,201392387,2170660915,22663,36895,2024-10-04 19:37:55,0,0,0,0,0,0
2,201392387,1145490689,2217,47873,2024-10-04 19:37:55,0,0,0,0,0,0
2,201392387,2170660915,0,0,2024-10-04 19:37:55,128,84,212,1,1,2
2,201392387,2170660915,39639,36895,2024-10-04 19:37:56,0,0,0,0,0,0
2,201392387,2170660915,22663,36895,2024-10-04 19:37:56,0,0,0,0,0,0
2,201392387,1145490689,2217,47873,2024-10-04 19:37:56,0,0,0,0,0,0
2,201392387,2170660915,0,0,2024-10-04 19:37:56,128,84,212,1,1,2
2,201392387,2170660915,39639,36895,2024-10-04 19:37:57,0,0,0,0,0,0
2,201392387,2170660915,22663,36895,2024-10-04 19:37:57,0,0,0,0,0,0
2,201392387,2170660915,0,0,2024-10-04 19:37:57,128,84,212,1,1,2
2,201392387,2170660915,39639,36895,2024-10-04 19:37:58,0,0,0,0,0,0
2,201392387,2170660915,22663,36895,2024-10-04 19:37:58,0,0,0,0,0,0
2,201392387,2170660915,0,0,2024-10-04 19:37:58,128,84,212,1,1,2
2,201392387,2170660915,39639,36895,2024-10-04 19:37:59,0,0,0,0,0,0
2,201392387,2170660915,22663,36895,2024-10-04 19:37:59,0,0,0,0,0,0
2,201392387,2170660915,0,0,2024-10-04 19:37:59,128,84,212,1,1,2
2,201392387,2170660915,39639,36895,2024-10-04 19:38:00,0,0,0,0,0,0
2,201392387,2170660915,22663,36895,2024-10-04 19:38:00,0,0,0,0,0,0
2,201392387,2170660915,0,0,2024-10-04 19:38:00,128,84,212,1,1,2
2,201392387,2170660915,39639,36895,2024-10-04 19:38:01,0,0,0,0,0,0
2,201392387,2170660915,22663,36895,2024-10-04 19:38:01,0,0,0,0,0,0
2,201392387,2170660915,0,0,2024-10-04 19:38:01,0,0,0,0,0,0
2,201392387,2170660915,39639,36895,2024-10-04 19:38:02,0,0,0,0,0,0
2,201392387,2170660915,22663,36895,2024-10-04 19:38:02,0,0,0,0,0,0
2,201392387,2170660915,19147,36895,2024-10-04 19:38:02,666,507,1173,6,6,12
2,201392387,2170660915,0,0,2024-10-04 19:38:02,0,0,0,0,0,0
2,201392387,2170660915,39639,36895,2024-10-04 19:38:03,0,0,0,0,0,0
2,201392387,2170660915,22663,36895,2024-10-04 19:38:03,0,0,0,0,0,0
2,201392387,2170660915,19147,36895,2024-10-04 19:38:03,0,0,0,0,0,0
2,201392387,2170660915,0,0,2024-10-04 19:38:03,256,84,340,2,1,3
2,201392387,2170660915,39639,36895,2024-10-04 19:38:04,0,0,0,0,0,0
2,201392387,2170660915,22663,36895,2024-10-04 19:38:04,0,0,0,0,0,0
2,201392387,2170660915,19147,36895,2024-10-04 19:38:04,0,0,0,0,0,0
2,201392387,2170660915,0,0,2024-10-04 19:38:04,0,84,84,0,1,1
2,201392387,2170660915,39639,36895,2024-10-04 19:38:05,0,0,0,0,0,0
2,201392387,2170660915,22663,36895,2024-10-04 19:38:05,0,0,0,0,0,0
2,201392387,2170660915,19147,36895,2024-10-04 19:38:05,0,0,0,0,0,0
2,201392387,2170660915,0,0,2024-10-04 19:38:05,128,84,212,1,1,2
2,201392387,2170660915,39639,36895,2024-10-04 19:38:06,0,0,0,0,0,0
2,201392387,2170660915,22663,36895,2024-10-04 19:38:06,0,0,0,0,0,0
2,201392387,2170660915,19147,36895,2024-10-04 19:38:06,0,0,0,0,0,0
2,201392387,2170660915,0,0,2024-10-04 19:38:06,0,0,0,0,0,0
2,201392387,2170660915,39639,36895,2024-10-04 19:38:07,0,0,0,0,0,0
2,201392387,2170660915,22663,36895,2024-10-04 19:38:07,0,0,0,0,0,0
2,201392387,2170660915,0,0,2024-10-04 19:38:07,0,0,0,0,0,0
2,201392387,2170660915,39639,36895,2024-10-04 19:38:08,0,0,0,0,0,0
2,201392387,2170660915,22663,36895,2024-10-04 19:38:08,0,0,0,0,0,0
2,201392387,2170660915,0,0,2024-10-04 19:38:08,128,84,212,1,1,2
2,201392387,2170660915,39639,36895,2024-10-04 19:38:09,0,0,0,0,0,0
2,201392387,2170660915,22663,36895,2024-10-04 19:38:09,0,0,0,0,0,0
2,201392387,2170660915,0,0,2024-10-04 19:38:09,0,0,0,0,0,0
2,201392387,2170660915,39639,36895,2024-10-04 19:38:10,0,0,0,0,0,0
2,201392387,2170660915,22663,36895,2024-10-04 19:38:10,0,0,0,0,0,0
2,201392387,1145490690,65254,47873,2024-10-04 19:38:10,813,60,873,3,1,4
2,201392387,2170660915,0,0,2024-10-04 19:38:10,256,168,424,2,2,4
2,201392387,2170660915,39639,36895,2024-10-04 19:38:11,0,0,0,0,0,0
2,201392387,2170660915,22663,36895,2024-10-04 19:38:11,0,0,0,0,0,0
2,201392387,1145490690,65254,47873,2024-10-04 19:38:11,0,0,0,0,0,0
2,201392387,2170660915,0,0,2024-10-04 19:38:11,0,0,0,0,0,0
2,201392387,2170660915,39639,36895,2024-10-04 19:38:12,0,0,0,0,0,0
2,201392387,2170660915,22663,36895,2024-10-04 19:38:12,0,0,0,0,0,0
2,201392387,1145490690,65254,47873,2024-10-04 19:38:12,0,0,0,0,0,0
2,201392387,2170660915,0,0,2024-10-04 19:38:12,0,0,0,0,0,0
2,201392387,2170660915,39639,36895,2024-10-04 19:38:13,0,0,0,0,0,0
2,201392387,2170660915,22663,36895,2024-10-04 19:38:13,0,0,0,0,0,0
2,201392387,1145490690,65254,47873,2024-10-04 19:38:13,0,0,0,0,0,0
2,201392387,2170660915,0,0,2024-10-04 19:38:13,0,0,0,0,0,0
2,201392387,2170660915,39639,36895,2024-10-04 19:38:14,0,0,0,0,0,0
2,201392387,2170660915,22663,36895,2024-10-04 19:38:14,0,0,0,0,0,0
2,201392387,1145490690,65254,47873,2024-10-04 19:38:14,0,0,0,0,0,0
2,201392387,2170660915,0,0,2024-10-04 19:38:14,0,0,0,0,0,0
2,201392387,2170660915,39639,36895,2024-10-04 19:38:15,0,0,0,0,0,0
2,201392387,2170660915,22663,36895,2024-10-04 19:38:15,0,0,0,0,0,0
2,201392387,1145490690,65254,47873,2024-10-04 19:38:15,0,0,0,0,0,0
2,201392387,2170660915,0,0,2024-10-04 19:38:15,0,0,0,0,0,0
2,201392387,2170660915,39639,36895,2024-10-04 19:38:16,0,0,0,0,0,0
2,201392387,2170660915,22663,36895,2024-10-04 19:38:16,0,0,0,0,0,0
2,201392387,1145490690,65254,47873,2024-10-04 19:38:16,0,0,0,0,0,0
2,201392387,2170660915,0,0,2024-10-04 19:38:16,0,0,0,0,0,0
2,201392387,2170660915,39639,36895,2024-10-04 19:38:17,0,0,0,0,0,0
2,201392387,2170660915,22663,36895,2024-10-04 19:38:17,0,0,0,0,0,0
2,201392387,1145490690,65254,47873,2024-10-04 19:38:17,0,0,0,0,0,0
2,201392387,2170660915,0,0,2024-10-04 19:38:17,0,0,0,0,0,0
2,201392387,2170660915,39639,36895,2024-10-04 19:38:18,0,0,0,0,0,0
2,201392387,2170660915,22663,36895,2024-10-04 19:38:18,0,0,0,0,0,0
2,201392387,1145490690,65254,47873,2024-10-04 19:38:18,5403,89072,94475,51,72,123
2,201392387,2170660915,0,0,2024-10-04 19:38:18,0,0,0,0,0,0
2,201392387,2170660915,39639,36895,2024-10-04 19:38:19,0,0,0,0,0,0
2,201392387,2170660915,22663,36895,2024-10-04 19:38:19,0,0,0,0,0,0
2,201392387,1145490690,65254,47873,2024-10-04 19:38:19,0,0,0,0,0,0
2,201392387,2170660915,0,0,2024-10-04 19:38:19,0,0,0,0,0,0
2,201392387,2170660915,39639,36895,2024-10-04 19:38:20,0,0,0,0,0,0
2,201392387,2170660915,22663,36895,2024-10-04 19:38:20,0,0,0,0,0,0
2,201392387,1145490690,65254,47873,2024-10-04 19:38:20,0,0,0,0,0,0
2,201392387,2170660915,0,0,2024-10-04 19:38:20,0,0,0,0,0,0
2,201392387,2170660915,39639,36895,2024-10-04 19:38:21,0,0,0,0,0,0
2,201392387,2170660915,22663,36895,2024-10-04 19:38:21,0,0,0,0,0,0
2,201392387,1145490690,65254,47873,2024-10-04 19:38:21,0,0,0,0,0,0
2,201392387,2170660915,0,0,2024-10-04 19:38:21,0,0,0,0,0,0
2,201392387,2170660915,39639,36895,2024-10-04 19:38:22,0,0,0,0,0,0
2,201392387,2170660915,22663,36895,2024-10-04 19:38:22,0,0,0,0,0,0
2,201392387,1145490690,65254,47873,2024-10-04 19:38:22,0,0,0,0,0,0
2,201392387,2170660915,0,0,2024-10-04 19:38:22,128,84,212,1,1,2
2,201392387,2170660915,39639,36895,2024-10-04 19:38:23,0,0,0,0,0,0
2,201392387,2170660915,22663,36895,2024-10-04 19:38:23,0,0,0,0,0,0
2,201392387,1145490690,65254,47873,2024-10-04 19:38:23,0,0,0,0,0,0
2,201392387,2170660915,0,0,2024-10-04 19:38:23,128,84,212,1,1,2
2,201392387,2170660915,39639,36895,2024-10-04 19:38:24,0,0,0,0,0,0
2,201392387,2170660915,22663,36895,2024-10-04 19:38:24,0,0,0,0,0,0
2,201392387,1145490690,65254,47873,2024-10-04 19:38:24,0,0,0,0,0,0
2,201392387,2170660915,0,0,2024-10-04 19:38:24,256,168,424,2,2,4
2,201392387,2170660915,39639,36895,2024-10-04 19:38:25,0,0,0,0,0,0
2,201392387,2170660915,22663,36895,2024-10-04 19:38:25,0,0,0,0,0,0
2,201392387,1145490690,65254,47873,2024-10-04 19:38:25,0,0,0,0,0,0
2,201392387,2170660915,0,0,2024-10-04 19:38:25,128,84,212,1,1,2
2,201392387,2170660915,39639,36895,2024-10-04 19:38:26,0,0,0,0,0,0
2,201392387,2170660915,22663,36895,2024-10-04 19:38:26,0,0,0,0,0,0
2,201392387,1145490690,65254,47873,2024-10-04 19:38:26,0,0,0,0,0,0
2,201392387,2170660915,0,0,2024-10-04 19:38:26,128,84,212,1,1,2
2,201392387,2170660915,39639,36895,2024-10-04 19:38:27,0,0,0,0,0,0
2,201392387,2170660915,22663,36895,2024-10-04 19:38:27,0,0,0,0,0,0
2,201392387,1145490690,65254,47873,2024-10-04 19:38:27,0,0,0,0,0,0
2,201392387,2170660915,0,0,2024-10-04 19:38:27,128,84,212,1,1,2
2,201392387,2170660915,39639,36895,2024-10-04 19:38:28,0,0,0,0,0,0
2,201392387,2170660915,22663,36895,2024-10-04 19:38:28,0,0,0,0,0,0
2,201392387,1145490690,65254,47873,2024-10-04 19:38:28,0,0,0,0,0,0
2,201392387,2170660915,0,0,2024-10-04 19:38:28,128,0,128,1,0,1
2,201392387,2170660915,39639,36895,2024-10-04 19:38:29,0,0,0,0,0,0
2,201392387,2170660915,22663,36895,2024-10-04 19:38:29,0,0,0,0,0,0
2,201392387,2170660915,0,0,2024-10-04 19:38:29,0,84,84,0,1,1
2,201392387,2170660915,39639,36895,2024-10-04 19:38:30,0,0,0,0,0,0
2,201392387,2170660915,22663,36895,2024-10-04 19:38:30,0,0,0,0,0,0
2,201392387,2170660915,0,0,2024-10-04 19:38:30,256,84,340,2,1,3
2,201392387,2170660915,39639,36895,2024-10-04 19:38:31,0,0,0,0,0,0
2,201392387,2170660915,22663,36895,2024-10-04 19:38:31,0,0,0,0,0,0
2,201392387,2170660915,0,0,2024-10-04 19:38:31,0,84,84,0,1,1
2,201392387,2170660915,39639,36895,2024-10-04 19:38:32,0,0,0,0,0,0
2,201392387,2170660915,22663,36895,2024-10-04 19:38:32,0,0,0,0,0,0
2,201392387,2170660915,40128,36895,2024-10-04 19:38:32,666,507,1173,6,6,12
2,201392387,2170660915,0,0,2024-10-04 19:38:32,0,0,0,0,0,0
2,201392387,2170660915,39639,36895,2024-10-04 19:38:33,0,0,0,0,0,0
2,201392387,2170660915,22663,36895,2024-10-04 19:38:33,0,0,0,0,0,0
2,201392387,2170660915,40128,36895,2024-10-04 19:38:33,0,0,0,0,0,0
2,201392387,2170660915,0,0,2024-10-04 19:38:33,0,0,0,0,0,0
2,201392387,2170660915,39639,36895,2024-10-04 19:38:34,0,0,0,0,0,0
2,201392387,2170660915,22663,36895,2024-10-04 19:38:34,0,0,0,0,0,0
2,201392387,2170660915,40128,36895,2024-10-04 19:38:34,0,0,0,0,0,0
2,201392387,2170660915,0,0,2024-10-04 19:38:34,256,84,340,2,1,3
2,201392387,2170660915,39639,36895,2024-10-04 19:38:35,0,0,0,0,0,0
2,201392387,2170660915,22663,36895,2024-10-04 19:38:35,0,0,0,0,0,0
2,201392387,2170660915,40128,36895,2024-10-04 19:38:35,0,0,0,0,0,0
2,201392387,2170660915,0,0,2024-10-04 19:38:35,128,84,212,1,1,2
2,201392387,2170660915,39639,36895,2024-10-04 19:38:36,0,0,0,0,0,0
2,201392387,2170660915,22663,36895,2024-10-04 19:38:36,0,0,0,0,0,0
2,201392387,2170660915,40128,36895,2024-10-04 19:38:36,0,0,0,0,0,0
2,201392387,2170660915,0,0,2024-10-04 19:38:36,0,84,84,0,1,1
2,201392387,2170660915,39639,36895,2024-10-04 19:38:37,0,0,0,0,0,0
2,201392387,2170660915,22663,36895,2024-10-04 19:38:37,0,0,0,0,0,0
2,201392387,2170660915,40128,36895,2024-10-04 19:38:37,0,0,0,0,0,0
2,201392387,2170660915,0,0,2024-10-04 19:38:37,0,0,0,0,0,0
2,201392387,2170660915,39639,36895,2024-10-04 19:38:38,0,0,0,0,0,0
2,201392387,2170660915,22663,36895,2024-10-04 19:38:38,0,0,0,0,0,0
2,201392387,2170660915,40128,36895,2024-10-04 19:38:38,0,0,0,0,0,0
2,201392387,2170660915,0,0,2024-10-04 19:38:38,0,0,0,0,0,0
2,201392387,2170660915,39639,36895,2024-10-04 19:38:39,0,0,0,0,0,0
2,201392387,2170660915,22663,36895,2024-10-04 19:38:39,0,0,0,0,0,0
2,201392387,2170660915,40128,36895,2024-10-04 19:38:39,0,0,0,0,0,0
2,201392387,2170660915,0,0,2024-10-04 19:38:39,0,0,0,0,0,0
2,201392387,2170660915,39639,36895,2024-10-04 19:38:40,0,0,0,0,0,0
2,201392387,2170660915,22663,36895,2024-10-04 19:38:40,0,0,0,0,0,0
2,201392387,2170660915,40128,36895,2024-10-04 19:38:40,0,0,0,0,0,0
2,201392387,2170660915,0,0,2024-10-04 19:38:40,256,84,340,2,1,3
2,201392387,2170660915,39639,36895,2024-10-04 19:38:41,0,0,0,0,0,0
2,201392387,2170660915,22663,36895,2024-10-04 19:38:41,0,0,0,0,0,0
2,201392387,1145490689,32442,47873,2024-10-04 19:38:41,3888,58876,62764,30,47,77
2,201392387,2170660915,0,0,2024-10-04 19:38:41,128,168,296,1,2,3
2,201392387,2170660915,39639,36895,2024-10-04 19:38:42,0,0,0,0,0,0
2,201392387,2170660915,22663,36895,2024-10-04 19:38:42,0,0,0,0,0,0
2,201392387,1145490689,32442,47873,2024-10-04 19:38:42,2064,44952,47016,20,30,50
2,201392387,2170660915,0,0,2024-10-04 19:38:42,0,0,0,0,0,0
2,201392387,2170660915,39639,36895,2024-10-04 19:38:43,0,0,0,0,0,0
2,201392387,2170660915,22663,36895,2024-10-04 19:38:43,0,0,0,0,0,0
2,201392387,1145490689,32442,47873,2024-10-04 19:38:43,0,0,0,0,0,0
2,201392387,2170660915,0,0,2024-10-04 19:38:43,0,0,0,0,0,0
2,201392387,2170660915,39639,36895,2024-10-04 19:38:44,0,0,0,0,0,0
2,201392387,2170660915,22663,36895,2024-10-04 19:38:44,0,0,0,0,0,0
2,201392387,1145490689,32442,47873,2024-10-04 19:38:44,0,0,0,0,0,0
2,201392387,2170660915,0,0,2024-10-04 19:38:44,0,0,0,0,0,0
2,201392387,2170660915,39639,36895,2024-10-04 19:38:45,0,0,0,0,0,0
2,201392387,2170660915,22663,36895,2024-10-04 19:38:45,0,0,0,0,0,0
2,201392387,1145490689,32442,47873,2024-10-04 19:38:45,0,0,0,0,0,0
2,201392387,2170660915,0,0,2024-10-04 19:38:45,0,0,0,0,0,0
2,201392387,2170660915,39639,36895,2024-10-04 19:38:46,0,0,0,0,0,0
2,201392387,2170660915,22663,36895,2024-10-04 19:38:46,0,0,0,0,0,0
2,201392387,1145490689,32442,47873,2024-10-04 19:38:46,0,0,0,0,0,0
2,201392387,2170660915,0,0,2024-10-04 19:38:46,0,0,0,0,0,0
2,201392387,2170660915,39639,36895,2024-10-04 19:38:47,0,0,0,0,0,0
2,201392387,2170660915,22663,36895,2024-10-04 19:38:47,0,0,0,0,0,0
2,201392387,1145490689,32442,47873,2024-10-04 19:38:47,516,1576,2092,5,4,9
2,201392387,2170660915,0,0,2024-10-04 19:38:47,0,0,0,0,0,0
2,201392387,2170660915,39639,36895,2024-10-04 19:38:48,0,0,0,0,0,0
2,201392387,2170660915,22663,36895,2024-10-04 19:38:48,0,0,0,0,0,0
2,201392387,1145490689,32442,47873,2024-10-04 19:38:48,0,0,0,0,0,0
2,201392387,2170660915,0,0,2024-10-04 19:38:48,0,0,0,0,0,0
2,201392387,2170660915,39639,36895,2024-10-04 19:38:49,0,0,0,0,0,0
2,201392387,2170660915,22663,36895,2024-10-04 19:38:49,0,0,0,0,0,0
2,201392387,1145490689,32442,47873,2024-10-04 19:38:49,0,0,0,0,0,0
2,201392387,2170660915,0,0,2024-10-04 19:38:49,0,0,0,0,0,0
2,201392387,2170660915,39639,36895,2024-10-04 19:38:50,0,0,0,0,0,0
2,201392387,2170660915,22663,36895,2024-10-04 19:38:50,0,0,0,0,0,0
2,201392387,1145490689,32442,47873,2024-10-04 19:38:50,0,0,0,0,0,0
2,201392387,2170660915,0,0,2024-10-04 19:38:50,0,0,0,0,0,0
2,201392387,2170660915,39639,36895,2024-10-04 19:38:51,0,0,0,0,0,0
2,201392387,2170660915,22663,36895,2024-10-04 19:38:51,0,0,0,0,0,0
2,201392387,1145490689,32442,47873,2024-10-04 19:38:51,0,0,0,0,0,0
2,201392387,2170660915,0,0,2024-10-04 19:38:51,0,0,0,0,0,0
2,201392387,2170660915,39639,36895,2024-10-04 19:38:52,0,0,0,0,0,0
2,201392387,2170660915,22663,36895,2024-10-04 19:38:52,0,0,0,0,0,0
2,201392387,1145490689,32442,47873,2024-10-04 19:38:52,0,0,0,0,0,0
2,201392387,2170660915,0,0,2024-10-04 19:38:52,0,0,0,0,0,0
2,201392387,2170660915,39639,36895,2024-10-04 19:38:53,0,0,0,0,0,0
2,201392387,2170660915,22663,36895,2024-10-04 19:38:53,0,0,0,0,0,0
2,201392387,1145490689,32442,47873,2024-10-04 19:38:53,0,0,0,0,0,0
2,201392387,2170660915,0,0,2024-10-04 19:38:53,128,84,212,1,1,2
2,201392387,2170660915,39639,36895,2024-10-04 19:38:54,0,0,0,0,0,0
2,201392387,2170660915,22663,36895,2024-10-04 19:38:54,0,0,0,0,0,0
2,201392387,1145490689,32442,47873,2024-10-04 19:38:54,0,0,0,0,0,0
2,201392387,2170660915,0,0,2024-10-04 19:38:54,128,84,212,1,1,2
2,201392387,2170660915,39639,36895,2024-10-04 19:38:55,0,0,0,0,0,0
2,201392387,2170660915,22663,36895,2024-10-04 19:38:55,0,0,0,0,0,0
2,201392387,1145490689,32442,47873,2024-10-04 19:38:55,0,0,0,0,0,0
2,201392387,2170660915,0,0,2024-10-04 19:38:55,128,84,212,1,1,2
2,201392387,2170660915,39639,36895,2024-10-04 19:38:56,0,0,0,0,0,0
2,201392387,2170660915,22663,36895,2024-10-04 19:38:56,0,0,0,0,0,0
2,201392387,1145490689,32442,47873,2024-10-04 19:38:56,0,0,0,0,0,0
2,201392387,2170660915,0,0,2024-10-04 19:38:56,128,84,212,1,1,2
2,201392387,2170660915,39639,36895,2024-10-04 19:38:57,0,0,0,0,0,0
2,201392387,2170660915,22663,36895,2024-10-04 19:38:57,0,0,0,0,0,0
2,201392387,1145490689,32442,47873,2024-10-04 19:38:57,0,0,0,0,0,0
2,201392387,2170660915,0,0,2024-10-04 19:38:57,128,84,212,1,1,2
2,201392387,2170660915,39639,36895,2024-10-04 19:38:58,0,0,0,0,0,0
2,201392387,2170660915,22663,36895,2024-10-04 19:38:58,0,0,0,0,0,0
2,201392387,1145490689,32442,47873,2024-10-04 19:38:58,0,0,0,0,0,0
2,201392387,2170660915,0,0,2024-10-04 19:38:58,128,84,212,1,1,2
2,201392387,2170660915,39639,36895,2024-10-04 19:38:59,0,0,0,0,0,0
2,201392387,2170660915,22663,36895,2024-10-04 19:38:59,0,0,0,0,0,0
2,201392387,2170660915,0,0,2024-10-04 19:38:59,128,84,212,1,1,2
2,201392387,2170660915,39639,36895,2024-10-04 19:39:00,0,0,0,0,0,0
2,201392387,2170660915,22663,36895,2024-10-04 19:39:00,0,0,0,0,0,0
2,201392387,2170660915,0,0,2024-10-04 19:39:00,128,84,212,1,1,2
2,201392387,2170660915,39639,36895,2024-10-04 19:39:01,0,0,0,0,0,0
2,201392387,2170660915,22663,36895,2024-10-04 19:39:01,0,0,0,0,0,0
2,201392387,2170660915,0,0,2024-10-04 19:39:01,128,84,212,1,1,2
2,201392387,2170660915,39639,36895,2024-10-04 19:39:02,0,0,0,0,0,0
2,201392387,2170660915,22663,36895,2024-10-04 19:39:02,0,0,0,0,0,0
2,201392387,2170660915,0,0,2024-10-04 19:39:02,128,84,212,1,1,2
2,201392387,2170660915,39639,36895,2024-10-04 19:39:03,0,0,0,0,0,0
2,201392387,2170660915,22663,36895,2024-10-04 19:39:03,0,0,0,0,0,0
2,201392387,2170660915,31932,36895,2024-10-04 19:39:03,570,455,1025,5,5,10
2,201392387,2170660915,0,0,2024-10-04 19:39:03,0,0,0,0,0,0
2,201392387,2170660915,39639,36895,2024-10-04 19:39:04,0,0,0,0,0,0
2,201392387,2170660915,22663,36895,2024-10-04 19:39:04,0,0,0,0,0,0
2,201392387,2170660915,31932,36895,2024-10-04 19:39:04,0,0,0,0,0,0
2,201392387,2170660915,0,0,2024-10-04 19:39:04,0,0,0,0,0,0
2,201392387,2170660915,39639,36895,2024-10-04 19:39:05,0,0,0,0,0,0
2,201392387,2170660915,22663,36895,2024-10-04 19:39:05,0,0,0,0,0,0
2,201392387,2170660915,31932,36895,2024-10-04 19:39:05,0,0,0,0,0,0
2,201392387,2170660915,0,0,2024-10-04 19:39:05,256,84,340,2,1,3
2,201392387,2170660915,39639,36895,2024-10-04 19:39:06,0,0,0,0,0,0
2,201392387,2170660915,22663,36895,2024-10-04 19:39:06,0,0,0,0,0,0
2,201392387,2170660915,31932,36895,2024-10-04 19:39:06,0,0,0,0,0,0
2,201392387,2170660915,0,0,2024-10-04 19:39:06,128,168,296,1,2,3
2,201392387,2170660915,39639,36895,2024-10-04 19:39:07,0,0,0,0,0,0
2,201392387,2170660915,22663,36895,2024-10-04 19:39:07,0,0,0,0,0,0
2,201392387,2170660915,31932,36895,2024-10-04 19:39:07,0,0,0,0,0,0
2,201392387,2170660915,0,0,2024-10-04 19:39:07,0,0,0,0,0,0
2,201392387,2170660915,39639,36895,2024-10-04 19:39:08,0,0,0,0,0,0
2,201392387,2170660915,22663,36895,2024-10-04 19:39:08,0,0,0,0,0,0
2,201392387,2170660915,31932,36895,2024-10-04 19:39:08,0,0,0,0,0,0
2,201392387,2170660915,0,0,2024-10-04 19:39:08,0,0,0,0,0,0
2,201392387,2170660915,39639,36895,2024-10-04 19:39:09,0,0,0,0,0,0
2,201392387,2170660915,22663,36895,2024-10-04 19:39:09,0,0,0,0,0,0
2,201392387,2170660915,0,0,2024-10-04 19:39:09,0,0,0,0,0,0
2,201392387,2170660915,39639,36895,2024-10-04 19:39:10,0,0,0,0,0,0
2,201392387,2170660915,22663,36895,2024-10-04 19:39:10,0,0,0,0,0,0
2,201392387,2170660915,0,0,2024-10-04 19:39:10,0,0,0,0,0,0
2,201392387,2170660915,39639,36895,2024-10-04 19:39:11,0,0,0,0,0,0
2,201392387,2170660915,22663,36895,2024-10-04 19:39:11,0,0,0,0,0,0
2,201392387,2170660915,0,0,2024-10-04 19:39:11,256,84,340,2,1,3
2,201392387,2170660915,39639,36895,2024-10-04 19:39:12,0,0,0,0,0,0
2,201392387,2170660915,22663,36895,2024-10-04 19:39:12,0,0,0,0,0,0
2,201392387,1145490689,49293,47873,2024-10-04 19:39:12,2956,34737,37693,21,31,52
2,201392387,2170660915,0,0,2024-10-04 19:39:12,128,168,296,1,2,3
2,201392387,2170660915,39639,36895,2024-10-04 19:39:13,0,0,0,0,0,0
2,201392387,2170660915,22663,36895,2024-10-04 19:39:13,0,0,0,0,0,0
2,201392387,1145490689,49293,47873,2024-10-04 19:39:13,2760,59678,62438,27,39,66
2,201392387,2170660915,0,0,2024-10-04 19:39:13,0,0,0,0,0,0
2,201392387,2170660915,39639,36895,2024-10-04 19:39:14,0,0,0,0,0,0
2,201392387,2170660915,22663,36895,2024-10-04 19:39:14,0,0,0,0,0,0
2,201392387,1145490689,49293,47873,2024-10-04 19:39:14,0,0,0,0,0,0
2,201392387,2170660915,0,0,2024-10-04 19:39:14,0,0,0,0,0,0
2,201392387,2170660915,39639,36895,2024-10-04 19:39:15,0,0,0,0,0,0
2,201392387,2170660915,22663,36895,2024-10-04 19:39:15,0,0,0,0,0,0
2,201392387,1145490689,49293,47873,2024-10-04 19:39:15,0,0,0,0,0,0
2,201392387,2170660915,0,0,2024-10-04 19:39:15,0,0,0,0,0,0
2,201392387,2170660915,39639,36895,2024-10-04 19:39:16,0,0,0,0,0,0
2,201392387,2170660915,22663,36895,2024-10-04 19:39:16,0,0,0,0,0,0
2,201392387,1145490689,49293,47873,2024-10-04 19:39:16,0,0,0,0,0,0
2,201392387,2170660915,0,0,2024-10-04 19:39:16,0,0,0,0,0,0
2,201392387,2170660915,39639,36895,2024-10-04 19:39:17,0,0,0,0,0,0
2,201392387,2170660915,22663,36895,2024-10-04 19:39:17,0,0,0,0,0,0
2,201392387,1145490689,49293,47873,2024-10-04 19:39:17,0,0,0,0,0,0
2,201392387,2170660915,0,0,2024-10-04 19:39:17,0,0,0,0,0,0
2,201392387,2170660915,39639,36895,2024-10-04 19:39:18,0,0,0,0,0,0
2,201392387,2170660915,22663,36895,2024-10-04 19:39:18,0,0,0,0,0,0
2,201392387,1145490689,49293,47873,2024-10-04 19:39:18,0,0,0,0,0,0
2,201392387,2170660915,0,0,2024-10-04 19:39:18,0,0,0,0,0,0
2,201392387,2170660915,39639,36895,2024-10-04 19:39:19,0,0,0,0,0,0
2,201392387,2170660915,22663,36895,2024-10-04 19:39:19,0,0,0,0,0,0
2,201392387,1145490689,49293,47873,2024-10-04 19:39:19,720,6869,7589,7,8,15
2,201392387,2170660915,0,0,2024-10-04 19:39:19,0,0,0,0,0,0
2,201392387,2170660915,39639,36895,2024-10-04 19:39:20,0,0,0,0,0,0
2,201392387,2170660915,22663,36895,2024-10-04 19:39:20,0,0,0,0,0,0
2,201392387,1145490689,49293,47873,2024-10-04 19:39:20,0,0,0,0,0,0
2,201392387,2170660915,0,0,2024-10-04 19:39:20,0,0,0,0,0,0
2,201392387,2170660915,39639,36895,2024-10-04 19:39:21,0,0,0,0,0,0
2,201392387,2170660915,22663,36895,2024-10-04 19:39:21,0,0,0,0,0,0
2,201392387,1145490689,49293,47873,2024-10-04 19:39:21,0,0,0,0,0,0
2,201392387,2170660915,0,0,2024-10-04 19:39:21,0,0,0,0,0,0
2,201392387,2170660915,39639,36895,2024-10-04 19:39:22,0,0,0,0,0,0
2,201392387,2170660915,22663,36895,2024-10-04 19:39:22,0,0,0,0,0,0
2,201392387,1145490689,49293,47873,2024-10-04 19:39:22,0,0,0,0,0,0
2,201392387,2170660915,0,0,2024-10-04 19:39:22,0,0,0,0,0,0
2,201392387,2170660915,39639,36895,2024-10-04 19:39:23,0,0,0,0,0,0
2,201392387,2170660915,22663,36895,2024-10-04 19:39:23,0,0,0,0,0,0
2,201392387,1145490689,49293,47873,2024-10-04 19:39:23,0,0,0,0,0,0
2,201392387,2170660915,0,0,2024-10-04 19:39:23,128,0,128,1,0,1
2,201392387,2170660915,39639,36895,2024-10-04 19:39:24,0,0,0,0,0,0
2,201392387,2170660915,22663,36895,2024-10-04 19:39:24,0,0,0,0,0,0
2,201392387,1145490689,49293,47873,2024-10-04 19:39:24,0,0,0,0,0,0
2,201392387,2170660915,0,0,2024-10-04 19:39:24,128,84,212,1,1,2
2,201392387,2170660915,39639,36895,2024-10-04 19:39:25,0,0,0,0,0,0
2,201392387,2170660915,22663,36895,2024-10-04 19:39:25,0,0,0,0,0,0
2,201392387,1145490689,49293,47873,2024-10-04 19:39:25,0,0,0,0,0,0
2,201392387,2170660915,0,0,2024-10-04 19:39:25,128,84,212,1,1,2
2,201392387,2170660915,39639,36895,2024-10-04 19:39:26,0,0,0,0,0,0
2,201392387,2170660915,22663,36895,2024-10-04 19:39:26,0,0,0,0,0,0
2,201392387,1145490689,49293,47873,2024-10-04 19:39:26,0,0,0,0,0,0
2,201392387,2170660915,0,0,2024-10-04 19:39:26,128,84,212,1,1,2
2,201392387,2170660915,39639,36895,2024-10-04 19:39:27,0,0,0,0,0,0
2,201392387,2170660915,22663,36895,2024-10-04 19:39:27,0,0,0,0,0,0
2,201392387,1145490689,49293,47873,2024-10-04 19:39:27,0,0,0,0,0,0
2,201392387,2170660915,0,0,2024-10-04 19:39:27,128,84,212,1,1,2
2,201392387,2170660915,39639,36895,2024-10-04 19:39:28,0,0,0,0,0,0
2,201392387,2170660915,22663,36895,2024-10-04 19:39:28,0,0,0,0,0,0
2,201392387,1145490689,49293,47873,2024-10-04 19:39:28,0,0,0,0,0,0
2,201392387,2170660915,0,0,2024-10-04 19:39:28,128,84,212,1,1,2
2,201392387,2170660915,39639,36895,2024-10-04 19:39:29,0,0,0,0,0,0
2,201392387,2170660915,22663,36895,2024-10-04 19:39:29,0,0,0,0,0,0
2,201392387,1145490689,49293,47873,2024-10-04 19:39:29,0,0,0,0,0,0
2,201392387,2170660915,0,0,2024-10-04 19:39:29,128,84,212,1,1,2
2,201392387,2170660915,39639,36895,2024-10-04 19:39:30,0,0,0,0,0,0
2,201392387,2170660915,22663,36895,2024-10-04 19:39:30,0,0,0,0,0,0
2,201392387,2170660915,0,0,2024-10-04 19:39:30,0,84,84,0,1,1
2,201392387,2170660915,39639,36895,2024-10-04 19:39:31,0,0,0,0,0,0
2,201392387,2170660915,22663,36895,2024-10-04 19:39:31,0,0,0,0,0,0
2,201392387,2170660915,0,0,2024-10-04 19:39:31,256,84,340,2,1,3
2,201392387,2170660915,39639,36895,2024-10-04 19:39:32,0,0,0,0,0,0
2,201392387,2170660915,22663,36895,2024-10-04 19:39:32,0,0,0,0,0,0
2,201392387,2170660915,0,0,2024-10-04 19:39:32,128,84,212,1,1,2
2,201392387,2170660915,39639,36895,2024-10-04 19:39:33,0,0,0,0,0,0
2,201392387,2170660915,22663,36895,2024-10-04 19:39:33,0,0,0,0,0,0
2,201392387,2170660915,0,0,2024-10-04 19:39:33,0,84,84,0,1,1
2,201392387,2170660915,39639,36895,2024-10-04 19:39:34,0,0,0,0,0,0
2,201392387,2170660915,22663,36895,2024-10-04 19:39:34,0,0,0,0,0,0
2,201392387,2170660915,0,0,2024-10-04 19:39:34,0,0,0,0,0,0
2,201392387,2170660915,39639,36895,2024-10-04 19:39:35,0,0,0,0,0,0
2,201392387,2170660915,22663,36895,2024-10-04 19:39:35,0,0,0,0,0,0
2,201392387,2170660915,64200,36895,2024-10-04 19:39:35,666,507,1173,6,6,12
2,201392387,2170660915,0,0,2024-10-04 19:39:35,128,0,128,1,0,1
2,201392387,2170660915,39639,36895,2024-10-04 19:39:36,0,0,0,0,0,0
2,201392387,2170660915,22663,36895,2024-10-04 19:39:36,0,0,0,0,0,0
2,201392387,2170660915,64200,36895,2024-10-04 19:39:36,0,0,0,0,0,0
2,201392387,2170660915,0,0,2024-10-04 19:39:36,0,84,84,0,1,1
2,201392387,2170660915,39639,36895,2024-10-04 19:39:37,0,0,0,0,0,0
2,201392387,2170660915,22663,36895,2024-10-04 19:39:37,0,0,0,0,0,0
2,201392387,2170660915,64200,36895,2024-10-04 19:39:37,0,0,0,0,0,0
2,201392387,2170660915,0,0,2024-10-04 19:39:37,256,168,424,2,2,4
2,201392387,2170660915,39639,36895,2024-10-04 19:39:38,0,0,0,0,0,0
2,201392387,2170660915,22663,36895,2024-10-04 19:39:38,0,0,0,0,0,0
2,201392387,2170660915,64200,36895,2024-10-04 19:39:38,0,0,0,0,0,0
2,201392387,2170660915,0,0,2024-10-04 19:39:38,0,0,0,0,0,0
2,201392387,2170660915,39639,36895,2024-10-04 19:39:39,0,0,0,0,0,0
2,201392387,2170660915,22663,36895,2024-10-04 19:39:39,0,0,0,0,0,0
2,201392387,2170660915,0,0,2024-10-04 19:39:39,0,0,0,0,0,0
2,201392387,2170660915,39639,36895,2024-10-04 19:39:40,0,0,0,0,0,0
2,201392387,2170660915,22663,36895,2024-10-04 19:39:40,0,0,0,0,0,0
2,201392387,2170660915,0,0,2024-10-04 19:39:40,128,0,128,1,0,1
2,201392387,2170660915,39639,36895,2024-10-04 19:39:41,0,0,0,0,0,0
2,201392387,2170660915,22663,36895,2024-10-04 19:39:41,0,0,0,0,0,0
2,201392387,2170660915,0,0,2024-10-04 19:39:41,128,84,212,1,1,2
2,201392387,2170660915,39639,36895,2024-10-04 19:39:42,0,0,0,0,0,0
2,201392387,2170660915,22663,36895,2024-10-04 19:39:42,0,0,0,0,0,0
2,201392387,2170660915,0,0,2024-10-04 19:39:42,128,84,212,1,1,2
2,201392387,2170660915,39639,36895,2024-10-04 19:39:43,0,0,0,0,0,0
2,201392387,2170660915,22663,36895,2024-10-04 19:39:43,0,0,0,0,0,0
2,201392387,1145490690,15556,47873,2024-10-04 19:39:43,3506,40607,44113,26,38,64
2,201392387,2170660915,0,0,2024-10-04 19:39:43,0,84,84,0,1,1
2,201392387,2170660915,39639,36895,2024-10-04 19:39:44,0,0,0,0,0,0
2,201392387,2170660915,22663,36895,2024-10-04 19:39:44,0,0,0,0,0,0
2,201392387,1145490690,15556,47873,2024-10-04 19:39:44,2040,55226,57266,20,35,55
2,201392387,2170660915,0,0,2024-10-04 19:39:44,0,0,0,0,0,0
2,201392387,2170660915,39639,36895,2024-10-04 19:39:45,0,0,0,0,0,0
2,201392387,2170660915,22663,36895,2024-10-04 19:39:45,0,0,0,0,0,0
2,201392387,1145490690,15556,47873,2024-10-04 19:39:45,0,0,0,0,0,0
2,201392387,2170660915,0,0,2024-10-04 19:39:45,0,0,0,0,0,0
2,201392387,2170660915,39639,36895,2024-10-04 19:39:46,0,0,0,0,0,0
2,201392387,2170660915,22663,36895,2024-10-04 19:39:46,0,0,0,0,0,0
2,201392387,1145490690,15556,47873,2024-10-04 19:39:46,0,0,0,0,0,0
2,201392387,2170660915,0,0,2024-10-04 19:39:46,0,0,0,0,0,0
2,201392387,2170660915,39639,36895,2024-10-04 19:39:47,0,0,0,0,0,0
2,201392387,2170660915,22663,36895,2024-10-04 19:39:47,0,0,0,0,0,0
2,201392387,1145490690,15556,47873,2024-10-04 19:39:47,0,0,0,0,0,0
2,201392387,2170660915,0,0,2024-10-04 19:39:47,0,0,0,0,0,0
2,201392387,2170660915,39639,36895,2024-10-04 19:39:48,0,0,0,0,0,0
2,201392387,2170660915,22663,36895,2024-10-04 19:39:48,0,0,0,0,0,0
2,201392387,1145490690,15556,47873,2024-10-04 19:39:48,0,0,0,0,0,0
2,201392387,2170660915,0,0,2024-10-04 19:39:48,0,0,0,0,0,0
2,201392387,2170660915,39639,36895,2024-10-04 19:39:49,0,0,0,0,0,0
2,201392387,2170660915,22663,36895,2024-10-04 19:39:49,0,0,0,0,0,0
2,201392387,1145490690,15556,47873,2024-10-04 19:39:49,0,0,0,0,0,0
2,201392387,2170660915,0,0,2024-10-04 19:39:49,0,0,0,0,0,0
2,201392387,2170660915,39639,36895,2024-10-04 19:39:50,0,0,0,0,0,0
2,201392387,2170660915,22663,36895,2024-10-04 19:39:50,0,0,0,0,0,0
2,201392387,1145490690,15556,47873,2024-10-04 19:39:50,936,11691,12627,9,10,19
2,201392387,2170660915,0,0,2024-10-04 19:39:50,0,0,0,0,0,0
2,201392387,2170660915,39639,36895,2024-10-04 19:39:51,0,0,0,0,0,0
2,201392387,2170660915,22663,36895,2024-10-04 19:39:51,0,0,0,0,0,0
2,201392387,1145490690,15556,47873,2024-10-04 19:39:51,0,0,0,0,0,0
2,201392387,2170660915,0,0,2024-10-04 19:39:51,0,0,0,0,0,0
2,201392387,2170660915,39639,36895,2024-10-04 19:39:52,0,0,0,0,0,0
2,201392387,2170660915,22663,36895,2024-10-04 19:39:52,0,0,0,0,0,0
2,201392387,1145490690,15556,47873,2024-10-04 19:39:52,0,0,0,0,0,0
2,201392387,2170660915,0,0,2024-10-04 19:39:52,0,0,0,0,0,0
2,201392387,2170660915,39639,36895,2024-10-04 19:39:53,0,0,0,0,0,0
2,201392387,2170660915,22663,36895,2024-10-04 19:39:53,0,0,0,0,0,0
2,201392387,1145490690,15556,47873,2024-10-04 19:39:53,0,0,0,0,0,0
2,201392387,2170660915,0,0,2024-10-04 19:39:53,0,0,0,0,0,0
2,201392387,2170660915,39639,36895,2024-10-04 19:39:54,0,0,0,0,0,0
2,201392387,2170660915,22663,36895,2024-10-04 19:39:54,0,0,0,0,0,0
2,201392387,1145490690,15556,47873,2024-10-04 19:39:54,0,0,0,0,0,0
2,201392387,2170660915,0,0,2024-10-04 19:39:54,128,0,128,1,0,1
2,201392387,2170660915,39639,36895,2024-10-04 19:39:55,0,0,0,0,0,0
2,201392387,2170660915,22663,36895,2024-10-04 19:39:55,0,0,0,0,0,0
2,201392387,1145490690,15556,47873,2024-10-04 19:39:55,0,0,0,0,0,0
2,201392387,2170660915,0,0,2024-10-04 19:39:55,128,84,212,1,1,2
2,201392387,2170660915,39639,36895,2024-10-04 19:39:56,0,0,0,0,0,0
2,201392387,2170660915,22663,36895,2024-10-04 19:39:56,0,0,0,0,0,0
2,201392387,1145490690,15556,47873,2024-10-04 19:39:56,0,0,0,0,0,0
2,201392387,2170660915,0,0,2024-10-04 19:39:56,128,84,212,1,1,2
2,201392387,2170660915,39639,36895,2024-10-04 19:39:57,0,0,0,0,0,0
2,201392387,2170660915,22663,36895,2024-10-04 19:39:57,0,0,0,0,0,0
2,201392387,1145490690,15556,47873,2024-10-04 19:39:57,0,0,0,0,0,0
2,201392387,2170660915,0,0,2024-10-04 19:39:57,128,84,212,1,1,2
2,201392387,2170660915,39639,36895,2024-10-04 19:39:58,0,0,0,0,0,0
2,201392387,2170660915,22663,36895,2024-10-04 19:39:58,0,0,0,0,0,0
2,201392387,1145490690,15556,47873,2024-10-04 19:39:58,0,0,0,0,0,0
2,201392387,2170660915,0,0,2024-10-04 19:39:58,128,84,212,1,1,2
2,201392387,2170660915,39639,36895,2024-10-04 19:39:59,0,0,0,0,0,0
2,201392387,2170660915,22663,36895,2024-10-04 19:39:59,0,0,0,0,0,0
2,201392387,1145490690,15556,47873,2024-10-04 19:39:59,0,0,0,0,0,0
2,201392387,2170660915,0,0,2024-10-04 19:39:59,128,84,212,1,1,2
2,201392387,2170660915,39639,36895,2024-10-04 19:40:00,0,0,0,0,0,0
2,201392387,2170660915,22663,36895,2024-10-04 19:40:00,0,0,0,0,0,0
2,201392387,2170660915,0,0,2024-10-04 19:40:00,0,84,84,0,1,1
2,201392387,2170660915,39639,36895,2024-10-04 19:40:01,0,0,0,0,0,0
2,201392387,2170660915,22663,36895,2024-10-04 19:40:01,0,0,0,0,0,0
2,201392387,2170660915,0,0,2024-10-04 19:40:01,128,84,212,1,1,2
2,201392387,2170660915,39639,36895,2024-10-04 19:40:02,0,0,0,0,0,0
2,201392387,2170660915,22663,36895,2024-10-04 19:40:02,0,0,0,0,0,0
2,201392387,2170660915,0,0,2024-10-04 19:40:02,128,84,212,1,1,2
2,201392387,2170660915,39639,36895,2024-10-04 19:40:03,0,0,0,0,0,0
2,201392387,2170660915,22663,36895,2024-10-04 19:40:03,0,0,0,0,0,0
2,201392387,2170660915,0,0,2024-10-04 19:40:03,128,84,212,1,1,2
2,201392387,2170660915,39639,36895,2024-10-04 19:40:04,0,0,0,0,0,0
2,201392387,2170660915,22663,36895,2024-10-04 19:40:04,0,0,0,0,0,0
2,201392387,2170660915,0,0,2024-10-04 19:40:04,0,0,0,0,0,0
2,201392387,2170660915,39639,36895,2024-10-04 19:40:05,0,0,0,0,0,0
2,201392387,2170660915,22663,36895,2024-10-04 19:40:05,0,0,0,0,0,0
2,201392387,2170660915,0,0,2024-10-04 19:40:05,128,84,212,1,1,2
2,201392387,2170660915,39639,36895,2024-10-04 19:40:06,0,0,0,0,0,0
2,201392387,2170660915,22663,36895,2024-10-04 19:40:06,0,0,0,0,0,0
2,201392387,2170660915,0,0,2024-10-04 19:40:06,0,0,0,0,0,0
2,201392387,2170660915,39639,36895,2024-10-04 19:40:07,0,0,0,0,0,0
2,201392387,2170660915,22663,36895,2024-10-04 19:40:07,0,0,0,0,0,0
2,201392387,2170660915,0,0,2024-10-04 19:40:07,128,0,128,1,0,1
2,201392387,2170660915,3742,36895,2024-10-04 19:40:07,666,507,1173,6,6,12
2,201392387,2170660915,39639,36895,2024-10-04 19:40:08,0,0,0,0,0,0
2,201392387,2170660915,22663,36895,2024-10-04 19:40:08,0,0,0,0,0,0
2,201392387,2170660915,0,0,2024-10-04 19:40:08,0,84,84,0,1,1
2,201392387,2170660915,3742,36895,2024-10-04 19:40:08,0,0,0,0,0,0
2,201392387,2170660915,39639,36895,2024-10-04 19:40:09,0,0,0,0,0,0
2,201392387,2170660915,22663,36895,2024-10-04 19:40:09,0,0,0,0,0,0
2,201392387,2170660915,0,0,2024-10-04 19:40:09,256,168,424,2,2,4
2,201392387,2170660915,39639,36895,2024-10-04 19:40:10,0,0,0,0,0,0
2,201392387,2170660915,22663,36895,2024-10-04 19:40:10,0,0,0,0,0,0
2,201392387,2170660915,0,0,2024-10-04 19:40:10,0,0,0,0,0,0
2,201392387,2170660915,39639,36895,2024-10-04 19:40:11,0,0,0,0,0,0
2,201392387,2170660915,22663,36895,2024-10-04 19:40:11,0,0,0,0,0,0
2,201392387,2170660915,0,0,2024-10-04 19:40:11,0,0,0,0,0,0
2,201392387,2170660915,39639,36895,2024-10-04 19:40:12,0,0,0,0,0,0
2,201392387,2170660915,22663,36895,2024-10-04 19:40:12,0,0,0,0,0,0
2,201392387,2170660915,0,0,2024-10-04 19:40:12,128,0,128,1,0,1
2,201392387,2170660915,39639,36895,2024-10-04 19:40:13,0,0,0,0,0,0
2,201392387,2170660915,22663,36895,2024-10-04 19:40:13,0,0,0,0,0,0
2,201392387,2170660915,0,0,2024-10-04 19:40:13,128,84,212,1,1,2
2,201392387,2170660915,39639,36895,2024-10-04 19:40:14,0,0,0,0,0,0
2,201392387,2170660915,22663,36895,2024-10-04 19:40:14,0,0,0,0,0,0
2,201392387,2170660915,0,0,2024-10-04 19:40:14,128,84,212,1,1,2
2,201392387,2170660915,39639,36895,2024-10-04 19:40:15,0,0,0,0,0,0
2,201392387,2170660915,22663,36895,2024-10-04 19:40:15,0,0,0,0,0,0
2,201392387,1145490690,50304,47873,2024-10-04 19:40:15,3144,39737,42881,23,36,59
2,201392387,2170660915,0,0,2024-10-04 19:40:15,0,84,84,0,1,1
2,201392387,2170660915,39639,36895,2024-10-04 19:40:16,0,0,0,0,0,0
2,201392387,2170660915,22663,36895,2024-10-04 19:40:16,0,0,0,0,0,0
2,201392387,1145490690,50304,47873,2024-10-04 19:40:16,0,0,0,0,0,0
2,201392387,2170660915,0,0,2024-10-04 19:40:16,0,0,0,0,0,0
2,201392387,2170660915,39639,36895,2024-10-04 19:40:17,0,0,0,0,0,0
2,201392387,2170660915,22663,36895,2024-10-04 19:40:17,0,0,0,0,0,0
2,201392387,1145490690,50304,47873,2024-10-04 19:40:17,0,0,0,0,0,0
2,201392387,2170660915,0,0,2024-10-04 19:40:17,0,0,0,0,0,0
2,201392387,2170660915,39639,36895,2024-10-04 19:40:18,0,0,0,0,0,0
2,201392387,2170660915,22663,36895,2024-10-04 19:40:18,0,0,0,0,0,0
2,201392387,1145490690,50304,47873,2024-10-04 19:40:18,0,0,0,0,0,0
2,201392387,2170660915,0,0,2024-10-04 19:40:18,0,0,0,0,0,0
2,201392387,2170660915,39639,36895,2024-10-04 19:40:19,0,0,0,0,0,0
2,201392387,2170660915,22663,36895,2024-10-04 19:40:19,0,0,0,0,0,0
2,201392387,1145490690,50304,47873,2024-10-04 19:40:19,0,0,0,0,0,0
2,201392387,2170660915,0,0,2024-10-04 19:40:19,0,0,0,0,0,0
2,201392387,2170660915,39639,36895,2024-10-04 19:40:20,0,0,0,0,0,0
2,201392387,2170660915,22663,36895,2024-10-04 19:40:20,0,0,0,0,0,0
2,201392387,1145490690,50304,47873,2024-10-04 19:40:20,2904,55571,58475,29,41,70
2,201392387,2170660915,0,0,2024-10-04 19:40:20,0,0,0,0,0,0
2,201392387,2170660915,39639,36895,2024-10-04 19:40:21,0,0,0,0,0,0
2,201392387,2170660915,22663,36895,2024-10-04 19:40:21,0,0,0,0,0,0
2,201392387,1145490690,50304,47873,2024-10-04 19:40:21,0,0,0,0,0,0
2,201392387,2170660915,0,0,2024-10-04 19:40:21,0,0,0,0,0,0
2,201392387,2170660915,39639,36895,2024-10-04 19:40:22,0,0,0,0,0,0
2,201392387,2170660915,22663,36895,2024-10-04 19:40:22,0,0,0,0,0,0
2,201392387,1145490690,50304,47873,2024-10-04 19:40:22,0,0,0,0,0,0
2,201392387,2170660915,0,0,2024-10-04 19:40:22,0,0,0,0,0,0
2,201392387,2170660915,39639,36895,2024-10-04 19:40:23,0,0,0,0,0,0
2,201392387,2170660915,22663,36895,2024-10-04 19:40:23,0,0,0,0,0,0
2,201392387,1145490690,50304,47873,2024-10-04 19:40:23,0,0,0,0,0,0
2,201392387,2170660915,0,0,2024-10-04 19:40:23,0,0,0,0,0,0
2,201392387,2170660915,39639,36895,2024-10-04 19:40:24,0,0,0,0,0,0
2,201392387,2170660915,22663,36895,2024-10-04 19:40:24,0,0,0,0,0,0
2,201392387,1145490690,50304,47873,2024-10-04 19:40:24,0,0,0,0,0,0
2,201392387,2170660915,0,0,2024-10-04 19:40:24,0,0,0,0,0,0
2,201392387,2170660915,39639,36895,2024-10-04 19:40:25,0,0,0,0,0,0
2,201392387,2170660915,22663,36895,2024-10-04 19:40:25,0,0,0,0,0,0
2,201392387,1145490690,50304,47873,2024-10-04 19:40:25,0,0,0,0,0,0
2,201392387,2170660915,0,0,2024-10-04 19:40:25,0,0,0,0,0,0
2,201392387,2170660915,39639,36895,2024-10-04 19:40:26,0,0,0,0,0,0
2,201392387,2170660915,22663,36895,2024-10-04 19:40:26,0,0,0,0,0,0
2,201392387,1145490690,50304,47873,2024-10-04 19:40:26,0,0,0,0,0,0
2,201392387,2170660915,0,0,2024-10-04 19:40:26,128,84,212,1,1,2
2,201392387,2170660915,39639,36895,2024-10-04 19:40:27,0,0,0,0,0,0
2,201392387,2170660915,22663,36895,2024-10-04 19:40:27,0,0,0,0,0,0
2,201392387,1145490690,50304,47873,2024-10-04 19:40:27,0,0,0,0,0,0
2,201392387,2170660915,0,0,2024-10-04 19:40:27,128,84,212,1,1,2
2,201392387,2170660915,39639,36895,2024-10-04 19:40:28,0,0,0,0,0,0
2,201392387,2170660915,22663,36895,2024-10-04 19:40:28,0,0,0,0,0,0
2,201392387,1145490690,50304,47873,2024-10-04 19:40:28,0,0,0,0,0,0
2,201392387,2170660915,0,0,2024-10-04 19:40:28,128,84,212,1,1,2
2,201392387,2170660915,39639,36895,2024-10-04 19:40:29,0,0,0,0,0,0
2,201392387,2170660915,22663,36895,2024-10-04 19:40:29,0,0,0,0,0,0
2,201392387,1145490690,50304,47873,2024-10-04 19:40:29,0,0,0,0,0,0
2,201392387,2170660915,0,0,2024-10-04 19:40:29,128,84,212,1,1,2
2,201392387,2170660915,39639,36895,2024-10-04 19:40:30,0,0,0,0,0,0
2,201392387,2170660915,22663,36895,2024-10-04 19:40:30,0,0,0,0,0,0
2,201392387,2170660915,0,0,2024-10-04 19:40:30,128,84,212,1,1,2
2,201392387,2170660915,39639,36895,2024-10-04 19:40:31,0,0,0,0,0,0
2,201392387,2170660915,22663,36895,2024-10-04 19:40:31,0,0,0,0,0,0
2,201392387,2170660915,0,0,2024-10-04 19:40:31,128,84,212,1,1,2
2,201392387,2170660915,39639,36895,2024-10-04 19:40:32,0,0,0,0,0,0
2,201392387,2170660915,22663,36895,2024-10-04 19:40:32,0,0,0,0,0,0
2,201392387,2170660915,0,0,2024-10-04 19:40:32,128,84,212,1,1,2
2,201392387,2170660915,39639,36895,2024-10-04 19:40:33,0,0,0,0,0,0
2,201392387,2170660915,22663,36895,2024-10-04 19:40:33,0,0,0,0,0,0
2,201392387,2170660915,0,0,2024-10-04 19:40:33,128,84,212,1,1,2
2,201392387,2170660915,39639,36895,2024-10-04 19:40:34,0,0,0,0,0,0
2,201392387,2170660915,22663,36895,2024-10-04 19:40:34,0,0,0,0,0,0
2,201392387,2170660915,0,0,2024-10-04 19:40:34,128,84,212,1,1,2
2,201392387,2170660915,39639,36895,2024-10-04 19:40:35,0,0,0,0,0,0
2,201392387,2170660915,22663,36895,2024-10-04 19:40:35,0,0,0,0,0,0
2,201392387,2170660915,0,0,2024-10-04 19:40:35,128,84,212,1,1,2
2,201392387,2170660915,39639,36895,2024-10-04 19:40:36,0,0,0,0,0,0
2,201392387,2170660915,22663,36895,2024-10-04 19:40:36,0,0,0,0,0,0
2,201392387,2170660915,0,0,2024-10-04 19:40:36,0,0,0,0,0,0
2,201392387,2170660915,39639,36895,2024-10-04 19:40:37,0,0,0,0,0,0
2,201392387,2170660915,21163,36895,2024-10-04 19:40:37,666,507,1173,6,6,12
2,201392387,2170660915,22663,36895,2024-10-04 19:40:37,0,0,0,0,0,0
2,201392387,2170660915,0,0,2024-10-04 19:40:37,128,84,212,1,1,2
2,201392387,2170660915,39639,36895,2024-10-04 19:40:38,0,0,0,0,0,0
2,201392387,2170660915,21163,36895,2024-10-04 19:40:38,0,0,0,0,0,0
2,201392387,2170660915,22663,36895,2024-10-04 19:40:38,0,0,0,0,0,0
2,201392387,2170660915,0,0,2024-10-04 19:40:38,128,84,212,1,1,2
2,201392387,2170660915,39639,36895,2024-10-04 19:40:39,0,0,0,0,0,0
2,201392387,2170660915,21163,36895,2024-10-04 19:40:39,0,0,0,0,0,0
2,201392387,2170660915,22663,36895,2024-10-04 19:40:39,0,0,0,0,0,0
2,201392387,2170660915,0,0,2024-10-04 19:40:39,128,84,212,1,1,2
2,201392387,2170660915,39639,36895,2024-10-04 19:40:40,0,0,0,0,0,0
2,201392387,2170660915,22663,36895,2024-10-04 19:40:40,0,0,0,0,0,0
2,201392387,2170660915,0,0,2024-10-04 19:40:40,0,0,0,0,0,0
2,201392387,2170660915,39639,36895,2024-10-04 19:40:41,0,0,0,0,0,0
2,201392387,2170660915,22663,36895,2024-10-04 19:40:41,0,0,0,0,0,0
2,201392387,2170660915,0,0,2024-10-04 19:40:41,0,0,0,0,0,0
2,201392387,2170660915,39639,36895,2024-10-04 19:40:42,0,0,0,0,0,0
2,201392387,2170660915,22663,36895,2024-10-04 19:40:42,0,0,0,0,0,0
2,201392387,2170660915,0,0,2024-10-04 19:40:42,0,0,0,0,0,0
2,201392387,2170660915,39639,36895,2024-10-04 19:40:43,0,0,0,0,0,0
2,201392387,2170660915,22663,36895,2024-10-04 19:40:43,0,0,0,0,0,0
2,201392387,2170660915,0,0,2024-10-04 19:40:43,0,0,0,0,0,0
2,201392387,2170660915,39639,36895,2024-10-04 19:40:44,0,0,0,0,0,0
2,201392387,2170660915,22663,36895,2024-10-04 19:40:44,0,0,0,0,0,0
2,201392387,2170660915,0,0,2024-10-04 19:40:44,256,84,340,2,1,3
2,201392387,2170660915,39639,36895,2024-10-04 19:40:45,0,0,0,0,0,0
2,201392387,1145490691,55940,47873,2024-10-04 19:40:45,4972,70467,75439,39,54,93
2,201392387,2170660915,22663,36895,2024-10-04 19:40:45,0,0,0,0,0,0
2,201392387,2170660915,0,0,2024-10-04 19:40:45,128,168,296,1,2,3
2,201392387,2170660915,39639,36895,2024-10-04 19:40:46,0,0,0,0,0,0
2,201392387,1145490691,55940,47873,2024-10-04 19:40:46,0,0,0,0,0,0
2,201392387,2170660915,22663,36895,2024-10-04 19:40:46,0,0,0,0,0,0
2,201392387,2170660915,0,0,2024-10-04 19:40:46,0,0,0,0,0,0
2,201392387,2170660915,39639,36895,2024-10-04 19:40:47,0,0,0,0,0,0
2,201392387,1145490691,55940,47873,2024-10-04 19:40:47,0,0,0,0,0,0
2,201392387,2170660915,22663,36895,2024-10-04 19:40:47,0,0,0,0,0,0
2,201392387,2170660915,0,0,2024-10-04 19:40:47,0,0,0,0,0,0
2,201392387,2170660915,39639,36895,2024-10-04 19:40:48,0,0,0,0,0,0
2,201392387,1145490691,55940,47873,2024-10-04 19:40:48,0,0,0,0,0,0
2,201392387,2170660915,22663,36895,2024-10-04 19:40:48,0,0,0,0,0,0
2,201392387,2170660915,0,0,2024-10-04 19:40:48,0,0,0,0,0,0
2,201392387,2170660915,39639,36895,2024-10-04 19:40:49,0,0,0,0,0,0
2,201392387,1145490691,55940,47873,2024-10-04 19:40:49,0,0,0,0,0,0
2,201392387,2170660915,22663,36895,2024-10-04 19:40:49,0,0,0,0,0,0
2,201392387,2170660915,0,0,2024-10-04 19:40:49,0,0,0,0,0,0
2,201392387,2170660915,39639,36895,2024-10-04 19:40:50,0,0,0,0,0,0
2,201392387,1145490691,55940,47873,2024-10-04 19:40:50,0,0,0,0,0,0
2,201392387,2170660915,22663,36895,2024-10-04 19:40:50,0,0,0,0,0,0
2,201392387,2170660915,0,0,2024-10-04 19:40:50,0,0,0,0,0,0
2,201392387,2170660915,39639,36895,2024-10-04 19:40:51,0,0,0,0,0,0
2,201392387,1145490691,55940,47873,2024-10-04 19:40:51,2304,32851,35155,23,25,48
2,201392387,2170660915,22663,36895,2024-10-04 19:40:51,0,0,0,0,0,0
2,201392387,2170660915,0,0,2024-10-04 19:40:51,0,0,0,0,0,0
2,201392387,2170660915,39639,36895,2024-10-04 19:40:52,0,0,0,0,0,0
2,201392387,1145490691,55940,47873,2024-10-04 19:40:52,0,0,0,0,0,0
2,201392387,2170660915,22663,36895,2024-10-04 19:40:52,0,0,0,0,0,0
2,201392387,2170660915,0,0,2024-10-04 19:40:52,0,0,0,0,0,0
2,201392387,2170660915,39639,36895,2024-10-04 19:40:53,0,0,0,0,0,0
2,201392387,1145490691,55940,47873,2024-10-04 19:40:53,0,0,0,0,0,0
2,201392387,2170660915,22663,36895,2024-10-04 19:40:53,0,0,0,0,0,0
2,201392387,2170660915,0,0,2024-10-04 19:40:53,0,0,0,0,0,0
2,201392387,2170660915,39639,36895,2024-10-04 19:40:54,0,0,0,0,0,0
2,201392387,1145490691,55940,47873,2024-10-04 19:40:54,0,0,0,0,0,0
2,201392387,2170660915,22663,36895,2024-10-04 19:40:54,0,0,0,0,0,0
2,201392387,2170660915,0,0,2024-10-04 19:40:54,0,0,0,0,0,0
2,201392387,2170660915,39639,36895,2024-10-04 19:40:55,0,0,0,0,0,0
2,201392387,1145490691,55940,47873,2024-10-04 19:40:55,0,0,0,0,0,0
2,201392387,2170660915,22663,36895,2024-10-04 19:40:55,0,0,0,0,0,0
2,201392387,2170660915,0,0,2024-10-04 19:40:55,128,0,128,1,0,1
2,201392387,2170660915,39639,36895,2024-10-04 19:40:56,0,0,0,0,0,0
2,201392387,1145490691,55940,47873,2024-10-04 19:40:56,0,0,0,0,0,0
2,201392387,2170660915,22663,36895,2024-10-04 19:40:56,0,0,0,0,0,0
2,201392387,2170660915,0,0,2024-10-04 19:40:56,128,84,212,1,1,2
2,201392387,2170660915,39639,36895,2024-10-04 19:40:57,0,0,0,0,0,0
2,201392387,1145490691,55940,47873,2024-10-04 19:40:57,0,0,0,0,0,0
2,201392387,2170660915,22663,36895,2024-10-04 19:40:57,0,0,0,0,0,0
2,201392387,2170660915,0,0,2024-10-04 19:40:57,128,84,212,1,1,2
2,201392387,2170660915,39639,36895,2024-10-04 19:40:58,0,0,0,0,0,0
2,201392387,1145490691,55940,47873,2024-10-04 19:40:58,0,0,0,0,0,0
2,201392387,2170660915,22663,36895,2024-10-04 19:40:58,0,0,0,0,0,0
2,201392387,2170660915,0,0,2024-10-04 19:40:58,128,84,212,1,1,2
2,201392387,2170660915,39639,36895,2024-10-04 19:40:59,0,0,0,0,0,0
2,201392387,1145490691,55940,47873,2024-10-04 19:40:59,0,0,0,0,0,0
2,201392387,2170660915,22663,36895,2024-10-04 19:40:59,0,0,0,0,0,0
2,201392387,2170660915,0,0,2024-10-04 19:40:59,128,84,212,1,1,2
2,201392387,2170660915,39639,36895,2024-10-04 19:41:00,0,0,0,0,0,0
2,201392387,1145490691,55940,47873,2024-10-04 19:41:00,0,0,0,0,0,0
2,201392387,2170660915,22663,36895,2024-10-04 19:41:00,0,0,0,0,0,0
2,201392387,2170660915,0,0,2024-10-04 19:41:00,128,84,212,1,1,2
2,201392387,2170660915,39639,36895,2024-10-04 19:41:01,0,0,0,0,0,0
2,201392387,2170660915,22663,36895,2024-10-04 19:41:01,0,0,0,0,0,0
2,201392387,2170660915,0,0,2024-10-04 19:41:01,0,84,84,0,1,1
2,201392387,2170660915,39639,36895,2024-10-04 19:41:02,0,0,0,0,0,0
2,201392387,2170660915,22663,36895,2024-10-04 19:41:02,0,0,0,0,0,0
2,201392387,2170660915,0,0,2024-10-04 19:41:02,256,84,340,2,1,3
2,201392387,2170660915,39639,36895,2024-10-04 19:41:03,0,0,0,0,0,0
2,201392387,2170660915,22663,36895,2024-10-04 19:41:03,0,0,0,0,0,0
2,201392387,2170660915,0,0,2024-10-04 19:41:03,0,84,84,0,1,1
2,201392387,2170660915,39639,36895,2024-10-04 19:41:04,0,0,0,0,0,0
2,201392387,2170660915,22663,36895,2024-10-04 19:41:04,0,0,0,0,0,0
2,201392387,2170660915,0,0,2024-10-04 19:41:04,256,84,340,2,1,3
2,201392387,2170660915,39639,36895,2024-10-04 19:41:05,0,0,0,0,0,0
2,201392387,2170660915,22663,36895,2024-10-04 19:41:05,0,0,0,0,0,0
2,201392387,2170660915,0,0,2024-10-04 19:41:05,0,84,84,0,1,1
2,201392387,2170660915,39639,36895,2024-10-04 19:41:06,0,0,0,0,0,0
2,201392387,2170660915,22663,36895,2024-10-04 19:41:06,0,0,0,0,0,0
2,201392387,2170660915,0,0,2024-10-04 19:41:06,0,0,0,0,0,0
2,201392387,2170660915,39639,36895,2024-10-04 19:41:07,0,0,0,0,0,0
2,201392387,2170660915,22663,36895,2024-10-04 19:41:07,0,0,0,0,0,0
2,201392387,2170660915,0,0,2024-10-04 19:41:07,0,0,0,0,0,0
2,201392387,2170660915,25262,36895,2024-10-04 19:41:07,570,455,1025,5,5,10
2,201392387,2170660915,39639,36895,2024-10-04 19:41:08,0,0,0,0,0,0
2,201392387,2170660915,22663,36895,2024-10-04 19:41:08,0,0,0,0,0,0
2,201392387,2170660915,0,0,2024-10-04 19:41:08,256,168,424,2,2,4
2,201392387,2170660915,25262,36895,2024-10-04 19:41:08,0,0,0,0,0,0
2,201392387,2170660915,39639,36895,2024-10-04 19:41:09,0,0,0,0,0,0
2,201392387,2170660915,22663,36895,2024-10-04 19:41:09,0,0,0,0,0,0
2,201392387,2170660915,0,0,2024-10-04 19:41:09,128,84,212,1,1,2
2,201392387,2170660915,25262,36895,2024-10-04 19:41:09,0,0,0,0,0,0
2,201392387,2170660915,39639,36895,2024-10-04 19:41:10,0,0,0,0,0,0
2,201392387,2170660915,22663,36895,2024-10-04 19:41:10,0,0,0,0,0,0
2,201392387,2170660915,0,0,2024-10-04 19:41:10,0,0,0,0,0,0
2,201392387,2170660915,25262,36895,2024-10-04 19:41:10,0,0,0,0,0,0
2,201392387,2170660915,39639,36895,2024-10-04 19:41:11,0,0,0,0,0,0
2,201392387,2170660915,22663,36895,2024-10-04 19:41:11,0,0,0,0,0,0
2,201392387,2170660915,0,0,2024-10-04 19:41:11,0,0,0,0,0,0
2,201392387,2170660915,25262,36895,2024-10-04 19:41:11,0,0,0,0,0,0
2,201392387,2170660915,39639,36895,2024-10-04 19:41:12,0,0,0,0,0,0
2,201392387,2170660915,22663,36895,2024-10-04 19:41:12,0,0,0,0,0,0
2,201392387,2170660915,0,0,2024-10-04 19:41:12,0,0,0,0,0,0
2,201392387,2170660915,25262,36895,2024-10-04 19:41:12,0,0,0,0,0,0
2,201392387,2170660915,39639,36895,2024-10-04 19:41:13,0,0,0,0,0,0
2,201392387,2170660915,22663,36895,2024-10-04 19:41:13,0,0,0,0,0,0
2,201392387,2170660915,0,0,2024-10-04 19:41:13,128,84,212,1,1,2
2,201392387,2170660915,25262,36895,2024-10-04 19:41:13,0,0,0,0,0,0
2,201392387,2170660915,39639,36895,2024-10-04 19:41:14,0,0,0,0,0,0
2,201392387,2170660915,22663,36895,2024-10-04 19:41:14,0,0,0,0,0,0
2,201392387,2170660915,0,0,2024-10-04 19:41:14,0,0,0,0,0,0
2,201392387,2170660915,25262,36895,2024-10-04 19:41:14,0,0,0,0,0,0
2,201392387,2170660915,39639,36895,2024-10-04 19:41:15,0,0,0,0,0,0
2,201392387,2170660915,22663,36895,2024-10-04 19:41:15,0,0,0,0,0,0
2,201392387,2170660915,0,0,2024-10-04 19:41:15,256,168,424,2,2,4
2,201392387,1145490691,7840,47873,2024-10-04 19:41:15,5012,87559,92571,40,67,107
2,201392387,2170660915,39639,36895,2024-10-04 19:41:16,0,0,0,0,0,0
2,201392387,2170660915,22663,36895,2024-10-04 19:41:16,0,0,0,0,0,0
2,201392387,2170660915,0,0,2024-10-04 19:41:16,0,0,0,0,0,0
2,201392387,1145490691,7840,47873,2024-10-04 19:41:16,0,0,0,0,0,0
2,201392387,2170660915,39639,36895,2024-10-04 19:41:17,0,0,0,0,0,0
2,201392387,2170660915,22663,36895,2024-10-04 19:41:17,0,0,0,0,0,0
2,201392387,2170660915,0,0,2024-10-04 19:41:17,0,0,0,0,0,0
2,201392387,1145490691,7840,47873,2024-10-04 19:41:17,0,0,0,0,0,0
2,201392387,2170660915,39639,36895,2024-10-04 19:41:18,0,0,0,0,0,0
2,201392387,2170660915,22663,36895,2024-10-04 19:41:18,0,0,0,0,0,0
2,201392387,2170660915,0,0,2024-10-04 19:41:18,0,0,0,0,0,0
2,201392387,1145490691,7840,47873,2024-10-04 19:41:18,0,0,0,0,0,0
2,201392387,2170660915,39639,36895,2024-10-04 19:41:19,0,0,0,0,0,0
2,201392387,2170660915,22663,36895,2024-10-04 19:41:19,0,0,0,0,0,0
2,201392387,2170660915,0,0,2024-10-04 19:41:19,0,0,0,0,0,0
2,201392387,1145490691,7840,47873,2024-10-04 19:41:19,0,0,0,0,0,0
2,201392387,2170660915,39639,36895,2024-10-04 19:41:20,0,0,0,0,0,0
2,201392387,2170660915,22663,36895,2024-10-04 19:41:20,0,0,0,0,0,0
2,201392387,2170660915,0,0,2024-10-04 19:41:20,0,0,0,0,0,0
2,201392387,1145490691,7840,47873,2024-10-04 19:41:20,0,0,0,0,0,0
2,201392387,2170660915,39639,36895,2024-10-04 19:41:21,0,0,0,0,0,0
2,201392387,2170660915,22663,36895,2024-10-04 19:41:21,0,0,0,0,0,0
2,201392387,2170660915,0,0,2024-10-04 19:41:21,0,0,0,0,0,0
2,201392387,1145490691,7840,47873,2024-10-04 19:41:21,0,0,0,0,0,0
2,201392387,2170660915,39639,36895,2024-10-04 19:41:22,0,0,0,0,0,0
2,201392387,2170660915,22663,36895,2024-10-04 19:41:22,0,0,0,0,0,0
2,201392387,2170660915,0,0,2024-10-04 19:41:22,0,0,0,0,0,0
2,201392387,1145490691,7840,47873,2024-10-04 19:41:22,0,0,0,0,0,0
2,201392387,2170660915,39639,36895,2024-10-04 19:41:23,0,0,0,0,0,0
2,201392387,2170660915,22663,36895,2024-10-04 19:41:23,0,0,0,0,0,0
2,201392387,2170660915,0,0,2024-10-04 19:41:23,0,0,0,0,0,0
2,201392387,1145490691,7840,47873,2024-10-04 19:41:23,936,13777,14713,9,12,21
2,201392387,2170660915,39639,36895,2024-10-04 19:41:24,0,0,0,0,0,0
2,201392387,2170660915,22663,36895,2024-10-04 19:41:24,0,0,0,0,0,0
2,201392387,2170660915,0,0,2024-10-04 19:41:24,0,0,0,0,0,0
2,201392387,1145490691,7840,47873,2024-10-04 19:41:24,0,0,0,0,0,0
2,201392387,2170660915,39639,36895,2024-10-04 19:41:25,0,0,0,0,0,0
2,201392387,2170660915,22663,36895,2024-10-04 19:41:25,0,0,0,0,0,0
2,201392387,2170660915,0,0,2024-10-04 19:41:25,0,0,0,0,0,0
2,201392387,1145490691,7840,47873,2024-10-04 19:41:25,0,0,0,0,0,0
2,201392387,2170660915,39639,36895,2024-10-04 19:41:26,0,0,0,0,0,0
2,201392387,2170660915,22663,36895,2024-10-04 19:41:26,0,0,0,0,0,0
2,201392387,2170660915,0,0,2024-10-04 19:41:26,128,84,212,1,1,2
2,201392387,1145490691,7840,47873,2024-10-04 19:41:26,0,0,0,0,0,0
2,201392387,2170660915,39639,36895,2024-10-04 19:41:27,0,0,0,0,0,0
2,201392387,2170660915,22663,36895,2024-10-04 19:41:27,0,0,0,0,0,0
2,201392387,2170660915,0,0,2024-10-04 19:41:27,128,84,212,1,1,2
2,201392387,1145490691,7840,47873,2024-10-04 19:41:27,0,0,0,0,0,0
2,201392387,2170660915,39639,36895,2024-10-04 19:41:28,0,0,0,0,0,0
2,201392387,2170660915,22663,36895,2024-10-04 19:41:28,0,0,0,0,0,0
2,201392387,2170660915,0,0,2024-10-04 19:41:28,128,84,212,1,1,2
2,201392387,1145490691,7840,47873,2024-10-04 19:41:28,0,0,0,0,0,0
2,201392387,2170660915,39639,36895,2024-10-04 19:41:29,0,0,0,0,0,0
2,201392387,2170660915,22663,36895,2024-10-04 19:41:29,0,0,0,0,0,0
2,201392387,2170660915,0,0,2024-10-04 19:41:29,0,0,0,0,0,0
2,201392387,1145490691,7840,47873,2024-10-04 19:41:29,0,0,0,0,0,0
2,201392387,2170660915,39639,36895,2024-10-04 19:41:30,0,0,0,0,0,0
2,201392387,2170660915,22663,36895,2024-10-04 19:41:30,0,0,0,0,0,0
2,201392387,2170660915,0,0,2024-10-04 19:41:30,128,84,212,1,1,2
2,201392387,1145490691,7840,47873,2024-10-04 19:41:30,0,0,0,0,0,0
2,201392387,2170660915,39639,36895,2024-10-04 19:41:31,0,0,0,0,0,0
2,201392387,2170660915,22663,36895,2024-10-04 19:41:31,0,0,0,0,0,0
2,201392387,2170660915,0,0,2024-10-04 19:41:31,128,84,212,1,1,2
2,201392387,1145490691,7840,47873,2024-10-04 19:41:31,0,0,0,0,0,0
2,201392387,2170660915,39639,36895,2024-10-04 19:41:32,0,0,0,0,0,0
2,201392387,2170660915,22663,36895,2024-10-04 19:41:32,0,0,0,0,0,0
2,201392387,2170660915,0,0,2024-10-04 19:41:32,128,84,212,1,1,2
2,201392387,1145490691,7840,47873,2024-10-04 19:41:32,0,0,0,0,0,0
2,201392387,2170660915,39639,36895,2024-10-04 19:41:33,0,0,0,0,0,0
2,201392387,2170660915,22663,36895,2024-10-04 19:41:33,0,0,0,0,0,0
2,201392387,2170660915,0,0,2024-10-04 19:41:33,256,168,424,2,2,4
2,201392387,2170660915,39639,36895,2024-10-04 19:41:34,0,0,0,0,0,0
2,201392387,2170660915,22663,36895,2024-10-04 19:41:34,0,0,0,0,0,0
2,201392387,2170660915,0,0,2024-10-04 19:41:34,128,84,212,1,1,2
2,201392387,2170660915,39639,36895,2024-10-04 19:41:35,0,0,0,0,0,0
2,201392387,2170660915,22663,36895,2024-10-04 19:41:35,0,0,0,0,0,0
2,201392387,2170660915,0,0,2024-10-04 19:41:35,128,84,212,1,1,2
2,201392387,2170660915,39639,36895,2024-10-04 19:41:36,0,0,0,0,0,0
2,201392387,2170660915,22663,36895,2024-10-04 19:41:36,0,0,0,0,0,0
2,201392387,2170660915,0,0,2024-10-04 19:41:36,0,0,0,0,0,0
2,201392387,2170660915,39639,36895,2024-10-04 19:41:37,0,0,0,0,0,0
2,201392387,2170660915,22663,36895,2024-10-04 19:41:37,0,0,0,0,0,0
2,201392387,2170660915,39564,36895,2024-10-04 19:41:37,666,507,1173,6,6,12
2,201392387,2170660915,0,0,2024-10-04 19:41:37,0,0,0,0,0,0
2,201392387,2170660915,39639,36895,2024-10-04 19:41:38,0,0,0,0,0,0
2,201392387,2170660915,22663,36895,2024-10-04 19:41:38,0,0,0,0,0,0
2,201392387,2170660915,39564,36895,2024-10-04 19:41:38,0,0,0,0,0,0
2,201392387,2170660915,0,0,2024-10-04 19:41:38,256,84,340,2,1,3
2,201392387,2170660915,39639,36895,2024-10-04 19:41:39,0,0,0,0,0,0
2,201392387,2170660915,22663,36895,2024-10-04 19:41:39,0,0,0,0,0,0
2,201392387,2170660915,39564,36895,2024-10-04 19:41:39,0,0,0,0,0,0
2,201392387,2170660915,0,0,2024-10-04 19:41:39,128,84,212,1,1,2
2,201392387,2170660915,39639,36895,2024-10-04 19:41:40,0,0,0,0,0,0
2,201392387,2170660915,22663,36895,2024-10-04 19:41:40,0,0,0,0,0,0
2,201392387,2170660915,39564,36895,2024-10-04 19:41:40,0,0,0,0,0,0
2,201392387,2170660915,0,0,2024-10-04 19:41:40,0,84,84,0,1,1
2,201392387,2170660915,39639,36895,2024-10-04 19:41:41,0,0,0,0,0,0
2,201392387,2170660915,22663,36895,2024-10-04 19:41:41,0,0,0,0,0,0
2,201392387,2170660915,39564,36895,2024-10-04 19:41:41,0,0,0,0,0,0
2,201392387,2170660915,0,0,2024-10-04 19:41:41,0,0,0,0,0,0
2,201392387,2170660915,39639,36895,2024-10-04 19:41:42,0,0,0,0,0,0
2,201392387,2170660915,22663,36895,2024-10-04 19:41:42,0,0,0,0,0,0
2,201392387,2170660915,39564,36895,2024-10-04 19:41:42,0,0,0,0,0,0
2,201392387,2170660915,0,0,2024-10-04 19:41:42,0,0,0,0,0,0
2,201392387,2170660915,39639,36895,2024-10-04 19:41:43,0,0,0,0,0,0
2,201392387,2170660915,22663,36895,2024-10-04 19:41:43,0,0,0,0,0,0
2,201392387,2170660915,39564,36895,2024-10-04 19:41:43,0,0,0,0,0,0
2,201392387,2170660915,0,0,2024-10-04 19:41:43,128,84,212,1,1,2
2,201392387,2170660915,39639,36895,2024-10-04 19:41:44,0,0,0,0,0,0
2,201392387,2170660915,22663,36895,2024-10-04 19:41:44,0,0,0,0,0,0
2,201392387,2170660915,39564,36895,2024-10-04 19:41:44,0,0,0,0,0,0
2,201392387,2170660915,0,0,2024-10-04 19:41:44,128,84,212,1,1,2
2,201392387,2170660915,39639,36895,2024-10-04 19:41:45,0,0,0,0,0,0
2,201392387,2170660915,22663,36895,2024-10-04 19:41:45,0,0,0,0,0,0
2,201392387,2170660915,39564,36895,2024-10-04 19:41:45,0,0,0,0,0,0
2,201392387,2170660915,0,0,2024-10-04 19:41:45,128,84,212,1,1,2
2,201392387,1145490691,12511,47873,2024-10-04 19:41:45,1029,5429,6458,5,6,11
2,201392387,2170660915,39639,36895,2024-10-04 19:41:46,0,0,0,0,0,0
2,201392387,2170660915,22663,36895,2024-10-04 19:41:46,0,0,0,0,0,0
2,201392387,2170660915,39564,36895,2024-10-04 19:41:46,0,0,0,0,0,0
2,201392387,2170660915,0,0,2024-10-04 19:41:46,0,0,0,0,0,0
2,201392387,1145490691,12511,47873,2024-10-04 19:41:46,4563,87637,92200,42,66,108
2,201392387,2170660915,39639,36895,2024-10-04 19:41:47,0,0,0,0,0,0
2,201392387,2170660915,22663,36895,2024-10-04 19:41:47,0,0,0,0,0,0
2,201392387,2170660915,39564,36895,2024-10-04 19:41:47,0,0,0,0,0,0
2,201392387,2170660915,0,0,2024-10-04 19:41:47,0,0,0,0,0,0
2,201392387,1145490691,12511,47873,2024-10-04 19:41:47,0,0,0,0,0,0
2,201392387,2170660915,39639,36895,2024-10-04 19:41:48,0,0,0,0,0,0
2,201392387,2170660915,22663,36895,2024-10-04 19:41:48,0,0,0,0,0,0
2,201392387,2170660915,39564,36895,2024-10-04 19:41:48,0,0,0,0,0,0
2,201392387,2170660915,0,0,2024-10-04 19:41:48,0,0,0,0,0,0
2,201392387,1145490691,12511,47873,2024-10-04 19:41:48,0,0,0,0,0,0
2,201392387,2170660915,39639,36895,2024-10-04 19:41:49,0,0,0,0,0,0
2,201392387,2170660915,22663,36895,2024-10-04 19:41:49,0,0,0,0,0,0
2,201392387,2170660915,39564,36895,2024-10-04 19:41:49,0,0,0,0,0,0
2,201392387,2170660915,0,0,2024-10-04 19:41:49,0,0,0,0,0,0
2,201392387,1145490691,12511,47873,2024-10-04 19:41:49,0,0,0,0,0,0
2,201392387,2170660915,39639,36895,2024-10-04 19:41:50,0,0,0,0,0,0
2,201392387,2170660915,22663,36895,2024-10-04 19:41:50,0,0,0,0,0,0
2,201392387,2170660915,39564,36895,2024-10-04 19:41:50,0,0,0,0,0,0
2,201392387,2170660915,0,0,2024-10-04 19:41:50,0,0,0,0,0,0
2,201392387,1145490691,12511,47873,2024-10-04 19:41:50,0,0,0,0,0,0
2,201392387,2170660915,39639,36895,2024-10-04 19:41:51,0,0,0,0,0,0
2,201392387,2170660915,22663,36895,2024-10-04 19:41:51,0,0,0,0,0,0
2,201392387,2170660915,39564,36895,2024-10-04 19:41:51,0,0,0,0,0,0
2,201392387,2170660915,0,0,2024-10-04 19:41:51,0,0,0,0,0,0
2,201392387,1145490691,12511,47873,2024-10-04 19:41:51,0,0,0,0,0,0
2,201392387,2170660915,39639,36895,2024-10-04 19:41:52,0,0,0,0,0,0
2,201392387,2170660915,22663,36895,2024-10-04 19:41:52,0,0,0,0,0,0
2,201392387,2170660915,39564,36895,2024-10-04 19:41:52,0,0,0,0,0,0
2,201392387,2170660915,0,0,2024-10-04 19:41:52,0,0,0,0,0,0
2,201392387,1145490691,12511,47873,2024-10-04 19:41:52,0,0,0,0,0,0
2,201392387,2170660915,39639,36895,2024-10-04 19:41:53,0,0,0,0,0,0
2,201392387,2170660915,22663,36895,2024-10-04 19:41:53,0,0,0,0,0,0
2,201392387,2170660915,39564,36895,2024-10-04 19:41:53,0,0,0,0,0,0
2,201392387,2170660915,0,0,2024-10-04 19:41:53,0,0,0,0,0,0
2,201392387,1145490691,12511,47873,2024-10-04 19:41:53,408,156,564,4,3,7
2,201392387,2170660915,39639,36895,2024-10-04 19:41:54,0,0,0,0,0,0
2,201392387,2170660915,22663,36895,2024-10-04 19:41:54,0,0,0,0,0,0
2,201392387,2170660915,39564,36895,2024-10-04 19:41:54,0,0,0,0,0,0
2,201392387,2170660915,0,0,2024-10-04 19:41:54,0,0,0,0,0,0
2,201392387,1145490691,12511,47873,2024-10-04 19:41:54,0,0,0,0,0,0
2,201392387,2170660915,39639,36895,2024-10-04 19:41:55,0,0,0,0,0,0
2,201392387,2170660915,22663,36895,2024-10-04 19:41:55,0,0,0,0,0,0
2,201392387,2170660915,39564,36895,2024-10-04 19:41:55,0,0,0,0,0,0
2,201392387,2170660915,0,0,2024-10-04 19:41:55,0,0,0,0,0,0
2,201392387,1145490691,12511,47873,2024-10-04 19:41:55,0,0,0,0,0,0
2,201392387,2170660915,39639,36895,2024-10-04 19:41:56,0,0,0,0,0,0
2,201392387,2170660915,22663,36895,2024-10-04 19:41:56,0,0,0,0,0,0
2,201392387,2170660915,39564,36895,2024-10-04 19:41:56,0,0,0,0,0,0
2,201392387,2170660915,0,0,2024-10-04 19:41:56,128,0,128,1,0,1
2,201392387,1145490691,12511,47873,2024-10-04 19:41:56,0,0,0,0,0,0
2,201392387,2170660915,39639,36895,2024-10-04 19:41:57,0,0,0,0,0,0
2,201392387,2170660915,22663,36895,2024-10-04 19:41:57,0,0,0,0,0,0
2,201392387,2170660915,39564,36895,2024-10-04 19:41:57,0,0,0,0,0,0
2,201392387,2170660915,0,0,2024-10-04 19:41:57,128,84,212,1,1,2
2,201392387,1145490691,12511,47873,2024-10-04 19:41:57,0,0,0,0,0,0
2,201392387,2170660915,39639,36895,2024-10-04 19:41:58,0,0,0,0,0,0
2,201392387,2170660915,22663,36895,2024-10-04 19:41:58,0,0,0,0,0,0
2,201392387,2170660915,39564,36895,2024-10-04 19:41:58,0,0,0,0,0,0
2,201392387,2170660915,0,0,2024-10-04 19:41:58,128,84,212,1,1,2
2,201392387,1145490691,12511,47873,2024-10-04 19:41:58,0,0,0,0,0,0
2,201392387,2170660915,39639,36895,2024-10-04 19:41:59,0,0,0,0,0,0
2,201392387,2170660915,22663,36895,2024-10-04 19:41:59,0,0,0,0,0,0
2,201392387,2170660915,39564,36895,2024-10-04 19:41:59,0,0,0,0,0,0
2,201392387,2170660915,0,0,2024-10-04 19:41:59,128,84,212,1,1,2
2,201392387,1145490691,12511,47873,2024-10-04 19:41:59,0,0,0,0,0,0
2,201392387,2170660915,39639,36895,2024-10-04 19:42:00,0,0,0,0,0,0
2,201392387,2170660915,22663,36895,2024-10-04 19:42:00,0,0,0,0,0,0
2,201392387,2170660915,39564,36895,2024-10-04 19:42:00,0,0,0,0,0,0
2,201392387,2170660915,0,0,2024-10-04 19:42:00,128,84,212,1,1,2
2,201392387,1145490691,12511,47873,2024-10-04 19:42:00,0,0,0,0,0,0
2,201392387,2170660915,39639,36895,2024-10-04 19:42:01,0,0,0,0,0,0
2,201392387,2170660915,22663,36895,2024-10-04 19:42:01,0,0,0,0,0,0
2,201392387,2170660915,39564,36895,2024-10-04 19:42:01,0,0,0,0,0,0
2,201392387,2170660915,0,0,2024-10-04 19:42:01,128,84,212,1,1,2
2,201392387,1145490691,12511,47873,2024-10-04 19:42:01,0,0,0,0,0,0
2,201392387,2170660915,39639,36895,2024-10-04 19:42:02,0,0,0,0,0,0
2,201392387,2170660915,22663,36895,2024-10-04 19:42:02,0,0,0,0,0,0
2,201392387,2170660915,39564,36895,2024-10-04 19:42:02,0,0,0,0,0,0
2,201392387,2170660915,0,0,2024-10-04 19:42:02,128,84,212,1,1,2
2,201392387,1145490691,12511,47873,2024-10-04 19:42:02,0,0,0,0,0,0
2,201392387,2170660915,39639,36895,2024-10-04 19:42:03,0,0,0,0,0,0
2,201392387,2170660915,22663,36895,2024-10-04 19:42:03,0,0,0,0,0,0
2,201392387,2170660915,39564,36895,2024-10-04 19:42:03,0,0,0,0,0,0
2,201392387,2170660915,0,0,2024-10-04 19:42:03,128,84,212,1,1,2
2,201392387,1145490691,12511,47873,2024-10-04 19:42:03,0,0,0,0,0,0
2,201392387,2170660915,39639,36895,2024-10-04 19:42:04,0,0,0,0,0,0
2,201392387,2170660915,22663,36895,2024-10-04 19:42:04,0,0,0,0,0,0
2,201392387,2170660915,39564,36895,2024-10-04 19:42:04,0,0,0,0,0,0
2,201392387,2170660915,0,0,2024-10-04 19:42:04,128,84,212,1,1,2
2,201392387,2170660915,39639,36895,2024-10-04 19:42:05,0,0,0,0,0,0
2,201392387,2170660915,22663,36895,2024-10-04 19:42:05,0,0,0,0,0,0
2,201392387,2170660915,39564,36895,2024-10-04 19:42:05,0,0,0,0,0,0
2,201392387,2170660915,0,0,2024-10-04 19:42:05,0,84,84,0,1,1
2,201392387,2170660915,39639,36895,2024-10-04 19:42:06,0,0,0,0,0,0
2,201392387,2170660915,22663,36895,2024-10-04 19:42:06,0,0,0,0,0,0
2,201392387,2170660915,0,0,2024-10-04 19:42:06,128,84,212,1,1,2
2,201392387,2170660915,39639,36895,2024-10-04 19:42:07,0,0,0,0,0,0
2,201392387,2170660915,22663,36895,2024-10-04 19:42:07,0,0,0,0,0,0
2,201392387,2170660915,50401,36895,2024-10-04 19:42:07,666,507,1173,6,6,12
2,201392387,2170660915,0,0,2024-10-04 19:42:07,0,0,0,0,0,0
2,201392387,2170660915,39639,36895,2024-10-04 19:42:08,0,0,0,0,0,0
2,201392387,2170660915,22663,36895,2024-10-04 19:42:08,0,0,0,0,0,0
2,201392387,2170660915,50401,36895,2024-10-04 19:42:08,0,0,0,0,0,0
2,201392387,2170660915,0,0,2024-10-04 19:42:08,128,84,212,1,1,2
2,201392387,2170660915,39639,36895,2024-10-04 19:42:09,0,0,0,0,0,0
2,201392387,2170660915,22663,36895,2024-10-04 19:42:09,0,0,0,0,0,0
2,201392387,2170660915,50401,36895,2024-10-04 19:42:09,0,0,0,0,0,0
2,201392387,2170660915,0,0,2024-10-04 19:42:09,0,0,0,0,0,0
2,201392387,2170660915,39639,36895,2024-10-04 19:42:10,0,0,0,0,0,0
2,201392387,2170660915,22663,36895,2024-10-04 19:42:10,0,0,0,0,0,0
2,201392387,2170660915,50401,36895,2024-10-04 19:42:10,0,0,0,0,0,0
2,201392387,2170660915,0,0,2024-10-04 19:42:10,256,84,340,2,1,3
2,201392387,2170660915,39639,36895,2024-10-04 19:42:11,0,0,0,0,0,0
2,201392387,2170660915,22663,36895,2024-10-04 19:42:11,0,0,0,0,0,0
2,201392387,2170660915,50401,36895,2024-10-04 19:42:11,0,0,0,0,0,0
2,201392387,2170660915,0,0,2024-10-04 19:42:11,0,84,84,0,1,1
2,201392387,2170660915,39639,36895,2024-10-04 19:42:12,0,0,0,0,0,0
2,201392387,2170660915,22663,36895,2024-10-04 19:42:12,0,0,0,0,0,0
2,201392387,2170660915,50401,36895,2024-10-04 19:42:12,0,0,0,0,0,0
2,201392387,2170660915,0,0,2024-10-04 19:42:12,0,0,0,0,0,0
2,201392387,2170660915,39639,36895,2024-10-04 19:42:13,0,0,0,0,0,0
2,201392387,2170660915,22663,36895,2024-10-04 19:42:13,0,0,0,0,0,0
2,201392387,2170660915,50401,36895,2024-10-04 19:42:13,0,0,0,0,0,0
2,201392387,2170660915,0,0,2024-10-04 19:42:13,128,0,128,1,0,1
2,201392387,2170660915,39639,36895,2024-10-04 19:42:14,0,0,0,0,0,0
2,201392387,2170660915,22663,36895,2024-10-04 19:42:14,0,0,0,0,0,0
2,201392387,2170660915,50401,36895,2024-10-04 19:42:14,0,0,0,0,0,0
2,201392387,2170660915,0,0,2024-10-04 19:42:14,0,84,84,0,1,1
2,201392387,2170660915,39639,36895,2024-10-04 19:42:15,0,0,0,0,0,0
2,201392387,2170660915,22663,36895,2024-10-04 19:42:15,0,0,0,0,0,0
2,201392387,2170660915,50401,36895,2024-10-04 19:42:15,0,0,0,0,0,0
2,201392387,2170660915,0,0,2024-10-04 19:42:15,128,84,212,1,1,2
2,201392387,2170660915,39639,36895,2024-10-04 19:42:16,0,0,0,0,0,0
2,201392387,2170660915,22663,36895,2024-10-04 19:42:16,0,0,0,0,0,0
2,201392387,2170660915,50401,36895,2024-10-04 19:42:16,0,0,0,0,0,0
2,201392387,2170660915,0,0,2024-10-04 19:42:16,0,0,0,0,0,0
2,201392387,2170660915,39639,36895,2024-10-04 19:42:17,0,0,0,0,0,0
2,201392387,2170660915,22663,36895,2024-10-04 19:42:17,0,0,0,0,0,0
2,201392387,2170660915,50401,36895,2024-10-04 19:42:17,0,0,0,0,0,0
2,201392387,2170660915,0,0,2024-10-04 19:42:17,0,0,0,0,0,0
2,201392387,2170660915,39639,36895,2024-10-04 19:42:18,0,0,0,0,0,0
2,201392387,2170660915,22663,36895,2024-10-04 19:42:18,0,0,0,0,0,0
2,201392387,2170660915,50401,36895,2024-10-04 19:42:18,0,0,0,0,0,0
2,201392387,2170660915,0,0,2024-10-04 19:42:18,0,0,0,0,0,0
2,201392387,2170660915,39639,36895,2024-10-04 19:42:19,0,0,0,0,0,0
2,201392387,2170660915,22663,36895,2024-10-04 19:42:19,0,0,0,0,0,0
2,201392387,2170660915,50401,36895,2024-10-04 19:42:19,0,0,0,0,0,0
2,201392387,2170660915,0,0,2024-10-04 19:42:19,0,0,0,0,0,0
2,201392387,2170660915,39639,36895,2024-10-04 19:42:20,0,0,0,0,0,0
2,201392387,2170660915,22663,36895,2024-10-04 19:42:20,0,0,0,0,0,0
2,201392387,2170660915,50401,36895,2024-10-04 19:42:20,0,0,0,0,0,0
2,201392387,2170660915,0,0,2024-10-04 19:42:20,0,0,0,0,0,0
2,201392387,2170660915,39639,36895,2024-10-04 19:42:21,0,0,0,0,0,0
2,201392387,2170660915,22663,36895,2024-10-04 19:42:21,0,0,0,0,0,0
2,201392387,2170660915,50401,36895,2024-10-04 19:42:21,0,0,0,0,0,0
2,201392387,2170660915,0,0,2024-10-04 19:42:21,0,0,0,0,0,0
2,201392387,2170660915,39639,36895,2024-10-04 19:42:22,0,0,0,0,0,0
2,201392387,2170660915,22663,36895,2024-10-04 19:42:22,0,0,0,0,0,0
2,201392387,2170660915,50401,36895,2024-10-04 19:42:22,0,0,0,0,0,0
2,201392387,2170660915,0,0,2024-10-04 19:42:22,0,0,0,0,0,0
2,201392387,2170660915,39639,36895,2024-10-04 19:42:23,0,0,0,0,0,0
2,201392387,2170660915,22663,36895,2024-10-04 19:42:23,0,0,0,0,0,0
2,201392387,2170660915,50401,36895,2024-10-04 19:42:23,0,0,0,0,0,0
2,201392387,2170660915,0,0,2024-10-04 19:42:23,0,0,0,0,0,0
2,201392387,2170660915,39639,36895,2024-10-04 19:42:24,0,0,0,0,0,0
2,201392387,2170660915,22663,36895,2024-10-04 19:42:24,0,0,0,0,0,0
2,201392387,1145490689,4301,47873,2024-10-04 19:42:24,6436,91188,97624,55,74,129
2,201392387,2170660915,0,0,2024-10-04 19:42:24,128,84,212,1,1,2
2,201392387,2170660915,39639,36895,2024-10-04 19:42:25,0,0,0,0,0,0
2,201392387,2170660915,22663,36895,2024-10-04 19:42:25,0,0,0,0,0,0
2,201392387,1145490689,4301,47873,2024-10-04 19:42:25,0,0,0,0,0,0
2,201392387,2170660915,0,0,2024-10-04 19:42:25,0,0,0,0,0,0
2,201392387,2170660915,39639,36895,2024-10-04 19:42:26,0,0,0,0,0,0
2,201392387,2170660915,22663,36895,2024-10-04 19:42:26,0,0,0,0,0,0
2,201392387,1145490689,4301,47873,2024-10-04 19:42:26,0,0,0,0,0,0
2,201392387,2170660915,0,0,2024-10-04 19:42:26,128,84,212,1,1,2
2,201392387,2170660915,39639,36895,2024-10-04 19:42:27,0,0,0,0,0,0
2,201392387,2170660915,22663,36895,2024-10-04 19:42:27,0,0,0,0,0,0
2,201392387,1145490689,4301,47873,2024-10-04 19:42:27,0,0,0,0,0,0
2,201392387,2170660915,0,0,2024-10-04 19:42:27,128,84,212,1,1,2
2,201392387,2170660915,39639,36895,2024-10-04 19:42:28,0,0,0,0,0,0
2,201392387,2170660915,22663,36895,2024-10-04 19:42:28,0,0,0,0,0,0
2,201392387,1145490689,4301,47873,2024-10-04 19:42:28,0,0,0,0,0,0
2,201392387,2170660915,0,0,2024-10-04 19:42:28,128,0,128,1,0,1
2,201392387,2170660915,39639,36895,2024-10-04 19:42:29,0,0,0,0,0,0
2,201392387,2170660915,22663,36895,2024-10-04 19:42:29,0,0,0,0,0,0
2,201392387,1145490689,4301,47873,2024-10-04 19:42:29,0,0,0,0,0,0
2,201392387,2170660915,0,0,2024-10-04 19:42:29,128,84,212,1,1,2
2,201392387,2170660915,39639,36895,2024-10-04 19:42:30,0,0,0,0,0,0
2,201392387,2170660915,22663,36895,2024-10-04 19:42:30,0,0,0,0,0,0
2,201392387,1145490689,4301,47873,2024-10-04 19:42:30,0,0,0,0,0,0
2,201392387,2170660915,0,0,2024-10-04 19:42:30,128,84,212,1,1,2
2,201392387,2170660915,39639,36895,2024-10-04 19:42:31,0,0,0,0,0,0
2,201392387,2170660915,22663,36895,2024-10-04 19:42:31,0,0,0,0,0,0
2,201392387,1145490689,4301,47873,2024-10-04 19:42:31,0,0,0,0,0,0
2,201392387,2170660915,0,0,2024-10-04 19:42:31,128,84,212,1,1,2
2,201392387,2170660915,39639,36895,2024-10-04 19:42:32,0,0,0,0,0,0
2,201392387,2170660915,22663,36895,2024-10-04 19:42:32,0,0,0,0,0,0
2,201392387,1145490689,4301,47873,2024-10-04 19:42:32,0,0,0,0,0,0
2,201392387,2170660915,0,0,2024-10-04 19:42:32,128,84,212,1,1,2
2,201392387,2170660915,39639,36895,2024-10-04 19:42:33,0,0,0,0,0,0
2,201392387,2170660915,22663,36895,2024-10-04 19:42:33,0,0,0,0,0,0
2,201392387,1145490689,4301,47873,2024-10-04 19:42:33,0,0,0,0,0,0
2,201392387,2170660915,0,0,2024-10-04 19:42:33,128,84,212,1,1,2
2,201392387,2170660915,39639,36895,2024-10-04 19:42:34,0,0,0,0,0,0
2,201392387,2170660915,22663,36895,2024-10-04 19:42:34,0,0,0,0,0,0
2,201392387,2170660915,0,0,2024-10-04 19:42:34,128,84,212,1,1,2
2,201392387,2170660915,39639,36895,2024-10-04 19:42:35,0,0,0,0,0,0
2,201392387,2170660915,22663,36895,2024-10-04 19:42:35,0,0,0,0,0,0
2,201392387,2170660915,0,0,2024-10-04 19:42:35,128,84,212,1,1,2
2,201392387,2170660915,39639,36895,2024-10-04 19:42:36,0,0,0,0,0,0
2,201392387,2170660915,22663,36895,2024-10-04 19:42:36,0,0,0,0,0,0
2,201392387,2170660915,0,0,2024-10-04 19:42:36,0,84,84,0,1,1
2,201392387,2170660915,39639,36895,2024-10-04 19:42:37,0,0,0,0,0,0
2,201392387,2170660915,22663,36895,2024-10-04 19:42:37,0,0,0,0,0,0
2,201392387,2170660915,12955,36895,2024-10-04 19:42:37,666,507,1173,6,6,12
2,201392387,2170660915,0,0,2024-10-04 19:42:37,0,0,0,0,0,0
2,201392387,2170660915,39639,36895,2024-10-04 19:42:38,0,0,0,0,0,0
2,201392387,2170660915,22663,36895,2024-10-04 19:42:38,0,0,0,0,0,0
2,201392387,2170660915,12955,36895,2024-10-04 19:42:38,0,0,0,0,0,0
2,201392387,2170660915,0,0,2024-10-04 19:42:38,128,84,212,1,1,2
2,201392387,2170660915,39639,36895,2024-10-04 19:42:39,0,0,0,0,0,0
2,201392387,2170660915,22663,36895,2024-10-04 19:42:39,0,0,0,0,0,0
2,201392387,2170660915,12955,36895,2024-10-04 19:42:39,0,0,0,0,0,0
2,201392387,2170660915,0,0,2024-10-04 19:42:39,128,84,212,1,1,2
2,201392387,2170660915,39639,36895,2024-10-04 19:42:40,0,0,0,0,0,0
2,201392387,2170660915,22663,36895,2024-10-04 19:42:40,0,0,0,0,0,0
2,201392387,2170660915,12955,36895,2024-10-04 19:42:40,0,0,0,0,0,0
2,201392387,2170660915,0,0,2024-10-04 19:42:40,0,0,0,0,0,0
2,201392387,2170660915,39639,36895,2024-10-04 19:42:41,0,0,0,0,0,0
2,201392387,2170660915,22663,36895,2024-10-04 19:42:41,0,0,0,0,0,0
2,201392387,2170660915,12955,36895,2024-10-04 19:42:41,0,0,0,0,0,0
2,201392387,2170660915,0,0,2024-10-04 19:42:41,128,84,212,1,1,2
2,201392387,2170660915,39639,36895,2024-10-04 19:42:42,0,0,0,0,0,0
2,201392387,2170660915,22663,36895,2024-10-04 19:42:42,0,0,0,0,0,0
2,201392387,2170660915,12955,36895,2024-10-04 19:42:42,0,0,0,0,0,0
2,201392387,2170660915,0,0,2024-10-04 19:42:42,0,0,0,0,0,0
2,201392387,2170660915,39639,36895,2024-10-04 19:42:43,0,0,0,0,0,0
2,201392387,2170660915,22663,36895,2024-10-04 19:42:43,0,0,0,0,0,0
2,201392387,2170660915,12955,36895,2024-10-04 19:42:43,0,0,0,0,0,0
2,201392387,2170660915,0,0,2024-10-04 19:42:43,0,0,0,0,0,0
2,201392387,2170660915,39639,36895,2024-10-04 19:42:44,0,0,0,0,0,0
2,201392387,2170660915,22663,36895,2024-10-04 19:42:44,0,0,0,0,0,0
2,201392387,2170660915,12955,36895,2024-10-04 19:42:44,0,0,0,0,0,0
2,201392387,2170660915,0,0,2024-10-04 19:42:44,128,84,212,1,1,2
2,201392387,2170660915,39639,36895,2024-10-04 19:42:45,0,0,0,0,0,0
2,201392387,2170660915,22663,36895,2024-10-04 19:42:45,0,0,0,0,0,0
2,201392387,2170660915,12955,36895,2024-10-04 19:42:45,0,0,0,0,0,0
2,201392387,2170660915,0,0,2024-10-04 19:42:45,128,84,212,1,1,2
2,201392387,2170660915,39639,36895,2024-10-04 19:42:46,0,0,0,0,0,0
2,201392387,2170660915,22663,36895,2024-10-04 19:42:46,0,0,0,0,0,0
2,201392387,1145490691,54481,47873,2024-10-04 19:42:46,2940,34980,37920,21,32,53
2,201392387,2170660915,12955,36895,2024-10-04 19:42:46,0,0,0,0,0,0
2,201392387,2170660915,0,0,2024-10-04 19:42:46,128,84,212,1,1,2
2,201392387,2170660915,39639,36895,2024-10-04 19:42:47,0,0,0,0,0,0
2,201392387,2170660915,22663,36895,2024-10-04 19:42:47,0,0,0,0,0,0
2,201392387,1145490691,54481,47873,2024-10-04 19:42:47,2256,55418,57674,22,36,58
2,201392387,2170660915,12955,36895,2024-10-04 19:42:47,0,0,0,0,0,0
2,201392387,2170660915,0,0,2024-10-04 19:42:47,0,0,0,0,0,0
2,201392387,2170660915,39639,36895,2024-10-04 19:42:48,0,0,0,0,0,0
2,201392387,2170660915,22663,36895,2024-10-04 19:42:48,0,0,0,0,0,0
2,201392387,1145490691,54481,47873,2024-10-04 19:42:48,0,0,0,0,0,0
2,201392387,2170660915,12955,36895,2024-10-04 19:42:48,0,0,0,0,0,0
2,201392387,2170660915,0,0,2024-10-04 19:42:48,0,0,0,0,0,0
2,201392387,2170660915,39639,36895,2024-10-04 19:42:49,0,0,0,0,0,0
2,201392387,2170660915,22663,36895,2024-10-04 19:42:49,0,0,0,0,0,0
2,201392387,1145490691,54481,47873,2024-10-04 19:42:49,0,0,0,0,0,0
2,201392387,2170660915,12955,36895,2024-10-04 19:42:49,0,0,0,0,0,0
2,201392387,2170660915,0,0,2024-10-04 19:42:49,0,0,0,0,0,0
2,201392387,2170660915,39639,36895,2024-10-04 19:42:50,0,0,0,0,0,0
2,201392387,2170660915,22663,36895,2024-10-04 19:42:50,0,0,0,0,0,0
2,201392387,1145490691,54481,47873,2024-10-04 19:42:50,0,0,0,0,0,0
2,201392387,2170660915,12955,36895,2024-10-04 19:42:50,0,0,0,0,0,0
2,201392387,2170660915,0,0,2024-10-04 19:42:50,0,0,0,0,0,0
2,201392387,2170660915,39639,36895,2024-10-04 19:42:51,0,0,0,0,0,0
2,201392387,2170660915,22663,36895,2024-10-04 19:42:51,0,0,0,0,0,0
2,201392387,1145490691,54481,47873,2024-10-04 19:42:51,0,0,0,0,0,0
2,201392387,2170660915,12955,36895,2024-10-04 19:42:51,0,0,0,0,0,0
2,201392387,2170660915,0,0,2024-10-04 19:42:51,0,0,0,0,0,0
2,201392387,2170660915,39639,36895,2024-10-04 19:42:52,0,0,0,0,0,0
2,201392387,2170660915,22663,36895,2024-10-04 19:42:52,0,0,0,0,0,0
2,201392387,1145490691,54481,47873,2024-10-04 19:42:52,0,0,0,0,0,0
2,201392387,2170660915,12955,36895,2024-10-04 19:42:52,0,0,0,0,0,0
2,201392387,2170660915,0,0,2024-10-04 19:42:52,0,0,0,0,0,0
2,201392387,2170660915,39639,36895,2024-10-04 19:42:53,0,0,0,0,0,0
2,201392387,2170660915,22663,36895,2024-10-04 19:42:53,0,0,0,0,0,0
2,201392387,1145490691,54481,47873,2024-10-04 19:42:53,0,0,0,0,0,0
2,201392387,2170660915,12955,36895,2024-10-04 19:42:53,0,0,0,0,0,0
2,201392387,2170660915,0,0,2024-10-04 19:42:53,0,0,0,0,0,0
2,201392387,2170660915,39639,36895,2024-10-04 19:42:54,0,0,0,0,0,0
2,201392387,2170660915,22663,36895,2024-10-04 19:42:54,0,0,0,0,0,0
2,201392387,1145490691,54481,47873,2024-10-04 19:42:54,1224,17040,18264,12,14,26
2,201392387,2170660915,12955,36895,2024-10-04 19:42:54,0,0,0,0,0,0
2,201392387,2170660915,0,0,2024-10-04 19:42:54,0,0,0,0,0,0
2,201392387,2170660915,39639,36895,2024-10-04 19:42:55,0,0,0,0,0,0
2,201392387,2170660915,22663,36895,2024-10-04 19:42:55,0,0,0,0,0,0
2,201392387,1145490691,54481,47873,2024-10-04 19:42:55,0,0,0,0,0,0
2,201392387,2170660915,12955,36895,2024-10-04 19:42:55,0,0,0,0,0,0
2,201392387,2170660915,0,0,2024-10-04 19:42:55,0,0,0,0,0,0
2,201392387,2170660915,39639,36895,2024-10-04 19:42:56,0,0,0,0,0,0
2,201392387,2170660915,22663,36895,2024-10-04 19:42:56,0,0,0,0,0,0
2,201392387,1145490691,54481,47873,2024-10-04 19:42:56,0,0,0,0,0,0
2,201392387,2170660915,12955,36895,2024-10-04 19:42:56,0,0,0,0,0,0
2,201392387,2170660915,0,0,2024-10-04 19:42:56,0,0,0,0,0,0
2,201392387,2170660915,39639,36895,2024-10-04 19:42:57,0,0,0,0,0,0
2,201392387,2170660915,22663,36895,2024-10-04 19:42:57,0,0,0,0,0,0
2,201392387,1145490691,54481,47873,2024-10-04 19:42:57,0,0,0,0,0,0
2,201392387,2170660915,12955,36895,2024-10-04 19:42:57,0,0,0,0,0,0
2,201392387,2170660915,0,0,2024-10-04 19:42:57,128,0,128,1,0,1
2,201392387,2170660915,39639,36895,2024-10-04 19:42:58,0,0,0,0,0,0
2,201392387,2170660915,22663,36895,2024-10-04 19:42:58,0,0,0,0,0,0
2,201392387,1145490691,54481,47873,2024-10-04 19:42:58,0,0,0,0,0,0
2,201392387,2170660915,12955,36895,2024-10-04 19:42:58,0,0,0,0,0,0
2,201392387,2170660915,0,0,2024-10-04 19:42:58,128,84,212,1,1,2
2,201392387,2170660915,39639,36895,2024-10-04 19:42:59,0,0,0,0,0,0
2,201392387,2170660915,22663,36895,2024-10-04 19:42:59,0,0,0,0,0,0
2,201392387,1145490691,54481,47873,2024-10-04 19:42:59,0,0,0,0,0,0
2,201392387,2170660915,12955,36895,2024-10-04 19:42:59,0,0,0,0,0,0
2,201392387,2170660915,0,0,2024-10-04 19:42:59,128,84,212,1,1,2
2,201392387,2170660915,39639,36895,2024-10-04 19:43:00,0,0,0,0,0,0
2,201392387,2170660915,22663,36895,2024-10-04 19:43:00,0,0,0,0,0,0
2,201392387,1145490691,54481,47873,2024-10-04 19:43:00,0,0,0,0,0,0
2,201392387,2170660915,12955,36895,2024-10-04 19:43:00,0,0,0,0,0,0
2,201392387,2170660915,0,0,2024-10-04 19:43:00,128,84,212,1,1,2
2,201392387,2170660915,39639,36895,2024-10-04 19:43:01,0,0,0,0,0,0
2,201392387,2170660915,22663,36895,2024-10-04 19:43:01,0,0,0,0,0,0
2,201392387,1145490691,54481,47873,2024-10-04 19:43:01,0,0,0,0,0,0
2,201392387,2170660915,12955,36895,2024-10-04 19:43:01,0,0,0,0,0,0
2,201392387,2170660915,0,0,2024-10-04 19:43:01,128,84,212,1,1,2
2,201392387,2170660915,39639,36895,2024-10-04 19:43:02,0,0,0,0,0,0
2,201392387,2170660915,22663,36895,2024-10-04 19:43:02,0,0,0,0,0,0
2,201392387,1145490691,54481,47873,2024-10-04 19:43:02,0,0,0,0,0,0
2,201392387,2170660915,12955,36895,2024-10-04 19:43:02,0,0,0,0,0,0
2,201392387,2170660915,0,0,2024-10-04 19:43:02,128,84,212,1,1,2
2,201392387,2170660915,39639,36895,2024-10-04 19:43:03,0,0,0,0,0,0
2,201392387,2170660915,22663,36895,2024-10-04 19:43:03,0,0,0,0,0,0
2,201392387,1145490691,54481,47873,2024-10-04 19:43:03,0,0,0,0,0,0
2,201392387,2170660915,12955,36895,2024-10-04 19:43:03,0,0,0,0,0,0
2,201392387,2170660915,0,0,2024-10-04 19:43:03,128,84,212,1,1,2
2,201392387,2170660915,39639,36895,2024-10-04 19:43:04,0,0,0,0,0,0
2,201392387,2170660915,22663,36895,2024-10-04 19:43:04,0,0,0,0,0,0
2,201392387,1145490691,54481,47873,2024-10-04 19:43:04,0,0,0,0,0,0
2,201392387,2170660915,12955,36895,2024-10-04 19:43:04,0,0,0,0,0,0
2,201392387,2170660915,0,0,2024-10-04 19:43:04,0,84,84,0,1,1
2,201392387,2170660915,39639,36895,2024-10-04 19:43:05,0,0,0,0,0,0
2,201392387,2170660915,22663,36895,2024-10-04 19:43:05,0,0,0,0,0,0
2,201392387,2170660915,12955,36895,2024-10-04 19:43:05,0,0,0,0,0,0
2,201392387,2170660915,0,0,2024-10-04 19:43:05,128,84,212,1,1,2
2,201392387,2170660915,39639,36895,2024-10-04 19:43:06,0,0,0,0,0,0
2,201392387,2170660915,22663,36895,2024-10-04 19:43:06,0,0,0,0,0,0
2,201392387,2170660915,12955,36895,2024-10-04 19:43:06,0,0,0,0,0,0
2,201392387,2170660915,0,0,2024-10-04 19:43:06,128,84,212,1,1,2
2,201392387,2170660915,39639,36895,2024-10-04 19:43:07,0,0,0,0,0,0
2,201392387,2170660915,22663,36895,2024-10-04 19:43:07,0,0,0,0,0,0
2,201392387,2170660915,12955,36895,2024-10-04 19:43:07,0,0,0,0,0,0
2,201392387,2170660915,0,0,2024-10-04 19:43:07,128,84,212,1,1,2
2,201392387,2170660915,39639,36895,2024-10-04 19:43:08,0,0,0,0,0,0
2,201392387,2170660915,22663,36895,2024-10-04 19:43:08,0,0,0,0,0,0
2,201392387,2170660915,12955,36895,2024-10-04 19:43:08,0,0,0,0,0,0
2,201392387,2170660915,0,0,2024-10-04 19:43:08,0,0,0,0,0,0
2,201392387,2170660915,39639,36895,2024-10-04 19:43:09,0,0,0,0,0,0
2,201392387,2170660915,22663,36895,2024-10-04 19:43:09,0,0,0,0,0,0
2,201392387,2170660915,53981,36895,2024-10-04 19:43:09,666,507,1173,6,6,12
2,201392387,2170660915,0,0,2024-10-04 19:43:09,0,0,0,0,0,0
2,201392387,2170660915,39639,36895,2024-10-04 19:43:10,0,0,0,0,0,0
2,201392387,2170660915,22663,36895,2024-10-04 19:43:10,0,0,0,0,0,0
2,201392387,2170660915,53981,36895,2024-10-04 19:43:10,0,0,0,0,0,0
2,201392387,2170660915,0,0,2024-10-04 19:43:10,128,84,212,1,1,2
2,201392387,2170660915,39639,36895,2024-10-04 19:43:11,0,0,0,0,0,0
2,201392387,2170660915,22663,36895,2024-10-04 19:43:11,0,0,0,0,0,0
2,201392387,2170660915,53981,36895,2024-10-04 19:43:11,0,0,0,0,0,0
2,201392387,2170660915,0,0,2024-10-04 19:43:11,128,84,212,1,1,2
2,201392387,2170660915,39639,36895,2024-10-04 19:43:12,0,0,0,0,0,0
2,201392387,2170660915,22663,36895,2024-10-04 19:43:12,0,0,0,0,0,0
2,201392387,2170660915,53981,36895,2024-10-04 19:43:12,0,0,0,0,0,0
2,201392387,2170660915,0,0,2024-10-04 19:43:12,128,84,212,1,1,2
2,201392387,2170660915,39639,36895,2024-10-04 19:43:13,0,0,0,0,0,0
2,201392387,2170660915,22663,36895,2024-10-04 19:43:13,0,0,0,0,0,0
2,201392387,2170660915,53981,36895,2024-10-04 19:43:13,0,0,0,0,0,0
2,201392387,2170660915,0,0,2024-10-04 19:43:13,0,0,0,0,0,0
2,201392387,2170660915,39639,36895,2024-10-04 19:43:14,0,0,0,0,0,0
2,201392387,2170660915,22663,36895,2024-10-04 19:43:14,0,0,0,0,0,0
2,201392387,2170660915,53981,36895,2024-10-04 19:43:14,0,0,0,0,0,0
2,201392387,2170660915,0,0,2024-10-04 19:43:14,0,0,0,0,0,0
2,201392387,2170660915,39639,36895,2024-10-04 19:43:15,0,0,0,0,0,0
2,201392387,2170660915,22663,36895,2024-10-04 19:43:15,0,0,0,0,0,0
2,201392387,2170660915,53981,36895,2024-10-04 19:43:15,0,0,0,0,0,0
2,201392387,2170660915,0,0,2024-10-04 19:43:15,128,84,212,1,1,2
2,201392387,2170660915,39639,36895,2024-10-04 19:43:16,0,0,0,0,0,0
2,201392387,2170660915,22663,36895,2024-10-04 19:43:16,0,0,0,0,0,0
2,201392387,2170660915,53981,36895,2024-10-04 19:43:16,0,0,0,0,0,0
2,201392387,2170660915,0,0,2024-10-04 19:43:16,0,0,0,0,0,0
2,201392387,2170660915,39639,36895,2024-10-04 19:43:17,0,0,0,0,0,0
2,201392387,2170660915,22663,36895,2024-10-04 19:43:17,0,0,0,0,0,0
2,201392387,2170660915,53981,36895,2024-10-04 19:43:17,0,0,0,0,0,0
2,201392387,2170660915,0,0,2024-10-04 19:43:17,256,168,424,2,2,4
2,201392387,1145490692,61621,47873,2024-10-04 19:43:17,4464,63751,68215,36,51,87
2,201392387,2170660915,39639,36895,2024-10-04 19:43:18,0,0,0,0,0,0
2,201392387,2170660915,22663,36895,2024-10-04 19:43:18,0,0,0,0,0,0
2,201392387,2170660915,53981,36895,2024-10-04 19:43:18,0,0,0,0,0,0
2,201392387,2170660915,0,0,2024-10-04 19:43:18,0,0,0,0,0,0
2,201392387,1145490692,61621,47873,2024-10-04 19:43:18,1860,29345,31205,18,22,40
2,201392387,2170660915,39639,36895,2024-10-04 19:43:19,0,0,0,0,0,0
2,201392387,2170660915,22663,36895,2024-10-04 19:43:19,0,0,0,0,0,0
2,201392387,2170660915,53981,36895,2024-10-04 19:43:19,0,0,0,0,0,0
2,201392387,2170660915,0,0,2024-10-04 19:43:19,0,0,0,0,0,0
2,201392387,1145490692,61621,47873,2024-10-04 19:43:19,0,0,0,0,0,0
2,201392387,2170660915,39639,36895,2024-10-04 19:43:20,0,0,0,0,0,0
2,201392387,2170660915,22663,36895,2024-10-04 19:43:20,0,0,0,0,0,0
2,201392387,2170660915,53981,36895,2024-10-04 19:43:20,0,0,0,0,0,0
2,201392387,2170660915,0,0,2024-10-04 19:43:20,0,0,0,0,0,0
2,201392387,1145490692,61621,47873,2024-10-04 19:43:20,0,0,0,0,0,0
2,201392387,2170660915,39639,36895,2024-10-04 19:43:21,0,0,0,0,0,0
2,201392387,2170660915,22663,36895,2024-10-04 19:43:21,0,0,0,0,0,0
2,201392387,2170660915,53981,36895,2024-10-04 19:43:21,0,0,0,0,0,0
2,201392387,2170660915,0,0,2024-10-04 19:43:21,0,0,0,0,0,0
2,201392387,1145490692,61621,47873,2024-10-04 19:43:21,0,0,0,0,0,0
2,201392387,2170660915,39639,36895,2024-10-04 19:43:22,0,0,0,0,0,0
2,201392387,2170660915,22663,36895,2024-10-04 19:43:22,0,0,0,0,0,0
2,201392387,2170660915,53981,36895,2024-10-04 19:43:22,0,0,0,0,0,0
2,201392387,2170660915,0,0,2024-10-04 19:43:22,0,0,0,0,0,0
2,201392387,1145490692,61621,47873,2024-10-04 19:43:22,0,0,0,0,0,0
2,201392387,2170660915,39639,36895,2024-10-04 19:43:23,0,0,0,0,0,0
2,201392387,2170660915,22663,36895,2024-10-04 19:43:23,0,0,0,0,0,0
2,201392387,2170660915,53981,36895,2024-10-04 19:43:23,0,0,0,0,0,0
2,201392387,2170660915,0,0,2024-10-04 19:43:23,0,0,0,0,0,0
2,201392387,1145490692,61621,47873,2024-10-04 19:43:23,0,0,0,0,0,0
2,201392387,2170660915,39639,36895,2024-10-04 19:43:24,0,0,0,0,0,0
2,201392387,2170660915,22663,36895,2024-10-04 19:43:24,0,0,0,0,0,0
2,201392387,2170660915,53981,36895,2024-10-04 19:43:24,0,0,0,0,0,0
2,201392387,2170660915,0,0,2024-10-04 19:43:24,0,0,0,0,0,0
2,201392387,1145490692,61621,47873,2024-10-04 19:43:24,0,0,0,0,0,0
2,201392387,2170660915,39639,36895,2024-10-04 19:43:25,0,0,0,0,0,0
2,201392387,2170660915,22663,36895,2024-10-04 19:43:25,0,0,0,0,0,0
2,201392387,2170660915,53981,36895,2024-10-04 19:43:25,0,0,0,0,0,0
2,201392387,2170660915,0,0,2024-10-04 19:43:25,0,0,0,0,0,0
2,201392387,1145490692,61621,47873,2024-10-04 19:43:25,0,0,0,0,0,0
2,201392387,2170660915,39639,36895,2024-10-04 19:43:26,0,0,0,0,0,0
2,201392387,2170660915,22663,36895,2024-10-04 19:43:26,0,0,0,0,0,0
2,201392387,2170660915,53981,36895,2024-10-04 19:43:26,0,0,0,0,0,0
2,201392387,2170660915,0,0,2024-10-04 19:43:26,0,0,0,0,0,0
2,201392387,1145490692,61621,47873,2024-10-04 19:43:26,0,0,0,0,0,0
2,201392387,2170660915,39639,36895,2024-10-04 19:43:27,0,0,0,0,0,0
2,201392387,2170660915,22663,36895,2024-10-04 19:43:27,0,0,0,0,0,0
2,201392387,2170660915,53981,36895,2024-10-04 19:43:27,0,0,0,0,0,0
2,201392387,2170660915,0,0,2024-10-04 19:43:27,0,0,0,0,0,0
2,201392387,1145490692,61621,47873,2024-10-04 19:43:27,0,0,0,0,0,0
2,201392387,2170660915,39639,36895,2024-10-04 19:43:28,0,0,0,0,0,0
2,201392387,2170660915,22663,36895,2024-10-04 19:43:28,0,0,0,0,0,0
2,201392387,2170660915,53981,36895,2024-10-04 19:43:28,0,0,0,0,0,0
2,201392387,2170660915,0,0,2024-10-04 19:43:28,128,84,212,1,1,2
2,201392387,1145490692,61621,47873,2024-10-04 19:43:28,0,0,0,0,0,0
2,201392387,2170660915,39639,36895,2024-10-04 19:43:29,0,0,0,0,0,0
2,201392387,2170660915,22663,36895,2024-10-04 19:43:29,0,0,0,0,0,0
2,201392387,2170660915,53981,36895,2024-10-04 19:43:29,0,0,0,0,0,0
2,201392387,2170660915,0,0,2024-10-04 19:43:29,128,84,212,1,1,2
2,201392387,1145490692,61621,47873,2024-10-04 19:43:29,0,0,0,0,0,0
2,201392387,2170660915,39639,36895,2024-10-04 19:43:30,0,0,0,0,0,0
2,201392387,2170660915,22663,36895,2024-10-04 19:43:30,0,0,0,0,0,0
2,201392387,2170660915,53981,36895,2024-10-04 19:43:30,0,0,0,0,0,0
2,201392387,2170660915,0,0,2024-10-04 19:43:30,128,84,212,1,1,2
2,201392387,1145490692,61621,47873,2024-10-04 19:43:30,0,0,0,0,0,0
2,201392387,2170660915,39639,36895,2024-10-04 19:43:31,0,0,0,0,0,0
2,201392387,2170660915,22663,36895,2024-10-04 19:43:31,0,0,0,0,0,0
2,201392387,2170660915,53981,36895,2024-10-04 19:43:31,0,0,0,0,0,0
2,201392387,2170660915,0,0,2024-10-04 19:43:31,128,84,212,1,1,2
2,201392387,1145490692,61621,47873,2024-10-04 19:43:31,0,0,0,0,0,0
2,201392387,2170660915,39639,36895,2024-10-04 19:43:32,0,0,0,0,0,0
2,201392387,2170660915,22663,36895,2024-10-04 19:43:32,0,0,0,0,0,0
2,201392387,2170660915,53981,36895,2024-10-04 19:43:32,0,0,0,0,0,0
2,201392387,2170660915,0,0,2024-10-04 19:43:32,128,84,212,1,1,2
2,201392387,1145490692,61621,47873,2024-10-04 19:43:32,0,0,0,0,0,0
2,201392387,2170660915,39639,36895,2024-10-04 19:43:33,0,0,0,0,0,0
2,201392387,2170660915,22663,36895,2024-10-04 19:43:33,0,0,0,0,0,0
2,201392387,2170660915,53981,36895,2024-10-04 19:43:33,0,0,0,0,0,0
2,201392387,2170660915,0,0,2024-10-04 19:43:33,128,84,212,1,1,2
2,201392387,1145490692,61621,47873,2024-10-04 19:43:33,0,0,0,0,0,0
2,201392387,2170660915,39639,36895,2024-10-04 19:43:34,0,0,0,0,0,0
2,201392387,2170660915,22663,36895,2024-10-04 19:43:34,0,0,0,0,0,0
2,201392387,2170660915,53981,36895,2024-10-04 19:43:34,0,0,0,0,0,0
2,201392387,2170660915,0,0,2024-10-04 19:43:34,128,84,212,1,1,2
2,201392387,1145490692,61621,47873,2024-10-04 19:43:34,0,0,0,0,0,0
2,201392387,2170660915,39639,36895,2024-10-04 19:43:35,0,0,0,0,0,0
2,201392387,2170660915,22663,36895,2024-10-04 19:43:35,0,0,0,0,0,0
2,201392387,2170660915,53981,36895,2024-10-04 19:43:35,0,0,0,0,0,0
2,201392387,2170660915,0,0,2024-10-04 19:43:35,128,84,212,1,1,2
2,201392387,1145490692,61621,47873,2024-10-04 19:43:35,0,0,0,0,0,0
2,201392387,2170660915,39639,36895,2024-10-04 19:43:36,0,0,0,0,0,0
2,201392387,2170660915,22663,36895,2024-10-04 19:43:36,0,0,0,0,0,0
2,201392387,2170660915,53981,36895,2024-10-04 19:43:36,0,0,0,0,0,0
2,201392387,2170660915,0,0,2024-10-04 19:43:36,128,84,212,1,1,2
2,201392387,1145490692,61621,47873,2024-10-04 19:43:36,0,0,0,0,0,0
2,201392387,2170660915,39639,36895,2024-10-04 19:43:37,0,0,0,0,0,0
2,201392387,2170660915,22663,36895,2024-10-04 19:43:37,0,0,0,0,0,0
2,201392387,2170660915,53981,36895,2024-10-04 19:43:37,0,0,0,0,0,0
2,201392387,2170660915,0,0,2024-10-04 19:43:37,128,84,212,1,1,2
2,201392387,2170660915,39639,36895,2024-10-04 19:43:38,0,0,0,0,0,0
2,201392387,2170660915,22663,36895,2024-10-04 19:43:38,0,0,0,0,0,0
2,201392387,2170660915,30902,36895,2024-10-04 19:43:38,666,507,1173,6,6,12
2,201392387,2170660915,0,0,2024-10-04 19:43:38,0,0,0,0,0,0
2,201392387,2170660915,39639,36895,2024-10-04 19:43:39,0,0,0,0,0,0
2,201392387,2170660915,22663,36895,2024-10-04 19:43:39,0,0,0,0,0,0
2,201392387,2170660915,30902,36895,2024-10-04 19:43:39,0,0,0,0,0,0
2,201392387,2170660915,0,0,2024-10-04 19:43:39,128,84,212,1,1,2
2,201392387,2170660915,39639,36895,2024-10-04 19:43:40,0,0,0,0,0,0
2,201392387,2170660915,22663,36895,2024-10-04 19:43:40,0,0,0,0,0,0
2,201392387,2170660915,30902,36895,2024-10-04 19:43:40,0,0,0,0,0,0
2,201392387,2170660915,0,0,2024-10-04 19:43:40,0,0,0,0,0,0
2,201392387,2170660915,39639,36895,2024-10-04 19:43:41,0,0,0,0,0,0
2,201392387,2170660915,22663,36895,2024-10-04 19:43:41,0,0,0,0,0,0
2,201392387,2170660915,30902,36895,2024-10-04 19:43:41,0,0,0,0,0,0
2,201392387,2170660915,0,0,2024-10-04 19:43:41,256,84,340,2,1,3
2,201392387,2170660915,39639,36895,2024-10-04 19:43:42,0,0,0,0,0,0
2,201392387,2170660915,22663,36895,2024-10-04 19:43:42,0,0,0,0,0,0
2,201392387,2170660915,30902,36895,2024-10-04 19:43:42,0,0,0,0,0,0
2,201392387,2170660915,0,0,2024-10-04 19:43:42,0,84,84,0,1,1
2,201392387,2170660915,39639,36895,2024-10-04 19:43:43,0,0,0,0,0,0
2,201392387,2170660915,22663,36895,2024-10-04 19:43:43,0,0,0,0,0,0
2,201392387,2170660915,30902,36895,2024-10-04 19:43:43,0,0,0,0,0,0
2,201392387,2170660915,0,0,2024-10-04 19:43:43,0,0,0,0,0,0
2,201392387,2170660915,39639,36895,2024-10-04 19:43:44,0,0,0,0,0,0
2,201392387,2170660915,22663,36895,2024-10-04 19:43:44,0,0,0,0,0,0
2,201392387,2170660915,30902,36895,2024-10-04 19:43:44,0,0,0,0,0,0
2,201392387,2170660915,0,0,2024-10-04 19:43:44,0,0,0,0,0,0
2,201392387,2170660915,39639,36895,2024-10-04 19:43:45,0,0,0,0,0,0
2,201392387,2170660915,22663,36895,2024-10-04 19:43:45,0,0,0,0,0,0
2,201392387,2170660915,30902,36895,2024-10-04 19:43:45,0,0,0,0,0,0
2,201392387,2170660915,0,0,2024-10-04 19:43:45,128,84,212,1,1,2
2,201392387,2170660915,39639,36895,2024-10-04 19:43:46,0,0,0,0,0,0
2,201392387,2170660915,22663,36895,2024-10-04 19:43:46,0,0,0,0,0,0
2,201392387,2170660915,30902,36895,2024-10-04 19:43:46,0,0,0,0,0,0
2,201392387,2170660915,0,0,2024-10-04 19:43:46,0,0,0,0,0,0
2,201392387,2170660915,39639,36895,2024-10-04 19:43:47,0,0,0,0,0,0
2,201392387,2170660915,22663,36895,2024-10-04 19:43:47,0,0,0,0,0,0
2,201392387,2170660915,30902,36895,2024-10-04 19:43:47,0,0,0,0,0,0
2,201392387,1145490689,18578,47873,2024-10-04 19:43:47,2892,33317,36209,21,30,51
2,201392387,2170660915,0,0,2024-10-04 19:43:47,256,168,424,2,2,4
2,201392387,2170660915,39639,36895,2024-10-04 19:43:48,0,0,0,0,0,0
2,201392387,2170660915,22663,36895,2024-10-04 19:43:48,0,0,0,0,0,0
2,201392387,2170660915,30902,36895,2024-10-04 19:43:48,0,0,0,0,0,0
2,201392387,1145490689,18578,47873,2024-10-04 19:43:48,2004,40604,42608,20,26,46
2,201392387,2170660915,0,0,2024-10-04 19:43:48,0,0,0,0,0,0
2,201392387,2170660915,39639,36895,2024-10-04 19:43:49,0,0,0,0,0,0
2,201392387,2170660915,22663,36895,2024-10-04 19:43:49,0,0,0,0,0,0
2,201392387,2170660915,30902,36895,2024-10-04 19:43:49,0,0,0,0,0,0
2,201392387,1145490689,18578,47873,2024-10-04 19:43:49,0,0,0,0,0,0
2,201392387,2170660915,0,0,2024-10-04 19:43:49,0,0,0,0,0,0
2,201392387,2170660915,39639,36895,2024-10-04 19:43:50,0,0,0,0,0,0
2,201392387,2170660915,22663,36895,2024-10-04 19:43:50,0,0,0,0,0,0
2,201392387,2170660915,30902,36895,2024-10-04 19:43:50,0,0,0,0,0,0
2,201392387,1145490689,18578,47873,2024-10-04 19:43:50,0,0,0,0,0,0
2,201392387,2170660915,0,0,2024-10-04 19:43:50,0,0,0,0,0,0
2,201392387,2170660915,39639,36895,2024-10-04 19:43:51,0,0,0,0,0,0
2,201392387,2170660915,22663,36895,2024-10-04 19:43:51,0,0,0,0,0,0
2,201392387,2170660915,30902,36895,2024-10-04 19:43:51,0,0,0,0,0,0
2,201392387,1145490689,18578,47873,2024-10-04 19:43:51,0,0,0,0,0,0
2,201392387,2170660915,0,0,2024-10-04 19:43:51,0,0,0,0,0,0
2,201392387,2170660915,39639,36895,2024-10-04 19:43:52,0,0,0,0,0,0
2,201392387,2170660915,22663,36895,2024-10-04 19:43:52,0,0,0,0,0,0
2,201392387,2170660915,30902,36895,2024-10-04 19:43:52,0,0,0,0,0,0
2,201392387,1145490689,18578,47873,2024-10-04 19:43:52,0,0,0,0,0,0
2,201392387,2170660915,0,0,2024-10-04 19:43:52,0,0,0,0,0,0
2,201392387,2170660915,39639,36895,2024-10-04 19:43:53,0,0,0,0,0,0
2,201392387,2170660915,22663,36895,2024-10-04 19:43:53,0,0,0,0,0,0
2,201392387,2170660915,30902,36895,2024-10-04 19:43:53,0,0,0,0,0,0
2,201392387,1145490689,18578,47873,2024-10-04 19:43:53,0,0,0,0,0,0
2,201392387,2170660915,0,0,2024-10-04 19:43:53,0,0,0,0,0,0
2,201392387,2170660915,39639,36895,2024-10-04 19:43:54,0,0,0,0,0,0
2,201392387,2170660915,22663,36895,2024-10-04 19:43:54,0,0,0,0,0,0
2,201392387,2170660915,30902,36895,2024-10-04 19:43:54,0,0,0,0,0,0
2,201392387,1145490689,18578,47873,2024-10-04 19:43:54,0,0,0,0,0,0
2,201392387,2170660915,0,0,2024-10-04 19:43:54,0,0,0,0,0,0
2,201392387,2170660915,39639,36895,2024-10-04 19:43:55,0,0,0,0,0,0
2,201392387,2170660915,22663,36895,2024-10-04 19:43:55,0,0,0,0,0,0
2,201392387,2170660915,30902,36895,2024-10-04 19:43:55,0,0,0,0,0,0
2,201392387,1145490689,18578,47873,2024-10-04 19:43:55,0,0,0,0,0,0
2,201392387,2170660915,0,0,2024-10-04 19:43:55,0,0,0,0,0,0
2,201392387,2170660915,39639,36895,2024-10-04 19:43:56,0,0,0,0,0,0
2,201392387,2170660915,22663,36895,2024-10-04 19:43:56,0,0,0,0,0,0
2,201392387,2170660915,30902,36895,2024-10-04 19:43:56,0,0,0,0,0,0
2,201392387,1145490689,18578,47873,2024-10-04 19:43:56,1728,29397,31125,17,23,40
2,201392387,2170660915,0,0,2024-10-04 19:43:56,0,0,0,0,0,0
2,201392387,2170660915,39639,36895,2024-10-04 19:43:57,0,0,0,0,0,0
2,201392387,2170660915,22663,36895,2024-10-04 19:43:57,0,0,0,0,0,0
2,201392387,2170660915,30902,36895,2024-10-04 19:43:57,0,0,0,0,0,0
2,201392387,1145490689,18578,47873,2024-10-04 19:43:57,0,0,0,0,0,0
2,201392387,2170660915,0,0,2024-10-04 19:43:57,0,0,0,0,0,0
2,201392387,2170660915,39639,36895,2024-10-04 19:43:58,0,0,0,0,0,0
2,201392387,2170660915,22663,36895,2024-10-04 19:43:58,0,0,0,0,0,0
2,201392387,2170660915,30902,36895,2024-10-04 19:43:58,0,0,0,0,0,0
2,201392387,1145490689,18578,47873,2024-10-04 19:43:58,0,0,0,0,0,0
2,201392387,2170660915,0,0,2024-10-04 19:43:58,0,0,0,0,0,0
2,201392387,2170660915,39639,36895,2024-10-04 19:43:59,0,0,0,0,0,0
2,201392387,2170660915,22663,36895,2024-10-04 19:43:59,0,0,0,0,0,0
2,201392387,2170660915,30902,36895,2024-10-04 19:43:59,0,0,0,0,0,0
2,201392387,1145490689,18578,47873,2024-10-04 19:43:59,0,0,0,0,0,0
2,201392387,2170660915,0,0,2024-10-04 19:43:59,128,84,212,1,1,2
2,201392387,2170660915,39639,36895,2024-10-04 19:44:00,0,0,0,0,0,0
2,201392387,2170660915,22663,36895,2024-10-04 19:44:00,0,0,0,0,0,0
2,201392387,2170660915,30902,36895,2024-10-04 19:44:00,0,0,0,0,0,0
2,201392387,1145490689,18578,47873,2024-10-04 19:44:00,0,0,0,0,0,0
2,201392387,2170660915,0,0,2024-10-04 19:44:00,128,84,212,1,1,2
2,201392387,2170660915,39639,36895,2024-10-04 19:44:01,0,0,0,0,0,0
2,201392387,2170660915,22663,36895,2024-10-04 19:44:01,0,0,0,0,0,0
2,201392387,2170660915,30902,36895,2024-10-04 19:44:01,0,0,0,0,0,0
2,201392387,1145490689,18578,47873,2024-10-04 19:44:01,0,0,0,0,0,0
2,201392387,2170660915,0,0,2024-10-04 19:44:01,128,84,212,1,1,2
2,201392387,2170660915,39639,36895,2024-10-04 19:44:02,0,0,0,0,0,0
2,201392387,2170660915,22663,36895,2024-10-04 19:44:02,0,0,0,0,0,0
2,201392387,2170660915,30902,36895,2024-10-04 19:44:02,0,0,0,0,0,0
2,201392387,1145490689,18578,47873,2024-10-04 19:44:02,0,0,0,0,0,0
2,201392387,2170660915,0,0,2024-10-04 19:44:02,128,84,212,1,1,2
2,201392387,2170660915,39639,36895,2024-10-04 19:44:03,0,0,0,0,0,0
2,201392387,2170660915,22663,36895,2024-10-04 19:44:03,0,0,0,0,0,0
2,201392387,2170660915,30902,36895,2024-10-04 19:44:03,0,0,0,0,0,0
2,201392387,1145490689,18578,47873,2024-10-04 19:44:03,0,0,0,0,0,0
2,201392387,2170660915,0,0,2024-10-04 19:44:03,128,84,212,1,1,2
2,201392387,2170660915,39639,36895,2024-10-04 19:44:04,0,0,0,0,0,0
2,201392387,2170660915,22663,36895,2024-10-04 19:44:04,0,0,0,0,0,0
2,201392387,2170660915,30902,36895,2024-10-04 19:44:04,0,0,0,0,0,0
2,201392387,1145490689,18578,47873,2024-10-04 19:44:04,0,0,0,0,0,0
2,201392387,2170660915,0,0,2024-10-04 19:44:04,128,84,212,1,1,2
2,201392387,2170660915,39639,36895,2024-10-04 19:44:05,0,0,0,0,0,0
2,201392387,2170660915,22663,36895,2024-10-04 19:44:05,0,0,0,0,0,0
2,201392387,2170660915,30902,36895,2024-10-04 19:44:05,0,0,0,0,0,0
2,201392387,1145490689,18578,47873,2024-10-04 19:44:05,0,0,0,0,0,0
2,201392387,2170660915,0,0,2024-10-04 19:44:05,128,84,212,1,1,2
2,201392387,2170660915,39639,36895,2024-10-04 19:44:06,0,0,0,0,0,0
2,201392387,2170660915,22663,36895,2024-10-04 19:44:06,0,0,0,0,0,0
2,201392387,2170660915,30902,36895,2024-10-04 19:44:06,0,0,0,0,0,0
2,201392387,2170660915,0,0,2024-10-04 19:44:06,128,84,212,1,1,2
2,201392387,2170660915,39639,36895,2024-10-04 19:44:07,0,0,0,0,0,0
2,201392387,2170660915,22663,36895,2024-10-04 19:44:07,0,0,0,0,0,0
2,201392387,2170660915,30902,36895,2024-10-04 19:44:07,0,0,0,0,0,0
2,201392387,2170660915,0,0,2024-10-04 19:44:07,128,84,212,1,1,2
2,201392387,2170660915,39639,36895,2024-10-04 19:44:08,0,0,0,0,0,0
2,201392387,2170660915,22663,36895,2024-10-04 19:44:08,0,0,0,0,0,0
2,201392387,2170660915,30902,36895,2024-10-04 19:44:08,0,0,0,0,0,0
2,201392387,2170660915,0,0,2024-10-04 19:44:08,128,84,212,1,1,2
2,201392387,2170660915,39639,36895,2024-10-04 19:44:09,0,0,0,0,0,0
2,201392387,2170660915,22663,36895,2024-10-04 19:44:09,0,0,0,0,0,0
2,201392387,2170660915,30902,36895,2024-10-04 19:44:09,0,0,0,0,0,0
2,201392387,2170660915,0,0,2024-10-04 19:44:09,0,0,0,0,0,0
2,201392387,2170660915,39639,36895,2024-10-04 19:44:10,0,0,0,0,0,0
2,201392387,2170660915,22663,36895,2024-10-04 19:44:10,0,0,0,0,0,0
2,201392387,2170660915,30902,36895,2024-10-04 19:44:10,0,0,0,0,0,0
2,201392387,2170660915,0,0,2024-10-04 19:44:10,0,0,0,0,0,0
2,201392387,2170660915,39639,36895,2024-10-04 19:44:11,0,0,0,0,0,0
2,201392387,2170660915,22663,36895,2024-10-04 19:44:11,0,0,0,0,0,0
2,201392387,2170660915,30878,36895,2024-10-04 19:44:11,666,507,1173,6,6,12
2,201392387,2170660915,0,0,2024-10-04 19:44:11,0,0,0,0,0,0
2,201392387,2170660915,39639,36895,2024-10-04 19:44:12,0,0,0,0,0,0
2,201392387,2170660915,22663,36895,2024-10-04 19:44:12,0,0,0,0,0,0
2,201392387,2170660915,30878,36895,2024-10-04 19:44:12,0,0,0,0,0,0
2,201392387,2170660915,0,0,2024-10-04 19:44:12,128,84,212,1,1,2
2,201392387,2170660915,39639,36895,2024-10-04 19:44:13,0,0,0,0,0,0
2,201392387,2170660915,22663,36895,2024-10-04 19:44:13,0,0,0,0,0,0
2,201392387,2170660915,30878,36895,2024-10-04 19:44:13,0,0,0,0,0,0
2,201392387,2170660915,0,0,2024-10-04 19:44:13,128,84,212,1,1,2
2,201392387,2170660915,39639,36895,2024-10-04 19:44:14,0,0,0,0,0,0
2,201392387,2170660915,22663,36895,2024-10-04 19:44:14,0,0,0,0,0,0
2,201392387,2170660915,30878,36895,2024-10-04 19:44:14,0,0,0,0,0,0
2,201392387,2170660915,0,0,2024-10-04 19:44:14,128,84,212,1,1,2
2,201392387,2170660915,39639,36895,2024-10-04 19:44:15,0,0,0,0,0,0
2,201392387,2170660915,22663,36895,2024-10-04 19:44:15,0,0,0,0,0,0
2,201392387,2170660915,30878,36895,2024-10-04 19:44:15,0,0,0,0,0,0
2,201392387,2170660915,0,0,2024-10-04 19:44:15,0,0,0,0,0,0
2,201392387,2170660915,39639,36895,2024-10-04 19:44:16,0,0,0,0,0,0
2,201392387,2170660915,22663,36895,2024-10-04 19:44:16,0,0,0,0,0,0
2,201392387,2170660915,30878,36895,2024-10-04 19:44:16,0,0,0,0,0,0
2,201392387,2170660915,0,0,2024-10-04 19:44:16,0,0,0,0,0,0
2,201392387,2170660915,39639,36895,2024-10-04 19:44:17,0,0,0,0,0,0
2,201392387,2170660915,22663,36895,2024-10-04 19:44:17,0,0,0,0,0,0
2,201392387,2170660915,30878,36895,2024-10-04 19:44:17,0,0,0,0,0,0
2,201392387,2170660915,0,0,2024-10-04 19:44:17,128,84,212,1,1,2
2,201392387,2170660915,39639,36895,2024-10-04 19:44:18,0,0,0,0,0,0
2,201392387,2170660915,22663,36895,2024-10-04 19:44:18,0,0,0,0,0,0
2,201392387,2170660915,30878,36895,2024-10-04 19:44:18,0,0,0,0,0,0
2,201392387,2170660915,0,0,2024-10-04 19:44:18,128,84,212,1,1,2
2,201392387,2170660915,39639,36895,2024-10-04 19:44:19,0,0,0,0,0,0
2,201392387,2170660915,22663,36895,2024-10-04 19:44:19,0,0,0,0,0,0
2,201392387,1145490691,63693,47873,2024-10-04 19:44:19,2712,26652,29364,19,27,46
2,201392387,2170660915,0,0,2024-10-04 19:44:19,128,84,212,1,1,2
2,201392387,2170660915,39639,36895,2024-10-04 19:44:20,0,0,0,0,0,0
2,201392387,2170660915,22663,36895,2024-10-04 19:44:20,0,0,0,0,0,0
2,201392387,1145490691,63693,47873,2024-10-04 19:44:20,4032,70668,74700,40,51,91
2,201392387,2170660915,0,0,2024-10-04 19:44:20,0,0,0,0,0,0
2,201392387,2170660915,39639,36895,2024-10-04 19:44:21,0,0,0,0,0,0
2,201392387,2170660915,22663,36895,2024-10-04 19:44:21,0,0,0,0,0,0
2,201392387,1145490691,63693,47873,2024-10-04 19:44:21,0,0,0,0,0,0
2,201392387,2170660915,0,0,2024-10-04 19:44:21,0,0,0,0,0,0
2,201392387,2170660915,39639,36895,2024-10-04 19:44:22,0,0,0,0,0,0
2,201392387,2170660915,22663,36895,2024-10-04 19:44:22,0,0,0,0,0,0
2,201392387,1145490691,63693,47873,2024-10-04 19:44:22,0,0,0,0,0,0
2,201392387,2170660915,0,0,2024-10-04 19:44:22,0,0,0,0,0,0
2,201392387,2170660915,39639,36895,2024-10-04 19:44:23,0,0,0,0,0,0
2,201392387,2170660915,22663,36895,2024-10-04 19:44:23,0,0,0,0,0,0
2,201392387,1145490691,63693,47873,2024-10-04 19:44:23,0,0,0,0,0,0
2,201392387,2170660915,0,0,2024-10-04 19:44:23,0,0,0,0,0,0
2,201392387,2170660915,39639,36895,2024-10-04 19:44:24,0,0,0,0,0,0
2,201392387,2170660915,22663,36895,2024-10-04 19:44:24,0,0,0,0,0,0
2,201392387,1145490691,63693,47873,2024-10-04 19:44:24,0,0,0,0,0,0
2,201392387,2170660915,0,0,2024-10-04 19:44:24,0,0,0,0,0,0
2,201392387,2170660915,39639,36895,2024-10-04 19:44:25,0,0,0,0,0,0
2,201392387,2170660915,22663,36895,2024-10-04 19:44:25,0,0,0,0,0,0
2,201392387,1145490691,63693,47873,2024-10-04 19:44:25,0,0,0,0,0,0
2,201392387,2170660915,0,0,2024-10-04 19:44:25,0,0,0,0,0,0
2,201392387,2170660915,39639,36895,2024-10-04 19:44:26,0,0,0,0,0,0
2,201392387,2170660915,22663,36895,2024-10-04 19:44:26,0,0,0,0,0,0
2,201392387,1145490691,63693,47873,2024-10-04 19:44:26,0,0,0,0,0,0
2,201392387,2170660915,0,0,2024-10-04 19:44:26,0,0,0,0,0,0
2,201392387,2170660915,39639,36895,2024-10-04 19:44:27,0,0,0,0,0,0
2,201392387,2170660915,22663,36895,2024-10-04 19:44:27,0,0,0,0,0,0
2,201392387,1145490691,63693,47873,2024-10-04 19:44:27,0,0,0,0,0,0
2,201392387,2170660915,0,0,2024-10-04 19:44:27,0,0,0,0,0,0
2,201392387,2170660915,39639,36895,2024-10-04 19:44:28,0,0,0,0,0,0
2,201392387,2170660915,22663,36895,2024-10-04 19:44:28,0,0,0,0,0,0
2,201392387,1145490691,63693,47873,2024-10-04 19:44:28,0,0,0,0,0,0
2,201392387,2170660915,0,0,2024-10-04 19:44:28,0,0,0,0,0,0
2,201392387,2170660915,39639,36895,2024-10-04 19:44:29,0,0,0,0,0,0
2,201392387,2170660915,22663,36895,2024-10-04 19:44:29,0,0,0,0,0,0
2,201392387,1145490691,63693,47873,2024-10-04 19:44:29,0,0,0,0,0,0
2,201392387,2170660915,0,0,2024-10-04 19:44:29,0,0,0,0,0,0
2,201392387,2170660915,39639,36895,2024-10-04 19:44:30,0,0,0,0,0,0
2,201392387,2170660915,22663,36895,2024-10-04 19:44:30,0,0,0,0,0,0
2,201392387,1145490691,63693,47873,2024-10-04 19:44:30,0,0,0,0,0,0
2,201392387,2170660915,0,0,2024-10-04 19:44:30,128,84,212,1,1,2
2,201392387,2170660915,39639,36895,2024-10-04 19:44:31,0,0,0,0,0,0
2,201392387,2170660915,22663,36895,2024-10-04 19:44:31,0,0,0,0,0,0
2,201392387,1145490691,63693,47873,2024-10-04 19:44:31,0,0,0,0,0,0
2,201392387,2170660915,0,0,2024-10-04 19:44:31,128,84,212,1,1,2
2,201392387,2170660915,39639,36895,2024-10-04 19:44:32,0,0,0,0,0,0
2,201392387,2170660915,22663,36895,2024-10-04 19:44:32,0,0,0,0,0,0
2,201392387,1145490691,63693,47873,2024-10-04 19:44:32,0,0,0,0,0,0
2,201392387,2170660915,0,0,2024-10-04 19:44:32,128,84,212,1,1,2
2,201392387,2170660915,39639,36895,2024-10-04 19:44:33,0,0,0,0,0,0
2,201392387,2170660915,22663,36895,2024-10-04 19:44:33,0,0,0,0,0,0
2,201392387,1145490691,63693,47873,2024-10-04 19:44:33,0,0,0,0,0,0
2,201392387,2170660915,0,0,2024-10-04 19:44:33,128,0,128,1,0,1
2,201392387,2170660915,39639,36895,2024-10-04 19:44:34,0,0,0,0,0,0
2,201392387,2170660915,22663,36895,2024-10-04 19:44:34,0,0,0,0,0,0
2,201392387,1145490691,63693,47873,2024-10-04 19:44:34,0,0,0,0,0,0
2,201392387,2170660915,0,0,2024-10-04 19:44:34,128,84,212,1,1,2
2,201392387,2170660915,39639,36895,2024-10-04 19:44:35,0,0,0,0,0,0
2,201392387,2170660915,22663,36895,2024-10-04 19:44:35,0,0,0,0,0,0
2,201392387,1145490691,63693,47873,2024-10-04 19:44:35,0,0,0,0,0,0
2,201392387,2170660915,0,0,2024-10-04 19:44:35,128,84,212,1,1,2
2,201392387,2170660915,39639,36895,2024-10-04 19:44:36,0,0,0,0,0,0
2,201392387,2170660915,22663,36895,2024-10-04 19:44:36,0,0,0,0,0,0
2,201392387,1145490691,63693,47873,2024-10-04 19:44:36,0,0,0,0,0,0
2,201392387,2170660915,0,0,2024-10-04 19:44:36,128,84,212,1,1,2
2,201392387,2170660915,39639,36895,2024-10-04 19:44:37,0,0,0,0,0,0
2,201392387,2170660915,22663,36895,2024-10-04 19:44:37,0,0,0,0,0,0
2,201392387,1145490691,63693,47873,2024-10-04 19:44:37,0,0,0,0,0,0
2,201392387,2170660915,0,0,2024-10-04 19:44:37,128,84,212,1,1,2
2,201392387,2170660915,39639,36895,2024-10-04 19:44:38,0,0,0,0,0,0
2,201392387,2170660915,22663,36895,2024-10-04 19:44:38,0,0,0,0,0,0
2,201392387,2170660915,0,0,2024-10-04 19:44:38,128,84,212,1,1,2
2,201392387,2170660915,39639,36895,2024-10-04 19:44:39,0,0,0,0,0,0
2,201392387,2170660915,22663,36895,2024-10-04 19:44:39,0,0,0,0,0,0
2,201392387,2170660915,0,0,2024-10-04 19:44:39,128,84,212,1,1,2
2,201392387,2170660915,39639,36895,2024-10-04 19:44:40,0,0,0,0,0,0
2,201392387,2170660915,22663,36895,2024-10-04 19:44:40,0,0,0,0,0,0
2,201392387,2170660915,0,0,2024-10-04 19:44:40,0,84,84,0,1,1
2,201392387,2170660915,39639,36895,2024-10-04 19:44:41,0,0,0,0,0,0
2,201392387,2170660915,22663,36895,2024-10-04 19:44:41,0,0,0,0,0,0
2,201392387,2170660915,16087,36895,2024-10-04 19:44:41,666,507,1173,6,6,12
2,201392387,2170660915,0,0,2024-10-04 19:44:41,0,0,0,0,0,0
2,201392387,2170660915,39639,36895,2024-10-04 19:44:42,0,0,0,0,0,0
2,201392387,2170660915,22663,36895,2024-10-04 19:44:42,0,0,0,0,0,0
2,201392387,2170660915,16087,36895,2024-10-04 19:44:42,0,0,0,0,0,0
2,201392387,2170660915,0,0,2024-10-04 19:44:42,256,84,340,2,1,3
2,201392387,2170660915,39639,36895,2024-10-04 19:44:43,0,0,0,0,0,0
2,201392387,2170660915,22663,36895,2024-10-04 19:44:43,0,0,0,0,0,0
2,201392387,2170660915,16087,36895,2024-10-04 19:44:43,0,0,0,0,0,0
2,201392387,2170660915,0,0,2024-10-04 19:44:43,128,84,212,1,1,2
2,201392387,2170660915,39639,36895,2024-10-04 19:44:44,0,0,0,0,0,0
2,201392387,2170660915,22663,36895,2024-10-04 19:44:44,0,0,0,0,0,0
2,201392387,2170660915,16087,36895,2024-10-04 19:44:44,0,0,0,0,0,0
2,201392387,2170660915,0,0,2024-10-04 19:44:44,0,0,0,0,0,0
2,201392387,2170660915,39639,36895,2024-10-04 19:44:45,0,0,0,0,0,0
2,201392387,2170660915,22663,36895,2024-10-04 19:44:45,0,0,0,0,0,0
2,201392387,2170660915,16087,36895,2024-10-04 19:44:45,0,0,0,0,0,0
2,201392387,2170660915,0,0,2024-10-04 19:44:45,0,84,84,0,1,1
2,201392387,2170660915,39639,36895,2024-10-04 19:44:46,0,0,0,0,0,0
2,201392387,2170660915,22663,36895,2024-10-04 19:44:46,0,0,0,0,0,0
2,201392387,2170660915,16087,36895,2024-10-04 19:44:46,0,0,0,0,0,0
2,201392387,2170660915,0,0,2024-10-04 19:44:46,0,0,0,0,0,0
2,201392387,2170660915,39639,36895,2024-10-04 19:44:47,0,0,0,0,0,0
2,201392387,2170660915,22663,36895,2024-10-04 19:44:47,0,0,0,0,0,0
2,201392387,2170660915,16087,36895,2024-10-04 19:44:47,0,0,0,0,0,0
2,201392387,2170660915,0,0,2024-10-04 19:44:47,128,84,212,1,1,2
2,201392387,2170660915,39639,36895,2024-10-04 19:44:48,0,0,0,0,0,0
2,201392387,2170660915,22663,36895,2024-10-04 19:44:48,0,0,0,0,0,0
2,201392387,2170660915,16087,36895,2024-10-04 19:44:48,0,0,0,0,0,0
2,201392387,2170660915,0,0,2024-10-04 19:44:48,128,84,212,1,1,2
2,201392387,2170660915,39639,36895,2024-10-04 19:44:49,0,0,0,0,0,0
2,201392387,2170660915,22663,36895,2024-10-04 19:44:49,0,0,0,0,0,0
2,201392387,2170660915,16087,36895,2024-10-04 19:44:49,0,0,0,0,0,0
2,201392387,2170660915,0,0,2024-10-04 19:44:49,128,0,128,1,0,1
2,201392387,2170660915,39639,36895,2024-10-04 19:44:50,0,0,0,0,0,0
2,201392387,2170660915,22663,36895,2024-10-04 19:44:50,0,0,0,0,0,0
2,201392387,2170660915,16087,36895,2024-10-04 19:44:50,0,0,0,0,0,0
2,201392387,1145490689,28389,47873,2024-10-04 19:44:50,3756,53619,57375,29,43,72
2,201392387,2170660915,0,0,2024-10-04 19:44:50,0,84,84,0,1,1
2,201392387,2170660915,39639,36895,2024-10-04 19:44:51,0,0,0,0,0,0
2,201392387,2170660915,22663,36895,2024-10-04 19:44:51,0,0,0,0,0,0
2,201392387,2170660915,16087,36895,2024-10-04 19:44:51,0,0,0,0,0,0
2,201392387,1145490689,28389,47873,2024-10-04 19:44:51,2316,44250,46566,23,29,52
2,201392387,2170660915,0,0,2024-10-04 19:44:51,0,0,0,0,0,0
2,201392387,2170660915,39639,36895,2024-10-04 19:44:52,0,0,0,0,0,0
2,201392387,2170660915,22663,36895,2024-10-04 19:44:52,0,0,0,0,0,0
2,201392387,2170660915,16087,36895,2024-10-04 19:44:52,0,0,0,0,0,0
2,201392387,1145490689,28389,47873,2024-10-04 19:44:52,0,0,0,0,0,0
2,201392387,2170660915,0,0,2024-10-04 19:44:52,0,0,0,0,0,0
2,201392387,2170660915,39639,36895,2024-10-04 19:44:53,0,0,0,0,0,0
2,201392387,2170660915,22663,36895,2024-10-04 19:44:53,0,0,0,0,0,0
2,201392387,2170660915,16087,36895,2024-10-04 19:44:53,0,0,0,0,0,0
2,201392387,1145490689,28389,47873,2024-10-04 19:44:53,0,0,0,0,0,0
2,201392387,2170660915,0,0,2024-10-04 19:44:53,0,0,0,0,0,0
2,201392387,2170660915,39639,36895,2024-10-04 19:44:54,0,0,0,0,0,0
2,201392387,2170660915,22663,36895,2024-10-04 19:44:54,0,0,0,0,0,0
2,201392387,2170660915,16087,36895,2024-10-04 19:44:54,0,0,0,0,0,0
2,201392387,1145490689,28389,47873,2024-10-04 19:44:54,0,0,0,0,0,0
2,201392387,2170660915,0,0,2024-10-04 19:44:54,0,0,0,0,0,0
2,201392387,2170660915,39639,36895,2024-10-04 19:44:55,0,0,0,0,0,0
2,201392387,2170660915,22663,36895,2024-10-04 19:44:55,0,0,0,0,0,0
2,201392387,2170660915,16087,36895,2024-10-04 19:44:55,0,0,0,0,0,0
2,201392387,1145490689,28389,47873,2024-10-04 19:44:55,0,0,0,0,0,0
2,201392387,2170660915,0,0,2024-10-04 19:44:55,0,0,0,0,0,0
2,201392387,2170660915,39639,36895,2024-10-04 19:44:56,0,0,0,0,0,0
2,201392387,2170660915,22663,36895,2024-10-04 19:44:56,0,0,0,0,0,0
2,201392387,2170660915,16087,36895,2024-10-04 19:44:56,0,0,0,0,0,0
2,201392387,1145490689,28389,47873,2024-10-04 19:44:56,0,0,0,0,0,0
2,201392387,2170660915,0,0,2024-10-04 19:44:56,0,0,0,0,0,0
2,201392387,2170660915,39639,36895,2024-10-04 19:44:57,0,0,0,0,0,0
2,201392387,2170660915,22663,36895,2024-10-04 19:44:57,0,0,0,0,0,0
2,201392387,2170660915,16087,36895,2024-10-04 19:44:57,0,0,0,0,0,0
2,201392387,1145490689,28389,47873,2024-10-04 19:44:57,792,5397,6189,8,6,14
2,201392387,2170660915,0,0,2024-10-04 19:44:57,0,0,0,0,0,0
2,201392387,2170660915,39639,36895,2024-10-04 19:44:58,0,0,0,0,0,0
2,201392387,2170660915,22663,36895,2024-10-04 19:44:58,0,0,0,0,0,0
2,201392387,2170660915,16087,36895,2024-10-04 19:44:58,0,0,0,0,0,0
2,201392387,1145490689,28389,47873,2024-10-04 19:44:58,0,0,0,0,0,0
2,201392387,2170660915,0,0,2024-10-04 19:44:58,0,0,0,0,0,0
2,201392387,2170660915,39639,36895,2024-10-04 19:44:59,0,0,0,0,0,0
2,201392387,2170660915,22663,36895,2024-10-04 19:44:59,0,0,0,0,0,0
2,201392387,2170660915,16087,36895,2024-10-04 19:44:59,0,0,0,0,0,0
2,201392387,1145490689,28389,47873,2024-10-04 19:44:59,0,0,0,0,0,0
2,201392387,2170660915,0,0,2024-10-04 19:44:59,0,0,0,0,0,0
2,201392387,2170660915,39639,36895,2024-10-04 19:45:00,0,0,0,0,0,0
2,201392387,2170660915,22663,36895,2024-10-04 19:45:00,0,0,0,0,0,0
2,201392387,2170660915,16087,36895,2024-10-04 19:45:00,0,0,0,0,0,0
2,201392387,1145490689,28389,47873,2024-10-04 19:45:00,0,0,0,0,0,0
2,201392387,2170660915,0,0,2024-10-04 19:45:00,0,0,0,0,0,0
2,201392387,2170660915,39639,36895,2024-10-04 19:45:01,0,0,0,0,0,0
2,201392387,2170660915,22663,36895,2024-10-04 19:45:01,0,0,0,0,0,0
2,201392387,2170660915,16087,36895,2024-10-04 19:45:01,0,0,0,0,0,0
2,201392387,1145490689,28389,47873,2024-10-04 19:45:01,0,0,0,0,0,0
2,201392387,2170660915,0,0,2024-10-04 19:45:01,128,0,128,1,0,1
2,201392387,2170660915,39639,36895,2024-10-04 19:45:02,0,0,0,0,0,0
2,201392387,2170660915,22663,36895,2024-10-04 19:45:02,0,0,0,0,0,0
2,201392387,2170660915,16087,36895,2024-10-04 19:45:02,0,0,0,0,0,0
2,201392387,1145490689,28389,47873,2024-10-04 19:45:02,0,0,0,0,0,0
2,201392387,2170660915,0,0,2024-10-04 19:45:02,128,84,212,1,1,2
2,201392387,2170660915,39639,36895,2024-10-04 19:45:03,0,0,0,0,0,0
2,201392387,2170660915,22663,36895,2024-10-04 19:45:03,0,0,0,0,0,0
2,201392387,2170660915,16087,36895,2024-10-04 19:45:03,0,0,0,0,0,0
2,201392387,1145490689,28389,47873,2024-10-04 19:45:03,0,0,0,0,0,0
2,201392387,2170660915,0,0,2024-10-04 19:45:03,128,84,212,1,1,2
2,201392387,2170660915,39639,36895,2024-10-04 19:45:04,0,0,0,0,0,0
2,201392387,2170660915,22663,36895,2024-10-04 19:45:04,0,0,0,0,0,0
2,201392387,2170660915,16087,36895,2024-10-04 19:45:04,0,0,0,0,0,0
2,201392387,1145490689,28389,47873,2024-10-04 19:45:04,0,0,0,0,0,0
2,201392387,2170660915,0,0,2024-10-04 19:45:04,128,84,212,1,1,2
2,201392387,2170660915,39639,36895,2024-10-04 19:45:05,0,0,0,0,0,0
2,201392387,2170660915,22663,36895,2024-10-04 19:45:05,0,0,0,0,0,0
2,201392387,2170660915,16087,36895,2024-10-04 19:45:05,0,0,0,0,0,0
2,201392387,1145490689,28389,47873,2024-10-04 19:45:05,0,0,0,0,0,0
2,201392387,2170660915,0,0,2024-10-04 19:45:05,128,84,212,1,1,2
2,201392387,2170660915,39639,36895,2024-10-04 19:45:06,0,0,0,0,0,0
2,201392387,2170660915,22663,36895,2024-10-04 19:45:06,0,0,0,0,0,0
2,201392387,2170660915,16087,36895,2024-10-04 19:45:06,0,0,0,0,0,0
2,201392387,1145490689,28389,47873,2024-10-04 19:45:06,0,0,0,0,0,0
2,201392387,2170660915,0,0,2024-10-04 19:45:06,128,84,212,1,1,2
2,201392387,2170660915,39639,36895,2024-10-04 19:45:07,0,0,0,0,0,0
2,201392387,2170660915,22663,36895,2024-10-04 19:45:07,0,0,0,0,0,0
2,201392387,2170660915,16087,36895,2024-10-04 19:45:07,0,0,0,0,0,0
2,201392387,1145490689,28389,47873,2024-10-04 19:45:07,0,0,0,0,0,0
2,201392387,2170660915,0,0,2024-10-04 19:45:07,128,84,212,1,1,2
2,201392387,2170660915,39639,36895,2024-10-04 19:45:08,0,0,0,0,0,0
2,201392387,2170660915,22663,36895,2024-10-04 19:45:08,0,0,0,0,0,0
2,201392387,2170660915,16087,36895,2024-10-04 19:45:08,0,0,0,0,0,0
2,201392387,1145490689,28389,47873,2024-10-04 19:45:08,0,0,0,0,0,0
2,201392387,2170660915,0,0,2024-10-04 19:45:08,0,84,84,0,1,1
2,201392387,2170660915,39639,36895,2024-10-04 19:45:09,0,0,0,0,0,0
2,201392387,2170660915,22663,36895,2024-10-04 19:45:09,0,0,0,0,0,0
2,201392387,2170660915,16087,36895,2024-10-04 19:45:09,0,0,0,0,0,0
2,201392387,2170660915,0,0,2024-10-04 19:45:09,256,84,340,2,1,3
2,201392387,2170660915,39639,36895,2024-10-04 19:45:10,0,0,0,0,0,0
2,201392387,2170660915,22663,36895,2024-10-04 19:45:10,0,0,0,0,0,0
2,201392387,2170660915,16087,36895,2024-10-04 19:45:10,0,0,0,0,0,0
2,201392387,2170660915,0,0,2024-10-04 19:45:10,128,84,212,1,1,2
2,201392387,2170660915,39639,36895,2024-10-04 19:45:11,0,0,0,0,0,0
2,201392387,2170660915,22663,36895,2024-10-04 19:45:11,0,0,0,0,0,0
2,201392387,2170660915,16087,36895,2024-10-04 19:45:11,0,0,0,0,0,0
2,201392387,2170660915,0,0,2024-10-04 19:45:11,0,84,84,0,1,1
2,201392387,2170660915,39639,36895,2024-10-04 19:45:12,0,0,0,0,0,0
2,201392387,2170660915,22663,36895,2024-10-04 19:45:12,0,0,0,0,0,0
2,201392387,2170660915,48829,36895,2024-10-04 19:45:12,666,507,1173,6,6,12
2,201392387,2170660915,0,0,2024-10-04 19:45:12,0,0,0,0,0,0
2,201392387,2170660915,39639,36895,2024-10-04 19:45:13,0,0,0,0,0,0
2,201392387,2170660915,22663,36895,2024-10-04 19:45:13,0,0,0,0,0,0
2,201392387,2170660915,48829,36895,2024-10-04 19:45:13,0,0,0,0,0,0
2,201392387,2170660915,0,0,2024-10-04 19:45:13,0,0,0,0,0,0
2,201392387,2170660915,39639,36895,2024-10-04 19:45:14,0,0,0,0,0,0
2,201392387,2170660915,22663,36895,2024-10-04 19:45:14,0,0,0,0,0,0
2,201392387,2170660915,48829,36895,2024-10-04 19:45:14,0,0,0,0,0,0
2,201392387,2170660915,0,0,2024-10-04 19:45:14,128,84,212,1,1,2
2,201392387,2170660915,39639,36895,2024-10-04 19:45:15,0,0,0,0,0,0
2,201392387,2170660915,22663,36895,2024-10-04 19:45:15,0,0,0,0,0,0
2,201392387,2170660915,48829,36895,2024-10-04 19:45:15,0,0,0,0,0,0
2,201392387,2170660915,0,0,2024-10-04 19:45:15,256,168,424,2,2,4
2,201392387,2170660915,39639,36895,2024-10-04 19:45:16,0,0,0,0,0,0
2,201392387,2170660915,22663,36895,2024-10-04 19:45:16,0,0,0,0,0,0
2,201392387,2170660915,48829,36895,2024-10-04 19:45:16,0,0,0,0,0,0
2,201392387,2170660915,0,0,2024-10-04 19:45:16,0,0,0,0,0,0
2,201392387,2170660915,39639,36895,2024-10-04 19:45:17,0,0,0,0,0,0
2,201392387,2170660915,22663,36895,2024-10-04 19:45:17,0,0,0,0,0,0
2,201392387,2170660915,48829,36895,2024-10-04 19:45:17,0,0,0,0,0,0
2,201392387,2170660915,0,0,2024-10-04 19:45:17,0,0,0,0,0,0
2,201392387,2170660915,39639,36895,2024-10-04 19:45:18,0,0,0,0,0,0
2,201392387,2170660915,22663,36895,2024-10-04 19:45:18,0,0,0,0,0,0
2,201392387,2170660915,48829,36895,2024-10-04 19:45:18,0,0,0,0,0,0
2,201392387,2170660915,0,0,2024-10-04 19:45:18,128,0,128,1,0,1
2,201392387,2170660915,39639,36895,2024-10-04 19:45:19,0,0,0,0,0,0
2,201392387,2170660915,22663,36895,2024-10-04 19:45:19,0,0,0,0,0,0
2,201392387,2170660915,48829,36895,2024-10-04 19:45:19,0,0,0,0,0,0
2,201392387,2170660915,0,0,2024-10-04 19:45:19,0,84,84,0,1,1
2,201392387,2170660915,39639,36895,2024-10-04 19:45:20,0,0,0,0,0,0
2,201392387,2170660915,22663,36895,2024-10-04 19:45:20,0,0,0,0,0,0
2,201392387,2170660915,48829,36895,2024-10-04 19:45:20,0,0,0,0,0,0
2,201392387,2170660915,0,0,2024-10-04 19:45:20,128,84,212,1,1,2
2,201392387,2170660915,39639,36895,2024-10-04 19:45:21,0,0,0,0,0,0
2,201392387,2170660915,22663,36895,2024-10-04 19:45:21,0,0,0,0,0,0
2,201392387,2170660915,48829,36895,2024-10-04 19:45:21,0,0,0,0,0,0
2,201392387,1145490690,52945,47873,2024-10-04 19:45:21,2892,36771,39663,21,32,53
2,201392387,2170660915,0,0,2024-10-04 19:45:21,128,84,212,1,1,2
2,201392387,2170660915,39639,36895,2024-10-04 19:45:22,0,0,0,0,0,0
2,201392387,2170660915,22663,36895,2024-10-04 19:45:22,0,0,0,0,0,0
2,201392387,2170660915,48829,36895,2024-10-04 19:45:22,0,0,0,0,0,0
2,201392387,1145490690,52945,47873,2024-10-04 19:45:22,3372,60445,63817,34,44,78
2,201392387,2170660915,0,0,2024-10-04 19:45:22,0,0,0,0,0,0
2,201392387,2170660915,39639,36895,2024-10-04 19:45:23,0,0,0,0,0,0
2,201392387,2170660915,22663,36895,2024-10-04 19:45:23,0,0,0,0,0,0
2,201392387,2170660915,48829,36895,2024-10-04 19:45:23,0,0,0,0,0,0
2,201392387,1145490690,52945,47873,2024-10-04 19:45:23,0,0,0,0,0,0
2,201392387,2170660915,0,0,2024-10-04 19:45:23,0,0,0,0,0,0
2,201392387,2170660915,39639,36895,2024-10-04 19:45:24,0,0,0,0,0,0
2,201392387,2170660915,22663,36895,2024-10-04 19:45:24,0,0,0,0,0,0
2,201392387,2170660915,48829,36895,2024-10-04 19:45:24,0,0,0,0,0,0
2,201392387,1145490690,52945,47873,2024-10-04 19:45:24,0,0,0,0,0,0
2,201392387,2170660915,0,0,2024-10-04 19:45:24,0,0,0,0,0,0
2,201392387,2170660915,39639,36895,2024-10-04 19:45:25,0,0,0,0,0,0
2,201392387,2170660915,22663,36895,2024-10-04 19:45:25,0,0,0,0,0,0
2,201392387,2170660915,48829,36895,2024-10-04 19:45:25,0,0,0,0,0,0
2,201392387,1145490690,52945,47873,2024-10-04 19:45:25,0,0,0,0,0,0
2,201392387,2170660915,0,0,2024-10-04 19:45:25,0,0,0,0,0,0
2,201392387,2170660915,39639,36895,2024-10-04 19:45:26,0,0,0,0,0,0
2,201392387,2170660915,22663,36895,2024-10-04 19:45:26,0,0,0,0,0,0
2,201392387,2170660915,48829,36895,2024-10-04 19:45:26,0,0,0,0,0,0
2,201392387,1145490690,52945,47873,2024-10-04 19:45:26,0,0,0,0,0,0
2,201392387,2170660915,0,0,2024-10-04 19:45:26,0,0,0,0,0,0
2,201392387,2170660915,39639,36895,2024-10-04 19:45:27,0,0,0,0,0,0
2,201392387,2170660915,22663,36895,2024-10-04 19:45:27,0,0,0,0,0,0
2,201392387,2170660915,48829,36895,2024-10-04 19:45:27,0,0,0,0,0,0
2,201392387,1145490690,52945,47873,2024-10-04 19:45:27,0,0,0,0,0,0
2,201392387,2170660915,0,0,2024-10-04 19:45:27,0,0,0,0,0,0
2,201392387,2170660915,39639,36895,2024-10-04 19:45:28,0,0,0,0,0,0
2,201392387,2170660915,22663,36895,2024-10-04 19:45:28,0,0,0,0,0,0
2,201392387,2170660915,48829,36895,2024-10-04 19:45:28,0,0,0,0,0,0
2,201392387,1145490690,52945,47873,2024-10-04 19:45:28,0,0,0,0,0,0
2,201392387,2170660915,0,0,2024-10-04 19:45:28,0,0,0,0,0,0
2,201392387,2170660915,39639,36895,2024-10-04 19:45:29,0,0,0,0,0,0
2,201392387,2170660915,22663,36895,2024-10-04 19:45:29,0,0,0,0,0,0
2,201392387,2170660915,48829,36895,2024-10-04 19:45:29,0,0,0,0,0,0
2,201392387,1145490690,52945,47873,2024-10-04 19:45:29,0,0,0,0,0,0
2,201392387,2170660915,0,0,2024-10-04 19:45:29,0,0,0,0,0,0
2,201392387,2170660915,39639,36895,2024-10-04 19:45:30,0,0,0,0,0,0
2,201392387,2170660915,22663,36895,2024-10-04 19:45:30,0,0,0,0,0,0
2,201392387,2170660915,48829,36895,2024-10-04 19:45:30,0,0,0,0,0,0
2,201392387,1145490690,52945,47873,2024-10-04 19:45:30,0,0,0,0,0,0
2,201392387,2170660915,0,0,2024-10-04 19:45:30,0,0,0,0,0,0
2,201392387,2170660915,39639,36895,2024-10-04 19:45:31,0,0,0,0,0,0
2,201392387,2170660915,22663,36895,2024-10-04 19:45:31,0,0,0,0,0,0
2,201392387,2170660915,48829,36895,2024-10-04 19:45:31,0,0,0,0,0,0
2,201392387,1145490690,52945,47873,2024-10-04 19:45:31,0,0,0,0,0,0
2,201392387,2170660915,0,0,2024-10-04 19:45:31,0,0,0,0,0,0
2,201392387,2170660915,39639,36895,2024-10-04 19:45:32,0,0,0,0,0,0
2,201392387,2170660915,22663,36895,2024-10-04 19:45:32,0,0,0,0,0,0
2,201392387,2170660915,48829,36895,2024-10-04 19:45:32,0,0,0,0,0,0
2,201392387,1145490690,52945,47873,2024-10-04 19:45:32,0,0,0,0,0,0
2,201392387,2170660915,0,0,2024-10-04 19:45:32,0,0,0,0,0,0
2,201392387,2170660915,39639,36895,2024-10-04 19:45:33,0,0,0,0,0,0
2,201392387,2170660915,22663,36895,2024-10-04 19:45:33,0,0,0,0,0,0
2,201392387,2170660915,48829,36895,2024-10-04 19:45:33,0,0,0,0,0,0
2,201392387,1145490690,52945,47873,2024-10-04 19:45:33,0,0,0,0,0,0
2,201392387,2170660915,0,0,2024-10-04 19:45:33,128,84,212,1,1,2
2,201392387,2170660915,39639,36895,2024-10-04 19:45:34,0,0,0,0,0,0
2,201392387,2170660915,22663,36895,2024-10-04 19:45:34,0,0,0,0,0,0
2,201392387,2170660915,48829,36895,2024-10-04 19:45:34,0,0,0,0,0,0
2,201392387,1145490690,52945,47873,2024-10-04 19:45:34,0,0,0,0,0,0
2,201392387,2170660915,0,0,2024-10-04 19:45:34,128,84,212,1,1,2
2,201392387,2170660915,39639,36895,2024-10-04 19:45:35,0,0,0,0,0,0
2,201392387,2170660915,22663,36895,2024-10-04 19:45:35,0,0,0,0,0,0
2,201392387,2170660915,48829,36895,2024-10-04 19:45:35,0,0,0,0,0,0
2,201392387,1145490690,52945,47873,2024-10-04 19:45:35,0,0,0,0,0,0
2,201392387,2170660915,0,0,2024-10-04 19:45:35,128,84,212,1,1,2
2,201392387,2170660915,39639,36895,2024-10-04 19:45:36,0,0,0,0,0,0
2,201392387,2170660915,22663,36895,2024-10-04 19:45:36,0,0,0,0,0,0
2,201392387,2170660915,48829,36895,2024-10-04 19:45:36,0,0,0,0,0,0
2,201392387,1145490690,52945,47873,2024-10-04 19:45:36,0,0,0,0,0,0
2,201392387,2170660915,0,0,2024-10-04 19:45:36,128,84,212,1,1,2
2,201392387,2170660915,39639,36895,2024-10-04 19:45:37,0,0,0,0,0,0
2,201392387,2170660915,22663,36895,2024-10-04 19:45:37,0,0,0,0,0,0
2,201392387,2170660915,48829,36895,2024-10-04 19:45:37,0,0,0,0,0,0
2,201392387,1145490690,52945,47873,2024-10-04 19:45:37,0,0,0,0,0,0
2,201392387,2170660915,0,0,2024-10-04 19:45:37,128,84,212,1,1,2
2,201392387,2170660915,39639,36895,2024-10-04 19:45:38,0,0,0,0,0,0
2,201392387,2170660915,22663,36895,2024-10-04 19:45:38,0,0,0,0,0,0
2,201392387,2170660915,48829,36895,2024-10-04 19:45:38,0,0,0,0,0,0
2,201392387,1145490690,52945,47873,2024-10-04 19:45:38,0,0,0,0,0,0
2,201392387,2170660915,0,0,2024-10-04 19:45:38,256,168,424,2,2,4
2,201392387,2170660915,39639,36895,2024-10-04 19:45:39,0,0,0,0,0,0
2,201392387,2170660915,22663,36895,2024-10-04 19:45:39,0,0,0,0,0,0
2,201392387,2170660915,48829,36895,2024-10-04 19:45:39,0,0,0,0,0,0
2,201392387,2170660915,0,0,2024-10-04 19:45:39,128,84,212,1,1,2
2,201392387,2170660915,39639,36895,2024-10-04 19:45:40,0,0,0,0,0,0
2,201392387,2170660915,22663,36895,2024-10-04 19:45:40,0,0,0,0,0,0
2,201392387,2170660915,48829,36895,2024-10-04 19:45:40,0,0,0,0,0,0
2,201392387,2170660915,0,0,2024-10-04 19:45:40,128,84,212,1,1,2
2,201392387,2170660915,39639,36895,2024-10-04 19:45:41,0,0,0,0,0,0
2,201392387,2170660915,22663,36895,2024-10-04 19:45:41,0,0,0,0,0,0
2,201392387,2170660915,48829,36895,2024-10-04 19:45:41,0,0,0,0,0,0
2,201392387,2170660915,0,0,2024-10-04 19:45:41,128,84,212,1,1,2
2,201392387,2170660915,39639,36895,2024-10-04 19:45:42,0,0,0,0,0,0
2,201392387,2170660915,22663,36895,2024-10-04 19:45:42,0,0,0,0,0,0
2,201392387,2170660915,48829,36895,2024-10-04 19:45:42,0,0,0,0,0,0
2,201392387,2170660915,0,0,2024-10-04 19:45:42,0,0,0,0,0,0
2,201392387,2170660915,39639,36895,2024-10-04 19:45:43,0,0,0,0,0,0
2,201392387,2170660915,22663,36895,2024-10-04 19:45:43,0,0,0,0,0,0
2,201392387,2170660915,6784,36895,2024-10-04 19:45:43,666,507,1173,6,6,12
2,201392387,2170660915,0,0,2024-10-04 19:45:43,0,0,0,0,0,0
2,201392387,2170660915,39639,36895,2024-10-04 19:45:44,0,0,0,0,0,0
2,201392387,2170660915,22663,36895,2024-10-04 19:45:44,0,0,0,0,0,0
2,201392387,2170660915,6784,36895,2024-10-04 19:45:44,0,0,0,0,0,0
2,201392387,2170660915,0,0,2024-10-04 19:45:44,0,0,0,0,0,0
2,201392387,2170660915,39639,36895,2024-10-04 19:45:45,0,0,0,0,0,0
2,201392387,2170660915,22663,36895,2024-10-04 19:45:45,0,0,0,0,0,0
2,201392387,2170660915,6784,36895,2024-10-04 19:45:45,0,0,0,0,0,0
2,201392387,2170660915,0,0,2024-10-04 19:45:45,128,84,212,1,1,2
2,201392387,2170660915,39639,36895,2024-10-04 19:45:46,0,0,0,0,0,0
2,201392387,2170660915,22663,36895,2024-10-04 19:45:46,0,0,0,0,0,0
2,201392387,2170660915,6784,36895,2024-10-04 19:45:46,0,0,0,0,0,0
2,201392387,2170660915,0,0,2024-10-04 19:45:46,128,84,212,1,1,2
2,201392387,2170660915,39639,36895,2024-10-04 19:45:47,0,0,0,0,0,0
2,201392387,2170660915,22663,36895,2024-10-04 19:45:47,0,0,0,0,0,0
2,201392387,2170660915,6784,36895,2024-10-04 19:45:47,0,0,0,0,0,0
2,201392387,2170660915,0,0,2024-10-04 19:45:47,128,84,212,1,1,2
2,201392387,2170660915,39639,36895,2024-10-04 19:45:48,0,0,0,0,0,0
2,201392387,2170660915,22663,36895,2024-10-04 19:45:48,0,0,0,0,0,0
2,201392387,2170660915,6784,36895,2024-10-04 19:45:48,0,0,0,0,0,0
2,201392387,2170660915,0,0,2024-10-04 19:45:48,0,0,0,0,0,0
2,201392387,2170660915,39639,36895,2024-10-04 19:45:49,0,0,0,0,0,0
2,201392387,2170660915,22663,36895,2024-10-04 19:45:49,0,0,0,0,0,0
2,201392387,2170660915,6784,36895,2024-10-04 19:45:49,0,0,0,0,0,0
2,201392387,2170660915,0,0,2024-10-04 19:45:49,0,0,0,0,0,0
2,201392387,2170660915,39639,36895,2024-10-04 19:45:50,0,0,0,0,0,0
2,201392387,2170660915,22663,36895,2024-10-04 19:45:50,0,0,0,0,0,0
2,201392387,2170660915,6784,36895,2024-10-04 19:45:50,0,0,0,0,0,0
2,201392387,2170660915,0,0,2024-10-04 19:45:50,128,84,212,1,1,2
2,201392387,2170660915,39639,36895,2024-10-04 19:45:51,0,0,0,0,0,0
2,201392387,2170660915,22663,36895,2024-10-04 19:45:51,0,0,0,0,0,0
2,201392387,2170660915,6784,36895,2024-10-04 19:45:51,0,0,0,0,0,0
2,201392387,2170660915,0,0,2024-10-04 19:45:51,128,84,212,1,1,2
2,201392387,2170660915,39639,36895,2024-10-04 19:45:52,0,0,0,0,0,0
2,201392387,2170660915,22663,36895,2024-10-04 19:45:52,0,0,0,0,0,0
2,201392387,2170660915,6784,36895,2024-10-04 19:45:52,0,0,0,0,0,0
2,201392387,1145490691,9435,47873,2024-10-04 19:45:52,2712,27023,29735,19,26,45
2,201392387,2170660915,0,0,2024-10-04 19:45:52,128,84,212,1,1,2
2,201392387,2170660915,39639,36895,2024-10-04 19:45:53,0,0,0,0,0,0
2,201392387,2170660915,22663,36895,2024-10-04 19:45:53,0,0,0,0,0,0
2,201392387,2170660915,6784,36895,2024-10-04 19:45:53,0,0,0,0,0,0
2,201392387,1145490691,9435,47873,2024-10-04 19:45:53,384,13816,14200,4,8,12
2,201392387,2170660915,0,0,2024-10-04 19:45:53,0,0,0,0,0,0
2,201392387,2170660915,39639,36895,2024-10-04 19:45:54,0,0,0,0,0,0
2,201392387,2170660915,22663,36895,2024-10-04 19:45:54,0,0,0,0,0,0
2,201392387,2170660915,6784,36895,2024-10-04 19:45:54,0,0,0,0,0,0
2,201392387,1145490691,9435,47873,2024-10-04 19:45:54,1680,37764,39444,17,24,41
2,201392387,2170660915,0,0,2024-10-04 19:45:54,0,0,0,0,0,0
2,201392387,2170660915,39639,36895,2024-10-04 19:45:55,0,0,0,0,0,0
2,201392387,2170660915,22663,36895,2024-10-04 19:45:55,0,0,0,0,0,0
2,201392387,2170660915,6784,36895,2024-10-04 19:45:55,0,0,0,0,0,0
2,201392387,1145490691,9435,47873,2024-10-04 19:45:55,0,0,0,0,0,0
2,201392387,2170660915,0,0,2024-10-04 19:45:55,0,0,0,0,0,0
2,201392387,2170660915,39639,36895,2024-10-04 19:45:56,0,0,0,0,0,0
2,201392387,2170660915,22663,36895,2024-10-04 19:45:56,0,0,0,0,0,0
2,201392387,2170660915,6784,36895,2024-10-04 19:45:56,0,0,0,0,0,0
2,201392387,1145490691,9435,47873,2024-10-04 19:45:56,0,0,0,0,0,0
2,201392387,2170660915,0,0,2024-10-04 19:45:56,0,0,0,0,0,0
2,201392387,2170660915,39639,36895,2024-10-04 19:45:57,0,0,0,0,0,0
2,201392387,2170660915,22663,36895,2024-10-04 19:45:57,0,0,0,0,0,0
2,201392387,2170660915,6784,36895,2024-10-04 19:45:57,0,0,0,0,0,0
2,201392387,1145490691,9435,47873,2024-10-04 19:45:57,0,0,0,0,0,0
2,201392387,2170660915,0,0,2024-10-04 19:45:57,0,0,0,0,0,0
2,201392387,2170660915,39639,36895,2024-10-04 19:45:58,0,0,0,0,0,0
2,201392387,2170660915,22663,36895,2024-10-04 19:45:58,0,0,0,0,0,0
2,201392387,2170660915,6784,36895,2024-10-04 19:45:58,0,0,0,0,0,0
2,201392387,1145490691,9435,47873,2024-10-04 19:45:58,2208,32799,35007,22,24,46
2,201392387,2170660915,0,0,2024-10-04 19:45:58,0,0,0,0,0,0
2,201392387,2170660915,39639,36895,2024-10-04 19:45:59,0,0,0,0,0,0
2,201392387,2170660915,22663,36895,2024-10-04 19:45:59,0,0,0,0,0,0
2,201392387,2170660915,6784,36895,2024-10-04 19:45:59,0,0,0,0,0,0
2,201392387,1145490691,9435,47873,2024-10-04 19:45:59,0,0,0,0,0,0
2,201392387,2170660915,0,0,2024-10-04 19:45:59,0,0,0,0,0,0
2,201392387,2170660915,39639,36895,2024-10-04 19:46:00,0,0,0,0,0,0
2,201392387,2170660915,22663,36895,2024-10-04 19:46:00,0,0,0,0,0,0
2,201392387,2170660915,6784,36895,2024-10-04 19:46:00,0,0,0,0,0,0
2,201392387,1145490691,9435,47873,2024-10-04 19:46:00,0,0,0,0,0,0
2,201392387,2170660915,0,0,2024-10-04 19:46:00,0,0,0,0,0,0
2,201392387,2170660915,39639,36895,2024-10-04 19:46:01,0,0,0,0,0,0
2,201392387,2170660915,22663,36895,2024-10-04 19:46:01,0,0,0,0,0,0
2,201392387,2170660915,6784,36895,2024-10-04 19:46:01,0,0,0,0,0,0
2,201392387,1145490691,9435,47873,2024-10-04 19:46:01,0,0,0,0,0,0
2,201392387,2170660915,0,0,2024-10-04 19:46:01,0,0,0,0,0,0
2,201392387,2170660915,39639,36895,2024-10-04 19:46:02,0,0,0,0,0,0
2,201392387,2170660915,22663,36895,2024-10-04 19:46:02,0,0,0,0,0,0
2,201392387,2170660915,6784,36895,2024-10-04 19:46:02,0,0,0,0,0,0
2,201392387,1145490691,9435,47873,2024-10-04 19:46:02,0,0,0,0,0,0
2,201392387,2170660915,0,0,2024-10-04 19:46:02,0,0,0,0,0,0
2,201392387,2170660915,39639,36895,2024-10-04 19:46:03,0,0,0,0,0,0
2,201392387,2170660915,22663,36895,2024-10-04 19:46:03,0,0,0,0,0,0
2,201392387,2170660915,6784,36895,2024-10-04 19:46:03,0,0,0,0,0,0
2,201392387,1145490691,9435,47873,2024-10-04 19:46:03,0,0,0,0,0,0
2,201392387,2170660915,0,0,2024-10-04 19:46:03,0,0,0,0,0,0
2,201392387,2170660915,39639,36895,2024-10-04 19:46:04,0,0,0,0,0,0
2,201392387,2170660915,22663,36895,2024-10-04 19:46:04,0,0,0,0,0,0
2,201392387,2170660915,6784,36895,2024-10-04 19:46:04,0,0,0,0,0,0
2,201392387,1145490691,9435,47873,2024-10-04 19:46:04,0,0,0,0,0,0
2,201392387,2170660915,0,0,2024-10-04 19:46:04,0,0,0,0,0,0
2,201392387,2170660915,39639,36895,2024-10-04 19:46:05,0,0,0,0,0,0
2,201392387,2170660915,22663,36895,2024-10-04 19:46:05,0,0,0,0,0,0
2,201392387,2170660915,6784,36895,2024-10-04 19:46:05,0,0,0,0,0,0
2,201392387,1145490691,9435,47873,2024-10-04 19:46:05,0,0,0,0,0,0
2,201392387,2170660915,0,0,2024-10-04 19:46:05,128,84,212,1,1,2
2,201392387,2170660915,39639,36895,2024-10-04 19:46:06,0,0,0,0,0,0
2,201392387,2170660915,22663,36895,2024-10-04 19:46:06,0,0,0,0,0,0
2,201392387,2170660915,6784,36895,2024-10-04 19:46:06,0,0,0,0,0,0
2,201392387,1145490691,9435,47873,2024-10-04 19:46:06,0,0,0,0,0,0
2,201392387,2170660915,0,0,2024-10-04 19:46:06,128,84,212,1,1,2
2,201392387,2170660915,39639,36895,2024-10-04 19:46:07,0,0,0,0,0,0
2,201392387,2170660915,22663,36895,2024-10-04 19:46:07,0,0,0,0,0,0
2,201392387,2170660915,6784,36895,2024-10-04 19:46:07,0,0,0,0,0,0
2,201392387,1145490691,9435,47873,2024-10-04 19:46:07,0,0,0,0,0,0
2,201392387,2170660915,0,0,2024-10-04 19:46:07,128,84,212,1,1,2
2,201392387,2170660915,39639,36895,2024-10-04 19:46:08,0,0,0,0,0,0
2,201392387,2170660915,22663,36895,2024-10-04 19:46:08,0,0,0,0,0,0
2,201392387,2170660915,6784,36895,2024-10-04 19:46:08,0,0,0,0,0,0
2,201392387,2170660915,0,0,2024-10-04 19:46:08,128,84,212,1,1,2
2,201392387,2170660915,39639,36895,2024-10-04 19:46:09,0,0,0,0,0,0
2,201392387,2170660915,22663,36895,2024-10-04 19:46:09,0,0,0,0,0,0
2,201392387,2170660915,6784,36895,2024-10-04 19:46:09,0,0,0,0,0,0
2,201392387,2170660915,0,0,2024-10-04 19:46:09,128,84,212,1,1,2
2,201392387,2170660915,39639,36895,2024-10-04 19:46:10,0,0,0,0,0,0
2,201392387,2170660915,22663,36895,2024-10-04 19:46:10,0,0,0,0,0,0
2,201392387,2170660915,6784,36895,2024-10-04 19:46:10,0,0,0,0,0,0
2,201392387,2170660915,0,0,2024-10-04 19:46:10,128,84,212,1,1,2
2,201392387,2170660915,39639,36895,2024-10-04 19:46:11,0,0,0,0,0,0
2,201392387,2170660915,22663,36895,2024-10-04 19:46:11,0,0,0,0,0,0
2,201392387,2170660915,6784,36895,2024-10-04 19:46:11,0,0,0,0,0,0
2,201392387,2170660915,0,0,2024-10-04 19:46:11,128,84,212,1,1,2
2,201392387,2170660915,39639,36895,2024-10-04 19:46:12,0,0,0,0,0,0
2,201392387,2170660915,22663,36895,2024-10-04 19:46:12,0,0,0,0,0,0
2,201392387,2170660915,6784,36895,2024-10-04 19:46:12,0,0,0,0,0,0
2,201392387,2170660915,0,0,2024-10-04 19:46:12,128,84,212,1,1,2
2,201392387,2170660915,39639,36895,2024-10-04 19:46:13,0,0,0,0,0,0
2,201392387,2170660915,22663,36895,2024-10-04 19:46:13,0,0,0,0,0,0
2,201392387,2170660915,6784,36895,2024-10-04 19:46:13,0,0,0,0,0,0
2,201392387,2170660915,0,0,2024-10-04 19:46:13,128,84,212,1,1,2
2,201392387,2170660915,39639,36895,2024-10-04 19:46:14,0,0,0,0,0,0
2,201392387,2170660915,22663,36895,2024-10-04 19:46:14,0,0,0,0,0,0
2,201392387,2170660915,6784,36895,2024-10-04 19:46:14,0,0,0,0,0,0
2,201392387,2170660915,0,0,2024-10-04 19:46:14,128,84,212,1,1,2
2,201392387,2170660915,39639,36895,2024-10-04 19:46:15,0,0,0,0,0,0
2,201392387,2170660915,22663,36895,2024-10-04 19:46:15,0,0,0,0,0,0
2,201392387,2170660915,6784,36895,2024-10-04 19:46:15,0,0,0,0,0,0
2,201392387,2170660915,0,0,2024-10-04 19:46:15,0,0,0,0,0,0
2,201392387,2170660915,39639,36895,2024-10-04 19:46:16,0,0,0,0,0,0
2,201392387,2170660915,22663,36895,2024-10-04 19:46:16,0,0,0,0,0,0
2,201392387,2170660915,6784,36895,2024-10-04 19:46:16,0,0,0,0,0,0
2,201392387,2170660915,0,0,2024-10-04 19:46:16,0,0,0,0,0,0
2,201392387,2170660915,39639,36895,2024-10-04 19:46:17,0,0,0,0,0,0
2,201392387,2170660915,22663,36895,2024-10-04 19:46:17,0,0,0,0,0,0
2,201392387,2170660915,5848,36895,2024-10-04 19:46:17,570,455,1025,5,5,10
2,201392387,2170660915,0,0,2024-10-04 19:46:17,0,0,0,0,0,0
2,201392387,2170660915,39639,36895,2024-10-04 19:46:18,0,0,0,0,0,0
2,201392387,2170660915,22663,36895,2024-10-04 19:46:18,0,0,0,0,0,0
2,201392387,2170660915,5848,36895,2024-10-04 19:46:18,0,0,0,0,0,0
2,201392387,2170660915,0,0,2024-10-04 19:46:18,256,168,424,2,2,4
2,201392387,2170660915,39639,36895,2024-10-04 19:46:19,0,0,0,0,0,0
2,201392387,2170660915,22663,36895,2024-10-04 19:46:19,0,0,0,0,0,0
2,201392387,2170660915,5848,36895,2024-10-04 19:46:19,0,0,0,0,0,0
2,201392387,2170660915,0,0,2024-10-04 19:46:19,128,84,212,1,1,2
2,201392387,2170660915,39639,36895,2024-10-04 19:46:20,0,0,0,0,0,0
2,201392387,2170660915,22663,36895,2024-10-04 19:46:20,0,0,0,0,0,0
2,201392387,2170660915,5848,36895,2024-10-04 19:46:20,0,0,0,0,0,0
2,201392387,2170660915,0,0,2024-10-04 19:46:20,0,0,0,0,0,0
2,201392387,2170660915,39639,36895,2024-10-04 19:46:21,0,0,0,0,0,0
2,201392387,2170660915,22663,36895,2024-10-04 19:46:21,0,0,0,0,0,0
2,201392387,2170660915,5848,36895,2024-10-04 19:46:21,0,0,0,0,0,0
2,201392387,2170660915,0,0,2024-10-04 19:46:21,0,0,0,0,0,0
2,201392387,2170660915,39639,36895,2024-10-04 19:46:22,0,0,0,0,0,0
2,201392387,2170660915,22663,36895,2024-10-04 19:46:22,0,0,0,0,0,0
2,201392387,2170660915,5848,36895,2024-10-04 19:46:22,0,0,0,0,0,0
2,201392387,2170660915,0,0,2024-10-04 19:46:22,0,0,0,0,0,0
2,201392387,2170660915,39639,36895,2024-10-04 19:46:23,0,0,0,0,0,0
2,201392387,2170660915,22663,36895,2024-10-04 19:46:23,0,0,0,0,0,0
2,201392387,2170660915,5848,36895,2024-10-04 19:46:23,0,0,0,0,0,0
2,201392387,2170660915,0,0,2024-10-04 19:46:23,128,84,212,1,1,2
2,201392387,2170660915,39639,36895,2024-10-04 19:46:24,0,0,0,0,0,0
2,201392387,2170660915,22663,36895,2024-10-04 19:46:24,0,0,0,0,0,0
2,201392387,2170660915,5848,36895,2024-10-04 19:46:24,0,0,0,0,0,0
2,201392387,2170660915,0,0,2024-10-04 19:46:24,128,84,212,1,1,2
2,201392387,2170660915,39639,36895,2024-10-04 19:46:25,0,0,0,0,0,0
2,201392387,2170660915,22663,36895,2024-10-04 19:46:25,0,0,0,0,0,0
2,201392387,2170660915,5848,36895,2024-10-04 19:46:25,0,0,0,0,0,0
2,201392387,1145490690,27870,47873,2024-10-04 19:46:25,4236,65171,69407,34,52,86
2,201392387,2170660915,0,0,2024-10-04 19:46:25,128,84,212,1,1,2
2,201392387,2170660915,39639,36895,2024-10-04 19:46:26,0,0,0,0,0,0
2,201392387,2170660915,22663,36895,2024-10-04 19:46:26,0,0,0,0,0,0
2,201392387,2170660915,5848,36895,2024-10-04 19:46:26,0,0,0,0,0,0
2,201392387,1145490690,27870,47873,2024-10-04 19:46:26,0,0,0,0,0,0
2,201392387,2170660915,0,0,2024-10-04 19:46:26,0,0,0,0,0,0
2,201392387,2170660915,39639,36895,2024-10-04 19:46:27,0,0,0,0,0,0
2,201392387,2170660915,22663,36895,2024-10-04 19:46:27,0,0,0,0,0,0
2,201392387,2170660915,5848,36895,2024-10-04 19:46:27,0,0,0,0,0,0
2,201392387,1145490690,27870,47873,2024-10-04 19:46:27,0,0,0,0,0,0
2,201392387,2170660915,0,0,2024-10-04 19:46:27,0,0,0,0,0,0
2,201392387,2170660915,39639,36895,2024-10-04 19:46:28,0,0,0,0,0,0
2,201392387,2170660915,22663,36895,2024-10-04 19:46:28,0,0,0,0,0,0
2,201392387,2170660915,5848,36895,2024-10-04 19:46:28,0,0,0,0,0,0
2,201392387,1145490690,27870,47873,2024-10-04 19:46:28,0,0,0,0,0,0
2,201392387,2170660915,0,0,2024-10-04 19:46:28,0,0,0,0,0,0
2,201392387,2170660915,39639,36895,2024-10-04 19:46:29,0,0,0,0,0,0
2,201392387,2170660915,22663,36895,2024-10-04 19:46:29,0,0,0,0,0,0
2,201392387,2170660915,5848,36895,2024-10-04 19:46:29,0,0,0,0,0,0
2,201392387,1145490690,27870,47873,2024-10-04 19:46:29,0,0,0,0,0,0
2,201392387,2170660915,0,0,2024-10-04 19:46:29,0,0,0,0,0,0
2,201392387,2170660915,39639,36895,2024-10-04 19:46:30,0,0,0,0,0,0
2,201392387,2170660915,22663,36895,2024-10-04 19:46:30,0,0,0,0,0,0
2,201392387,2170660915,5848,36895,2024-10-04 19:46:30,0,0,0,0,0,0
2,201392387,1145490690,27870,47873,2024-10-04 19:46:30,1752,30011,31763,17,23,40
2,201392387,2170660915,0,0,2024-10-04 19:46:30,0,0,0,0,0,0
2,201392387,2170660915,39639,36895,2024-10-04 19:46:31,0,0,0,0,0,0
2,201392387,2170660915,22663,36895,2024-10-04 19:46:31,0,0,0,0,0,0
2,201392387,2170660915,5848,36895,2024-10-04 19:46:31,0,0,0,0,0,0
2,201392387,1145490690,27870,47873,2024-10-04 19:46:31,0,0,0,0,0,0
2,201392387,2170660915,0,0,2024-10-04 19:46:31,0,0,0,0,0,0
2,201392387,2170660915,39639,36895,2024-10-04 19:46:32,0,0,0,0,0,0
2,201392387,2170660915,22663,36895,2024-10-04 19:46:32,0,0,0,0,0,0
2,201392387,2170660915,5848,36895,2024-10-04 19:46:32,0,0,0,0,0,0
2,201392387,1145490690,27870,47873,2024-10-04 19:46:32,0,0,0,0,0,0
2,201392387,2170660915,0,0,2024-10-04 19:46:32,0,0,0,0,0,0
2,201392387,2170660915,39639,36895,2024-10-04 19:46:33,0,0,0,0,0,0
2,201392387,2170660915,22663,36895,2024-10-04 19:46:33,0,0,0,0,0,0
2,201392387,2170660915,5848,36895,2024-10-04 19:46:33,0,0,0,0,0,0
2,201392387,1145490690,27870,47873,2024-10-04 19:46:33,0,0,0,0,0,0
2,201392387,2170660915,0,0,2024-10-04 19:46:33,0,0,0,0,0,0
2,201392387,2170660915,39639,36895,2024-10-04 19:46:34,0,0,0,0,0,0
2,201392387,2170660915,22663,36895,2024-10-04 19:46:34,0,0,0,0,0,0
2,201392387,2170660915,5848,36895,2024-10-04 19:46:34,0,0,0,0,0,0
2,201392387,1145490690,27870,47873,2024-10-04 19:46:34,0,0,0,0,0,0
2,201392387,2170660915,0,0,2024-10-04 19:46:34,0,0,0,0,0,0
2,201392387,2170660915,39639,36895,2024-10-04 19:46:35,0,0,0,0,0,0
2,201392387,2170660915,22663,36895,2024-10-04 19:46:35,0,0,0,0,0,0
2,201392387,2170660915,5848,36895,2024-10-04 19:46:35,0,0,0,0,0,0
2,201392387,1145490690,27870,47873,2024-10-04 19:46:35,0,0,0,0,0,0
2,201392387,2170660915,0,0,2024-10-04 19:46:35,0,0,0,0,0,0
2,201392387,2170660915,39639,36895,2024-10-04 19:46:36,0,0,0,0,0,0
2,201392387,2170660915,22663,36895,2024-10-04 19:46:36,0,0,0,0,0,0
2,201392387,2170660915,5848,36895,2024-10-04 19:46:36,0,0,0,0,0,0
2,201392387,1145490690,27870,47873,2024-10-04 19:46:36,0,0,0,0,0,0
2,201392387,2170660915,0,0,2024-10-04 19:46:36,128,0,128,1,0,1
2,201392387,2170660915,39639,36895,2024-10-04 19:46:37,0,0,0,0,0,0
2,201392387,2170660915,22663,36895,2024-10-04 19:46:37,0,0,0,0,0,0
2,201392387,2170660915,5848,36895,2024-10-04 19:46:37,0,0,0,0,0,0
2,201392387,1145490690,27870,47873,2024-10-04 19:46:37,0,0,0,0,0,0
2,201392387,2170660915,0,0,2024-10-04 19:46:37,128,84,212,1,1,2
2,201392387,2170660915,39639,36895,2024-10-04 19:46:38,0,0,0,0,0,0
2,201392387,2170660915,22663,36895,2024-10-04 19:46:38,0,0,0,0,0,0
2,201392387,2170660915,5848,36895,2024-10-04 19:46:38,0,0,0,0,0,0
2,201392387,1145490690,27870,47873,2024-10-04 19:46:38,0,0,0,0,0,0
2,201392387,2170660915,0,0,2024-10-04 19:46:38,128,84,212,1,1,2
2,201392387,2170660915,39639,36895,2024-10-04 19:46:39,0,0,0,0,0,0
2,201392387,2170660915,22663,36895,2024-10-04 19:46:39,0,0,0,0,0,0
2,201392387,2170660915,5848,36895,2024-10-04 19:46:39,0,0,0,0,0,0
2,201392387,1145490690,27870,47873,2024-10-04 19:46:39,0,0,0,0,0,0
2,201392387,2170660915,0,0,2024-10-04 19:46:39,128,84,212,1,1,2
2,201392387,2170660915,39639,36895,2024-10-04 19:46:40,0,0,0,0,0,0
2,201392387,2170660915,22663,36895,2024-10-04 19:46:40,0,0,0,0,0,0
2,201392387,2170660915,5848,36895,2024-10-04 19:46:40,0,0,0,0,0,0
2,201392387,2170660915,0,0,2024-10-04 19:46:40,128,168,296,1,2,3
2,201392387,2170660915,39639,36895,2024-10-04 19:46:41,0,0,0,0,0,0
2,201392387,2170660915,22663,36895,2024-10-04 19:46:41,0,0,0,0,0,0
2,201392387,2170660915,5848,36895,2024-10-04 19:46:41,0,0,0,0,0,0
2,201392387,2170660915,0,0,2024-10-04 19:46:41,0,0,0,0,0,0
2,201392387,2170660915,39639,36895,2024-10-04 19:46:42,0,0,0,0,0,0
2,201392387,2170660915,22663,36895,2024-10-04 19:46:42,0,0,0,0,0,0
2,201392387,2170660915,5848,36895,2024-10-04 19:46:42,0,0,0,0,0,0
2,201392387,2170660915,0,0,2024-10-04 19:46:42,128,84,212,1,1,2
2,201392387,2170660915,39639,36895,2024-10-04 19:46:43,0,0,0,0,0,0
2,201392387,2170660915,22663,36895,2024-10-04 19:46:43,0,0,0,0,0,0
2,201392387,2170660915,5848,36895,2024-10-04 19:46:43,0,0,0,0,0,0
2,201392387,2170660915,0,0,2024-10-04 19:46:43,128,84,212,1,1,2
2,201392387,2170660915,39639,36895,2024-10-04 19:46:44,0,0,0,0,0,0
2,201392387,2170660915,22663,36895,2024-10-04 19:46:44,0,0,0,0,0,0
2,201392387,2170660915,5848,36895,2024-10-04 19:46:44,0,0,0,0,0,0
2,201392387,2170660915,0,0,2024-10-04 19:46:44,128,84,212,1,1,2
2,201392387,2170660915,39639,36895,2024-10-04 19:46:45,0,0,0,0,0,0
2,201392387,2170660915,22663,36895,2024-10-04 19:46:45,0,0,0,0,0,0
2,201392387,2170660915,5848,36895,2024-10-04 19:46:45,0,0,0,0,0,0
2,201392387,2170660915,0,0,2024-10-04 19:46:45,256,168,424,2,2,4
2,201392387,2170660915,39639,36895,2024-10-04 19:46:46,0,0,0,0,0,0
2,201392387,2170660915,22663,36895,2024-10-04 19:46:46,0,0,0,0,0,0
2,201392387,2170660915,0,0,2024-10-04 19:46:46,0,0,0,0,0,0
2,201392387,2170660915,39639,36895,2024-10-04 19:46:47,0,0,0,0,0,0
2,201392387,2170660915,22663,36895,2024-10-04 19:46:47,0,0,0,0,0,0
2,201392387,2170660915,47255,36895,2024-10-04 19:46:47,666,507,1173,6,6,12
2,201392387,2170660915,0,0,2024-10-04 19:46:47,0,0,0,0,0,0
2,201392387,2170660915,39639,36895,2024-10-04 19:46:48,0,0,0,0,0,0
2,201392387,2170660915,22663,36895,2024-10-04 19:46:48,0,0,0,0,0,0
2,201392387,2170660915,47255,36895,2024-10-04 19:46:48,0,0,0,0,0,0
2,201392387,2170660915,0,0,2024-10-04 19:46:48,128,84,212,1,1,2
2,201392387,2170660915,39639,36895,2024-10-04 19:46:49,0,0,0,0,0,0
2,201392387,2170660915,22663,36895,2024-10-04 19:46:49,0,0,0,0,0,0
2,201392387,2170660915,47255,36895,2024-10-04 19:46:49,0,0,0,0,0,0
2,201392387,2170660915,0,0,2024-10-04 19:46:49,128,84,212,1,1,2
2,201392387,2170660915,39639,36895,2024-10-04 19:46:50,0,0,0,0,0,0
2,201392387,2170660915,22663,36895,2024-10-04 19:46:50,0,0,0,0,0,0
2,201392387,2170660915,47255,36895,2024-10-04 19:46:50,0,0,0,0,0,0
2,201392387,2170660915,0,0,2024-10-04 19:46:50,128,84,212,1,1,2
2,201392387,2170660915,39639,36895,2024-10-04 19:46:51,0,0,0,0,0,0
2,201392387,2170660915,22663,36895,2024-10-04 19:46:51,0,0,0,0,0,0
2,201392387,2170660915,47255,36895,2024-10-04 19:46:51,0,0,0,0,0,0
2,201392387,2170660915,0,0,2024-10-04 19:46:51,0,0,0,0,0,0
2,201392387,2170660915,39639,36895,2024-10-04 19:46:52,0,0,0,0,0,0
2,201392387,2170660915,22663,36895,2024-10-04 19:46:52,0,0,0,0,0,0
2,201392387,2170660915,47255,36895,2024-10-04 19:46:52,0,0,0,0,0,0
2,201392387,2170660915,0,0,2024-10-04 19:46:52,0,0,0,0,0,0
2,201392387,2170660915,39639,36895,2024-10-04 19:46:53,0,0,0,0,0,0
2,201392387,2170660915,22663,36895,2024-10-04 19:46:53,0,0,0,0,0,0
2,201392387,2170660915,47255,36895,2024-10-04 19:46:53,0,0,0,0,0,0
2,201392387,2170660915,0,0,2024-10-04 19:46:53,0,0,0,0,0,0
2,201392387,2170660915,39639,36895,2024-10-04 19:46:54,0,0,0,0,0,0
2,201392387,2170660915,22663,36895,2024-10-04 19:46:54,0,0,0,0,0,0
2,201392387,2170660915,47255,36895,2024-10-04 19:46:54,0,0,0,0,0,0
2,201392387,2170660915,0,0,2024-10-04 19:46:54,128,84,212,1,1,2
2,201392387,2170660915,39639,36895,2024-10-04 19:46:55,0,0,0,0,0,0
2,201392387,1145490690,40641,47873,2024-10-04 19:46:55,813,60,873,3,1,4
2,201392387,2170660915,22663,36895,2024-10-04 19:46:55,0,0,0,0,0,0
2,201392387,2170660915,47255,36895,2024-10-04 19:46:55,0,0,0,0,0,0
2,201392387,2170660915,0,0,2024-10-04 19:46:55,256,168,424,2,2,4
2,201392387,2170660915,39639,36895,2024-10-04 19:46:56,0,0,0,0,0,0
2,201392387,1145490690,40641,47873,2024-10-04 19:46:56,5487,106137,111624,50,76,126
2,201392387,2170660915,22663,36895,2024-10-04 19:46:56,0,0,0,0,0,0
2,201392387,2170660915,47255,36895,2024-10-04 19:46:56,0,0,0,0,0,0
2,201392387,2170660915,0,0,2024-10-04 19:46:56,0,0,0,0,0,0
2,201392387,2170660915,39639,36895,2024-10-04 19:46:57,0,0,0,0,0,0
2,201392387,1145490690,40641,47873,2024-10-04 19:46:57,0,0,0,0,0,0
2,201392387,2170660915,22663,36895,2024-10-04 19:46:57,0,0,0,0,0,0
2,201392387,2170660915,47255,36895,2024-10-04 19:46:57,0,0,0,0,0,0
2,201392387,2170660915,0,0,2024-10-04 19:46:57,0,0,0,0,0,0
2,201392387,2170660915,39639,36895,2024-10-04 19:46:58,0,0,0,0,0,0
2,201392387,1145490690,40641,47873,2024-10-04 19:46:58,0,0,0,0,0,0
2,201392387,2170660915,22663,36895,2024-10-04 19:46:58,0,0,0,0,0,0
2,201392387,2170660915,47255,36895,2024-10-04 19:46:58,0,0,0,0,0,0
2,201392387,2170660915,0,0,2024-10-04 19:46:58,0,0,0,0,0,0
2,201392387,2170660915,39639,36895,2024-10-04 19:46:59,0,0,0,0,0,0
2,201392387,1145490690,40641,47873,2024-10-04 19:46:59,0,0,0,0,0,0
2,201392387,2170660915,22663,36895,2024-10-04 19:46:59,0,0,0,0,0,0
2,201392387,2170660915,47255,36895,2024-10-04 19:46:59,0,0,0,0,0,0
2,201392387,2170660915,0,0,2024-10-04 19:46:59,0,0,0,0,0,0
2,201392387,2170660915,39639,36895,2024-10-04 19:47:00,0,0,0,0,0,0
2,201392387,1145490690,40641,47873,2024-10-04 19:47:00,0,0,0,0,0,0
2,201392387,2170660915,22663,36895,2024-10-04 19:47:00,0,0,0,0,0,0
2,201392387,2170660915,47255,36895,2024-10-04 19:47:00,0,0,0,0,0,0
2,201392387,2170660915,0,0,2024-10-04 19:47:00,0,0,0,0,0,0
2,201392387,2170660915,39639,36895,2024-10-04 19:47:01,0,0,0,0,0,0
2,201392387,1145490690,40641,47873,2024-10-04 19:47:01,312,1189,1501,3,4,7
2,201392387,2170660915,22663,36895,2024-10-04 19:47:01,0,0,0,0,0,0
2,201392387,2170660915,47255,36895,2024-10-04 19:47:01,0,0,0,0,0,0
2,201392387,2170660915,0,0,2024-10-04 19:47:01,0,0,0,0,0,0
2,201392387,2170660915,39639,36895,2024-10-04 19:47:02,0,0,0,0,0,0
2,201392387,1145490690,40641,47873,2024-10-04 19:47:02,0,0,0,0,0,0
2,201392387,2170660915,22663,36895,2024-10-04 19:47:02,0,0,0,0,0,0
2,201392387,2170660915,47255,36895,2024-10-04 19:47:02,0,0,0,0,0,0
2,201392387,2170660915,0,0,2024-10-04 19:47:02,0,0,0,0,0,0
2,201392387,2170660915,39639,36895,2024-10-04 19:47:03,0,0,0,0,0,0
2,201392387,1145490690,40641,47873,2024-10-04 19:47:03,0,0,0,0,0,0
2,201392387,2170660915,22663,36895,2024-10-04 19:47:03,0,0,0,0,0,0
2,201392387,2170660915,47255,36895,2024-10-04 19:47:03,0,0,0,0,0,0
2,201392387,2170660915,0,0,2024-10-04 19:47:03,0,0,0,0,0,0
2,201392387,2170660915,39639,36895,2024-10-04 19:47:04,0,0,0,0,0,0
2,201392387,1145490690,40641,47873,2024-10-04 19:47:04,0,0,0,0,0,0
2,201392387,2170660915,22663,36895,2024-10-04 19:47:04,0,0,0,0,0,0
2,201392387,2170660915,47255,36895,2024-10-04 19:47:04,0,0,0,0,0,0
2,201392387,2170660915,0,0,2024-10-04 19:47:04,0,0,0,0,0,0
2,201392387,2170660915,39639,36895,2024-10-04 19:47:05,0,0,0,0,0,0
2,201392387,1145490690,40641,47873,2024-10-04 19:47:05,0,0,0,0,0,0
2,201392387,2170660915,22663,36895,2024-10-04 19:47:05,0,0,0,0,0,0
2,201392387,2170660915,47255,36895,2024-10-04 19:47:05,0,0,0,0,0,0
2,201392387,2170660915,0,0,2024-10-04 19:47:05,0,0,0,0,0,0
2,201392387,2170660915,39639,36895,2024-10-04 19:47:06,0,0,0,0,0,0
2,201392387,1145490690,40641,47873,2024-10-04 19:47:06,0,0,0,0,0,0
2,201392387,2170660915,22663,36895,2024-10-04 19:47:06,0,0,0,0,0,0
2,201392387,2170660915,47255,36895,2024-10-04 19:47:06,0,0,0,0,0,0
2,201392387,2170660915,0,0,2024-10-04 19:47:06,128,0,128,1,0,1
2,201392387,2170660915,39639,36895,2024-10-04 19:47:07,0,0,0,0,0,0
2,201392387,1145490690,40641,47873,2024-10-04 19:47:07,0,0,0,0,0,0
2,201392387,2170660915,22663,36895,2024-10-04 19:47:07,0,0,0,0,0,0
2,201392387,2170660915,47255,36895,2024-10-04 19:47:07,0,0,0,0,0,0
2,201392387,2170660915,0,0,2024-10-04 19:47:07,128,84,212,1,1,2
2,201392387,2170660915,39639,36895,2024-10-04 19:47:08,0,0,0,0,0,0
2,201392387,1145490690,40641,47873,2024-10-04 19:47:08,0,0,0,0,0,0
2,201392387,2170660915,22663,36895,2024-10-04 19:47:08,0,0,0,0,0,0
2,201392387,2170660915,47255,36895,2024-10-04 19:47:08,0,0,0,0,0,0
2,201392387,2170660915,0,0,2024-10-04 19:47:08,128,84,212,1,1,2
2,201392387,2170660915,39639,36895,2024-10-04 19:47:09,0,0,0,0,0,0
2,201392387,1145490690,40641,47873,2024-10-04 19:47:09,0,0,0,0,0,0
2,201392387,2170660915,22663,36895,2024-10-04 19:47:09,0,0,0,0,0,0
2,201392387,2170660915,47255,36895,2024-10-04 19:47:09,0,0,0,0,0,0
2,201392387,2170660915,0,0,2024-10-04 19:47:09,128,84,212,1,1,2
2,201392387,2170660915,39639,36895,2024-10-04 19:47:10,0,0,0,0,0,0
2,201392387,1145490690,40641,47873,2024-10-04 19:47:10,0,0,0,0,0,0
2,201392387,2170660915,22663,36895,2024-10-04 19:47:10,0,0,0,0,0,0
2,201392387,2170660915,47255,36895,2024-10-04 19:47:10,0,0,0,0,0,0
2,201392387,2170660915,0,0,2024-10-04 19:47:10,128,84,212,1,1,2
2,201392387,2170660915,39639,36895,2024-10-04 19:47:11,0,0,0,0,0,0
2,201392387,1145490690,40641,47873,2024-10-04 19:47:11,0,0,0,0,0,0
2,201392387,2170660915,22663,36895,2024-10-04 19:47:11,0,0,0,0,0,0
2,201392387,2170660915,47255,36895,2024-10-04 19:47:11,0,0,0,0,0,0
2,201392387,2170660915,0,0,2024-10-04 19:47:11,128,84,212,1,1,2
2,201392387,2170660915,39639,36895,2024-10-04 19:47:12,0,0,0,0,0,0
2,201392387,2170660915,22663,36895,2024-10-04 19:47:12,0,0,0,0,0,0
2,201392387,2170660915,47255,36895,2024-10-04 19:47:12,0,0,0,0,0,0
2,201392387,2170660915,0,0,2024-10-04 19:47:12,128,84,212,1,1,2
2,201392387,2170660915,39639,36895,2024-10-04 19:47:13,0,0,0,0,0,0
2,201392387,2170660915,22663,36895,2024-10-04 19:47:13,0,0,0,0,0,0
2,201392387,2170660915,47255,36895,2024-10-04 19:47:13,0,0,0,0,0,0
2,201392387,2170660915,0,0,2024-10-04 19:47:13,128,84,212,1,1,2
2,201392387,2170660915,39639,36895,2024-10-04 19:47:14,0,0,0,0,0,0
2,201392387,2170660915,22663,36895,2024-10-04 19:47:14,0,0,0,0,0,0
2,201392387,2170660915,47255,36895,2024-10-04 19:47:14,0,0,0,0,0,0
2,201392387,2170660915,0,0,2024-10-04 19:47:14,128,84,212,1,1,2
2,201392387,2170660915,39639,36895,2024-10-04 19:47:15,0,0,0,0,0,0
2,201392387,2170660915,22663,36895,2024-10-04 19:47:15,0,0,0,0,0,0
2,201392387,2170660915,47255,36895,2024-10-04 19:47:15,0,0,0,0,0,0
2,201392387,2170660915,0,0,2024-10-04 19:47:15,128,84,212,1,1,2
2,201392387,2170660915,39639,36895,2024-10-04 19:47:16,0,0,0,0,0,0
2,201392387,2170660915,22663,36895,2024-10-04 19:47:16,0,0,0,0,0,0
2,201392387,2170660915,47255,36895,2024-10-04 19:47:16,0,0,0,0,0,0
2,201392387,2170660915,0,0,2024-10-04 19:47:16,0,84,84,0,1,1
2,201392387,2170660915,39639,36895,2024-10-04 19:47:17,0,0,0,0,0,0
2,201392387,2170660915,22663,36895,2024-10-04 19:47:17,0,0,0,0,0,0
2,201392387,2170660915,9369,36895,2024-10-04 19:47:17,570,455,1025,5,5,10
2,201392387,2170660915,0,0,2024-10-04 19:47:17,0,0,0,0,0,0
2,201392387,2170660915,39639,36895,2024-10-04 19:47:18,0,0,0,0,0,0
2,201392387,2170660915,22663,36895,2024-10-04 19:47:18,0,0,0,0,0,0
2,201392387,2170660915,9369,36895,2024-10-04 19:47:18,0,0,0,0,0,0
2,201392387,2170660915,0,0,2024-10-04 19:47:18,128,84,212,1,1,2
2,201392387,2170660915,39639,36895,2024-10-04 19:47:19,0,0,0,0,0,0
2,201392387,2170660915,22663,36895,2024-10-04 19:47:19,0,0,0,0,0,0
2,201392387,2170660915,9369,36895,2024-10-04 19:47:19,0,0,0,0,0,0
2,201392387,2170660915,0,0,2024-10-04 19:47:19,128,84,212,1,1,2
2,201392387,2170660915,39639,36895,2024-10-04 19:47:20,0,0,0,0,0,0
2,201392387,2170660915,22663,36895,2024-10-04 19:47:20,0,0,0,0,0,0
2,201392387,2170660915,9369,36895,2024-10-04 19:47:20,0,0,0,0,0,0
2,201392387,2170660915,0,0,2024-10-04 19:47:20,128,84,212,1,1,2
2,201392387,2170660915,39639,36895,2024-10-04 19:47:21,0,0,0,0,0,0
2,201392387,2170660915,22663,36895,2024-10-04 19:47:21,0,0,0,0,0,0
2,201392387,2170660915,0,0,2024-10-04 19:47:21,0,0,0,0,0,0
2,201392387,2170660915,39639,36895,2024-10-04 19:47:22,0,0,0,0,0,0
2,201392387,2170660915,22663,36895,2024-10-04 19:47:22,0,0,0,0,0,0
2,201392387,2170660915,0,0,2024-10-04 19:47:22,0,0,0,0,0,0
2,201392387,2170660915,39639,36895,2024-10-04 19:47:23,0,0,0,0,0,0
2,201392387,2170660915,22663,36895,2024-10-04 19:47:23,0,0,0,0,0,0
2,201392387,2170660915,0,0,2024-10-04 19:47:23,0,0,0,0,0,0
2,201392387,2170660915,39639,36895,2024-10-04 19:47:24,0,0,0,0,0,0
2,201392387,2170660915,22663,36895,2024-10-04 19:47:24,0,0,0,0,0,0
2,201392387,2170660915,0,0,2024-10-04 19:47:24,128,84,212,1,1,2
2,201392387,2170660915,39639,36895,2024-10-04 19:47:25,0,0,0,0,0,0
2,201392387,2170660915,22663,36895,2024-10-04 19:47:25,0,0,0,0,0,0
2,201392387,2170660915,0,0,2024-10-04 19:47:25,128,84,212,1,1,2
2,201392387,2170660915,39639,36895,2024-10-04 19:47:26,0,0,0,0,0,0
2,201392387,2170660915,22663,36895,2024-10-04 19:47:26,0,0,0,0,0,0
2,201392387,1145490690,51393,47873,2024-10-04 19:47:26,3584,41911,45495,27,37,64
2,201392387,2170660915,0,0,2024-10-04 19:47:26,128,84,212,1,1,2
2,201392387,2170660915,39639,36895,2024-10-04 19:47:27,0,0,0,0,0,0
2,201392387,2170660915,22663,36895,2024-10-04 19:47:27,0,0,0,0,0,0
2,201392387,1145490690,51393,47873,2024-10-04 19:47:27,2256,50544,52800,22,33,55
2,201392387,2170660915,0,0,2024-10-04 19:47:27,0,0,0,0,0,0
2,201392387,2170660915,39639,36895,2024-10-04 19:47:28,0,0,0,0,0,0
2,201392387,2170660915,22663,36895,2024-10-04 19:47:28,0,0,0,0,0,0
2,201392387,1145490690,51393,47873,2024-10-04 19:47:28,0,0,0,0,0,0
2,201392387,2170660915,0,0,2024-10-04 19:47:28,0,0,0,0,0,0
2,201392387,2170660915,39639,36895,2024-10-04 19:47:29,0,0,0,0,0,0
2,201392387,2170660915,22663,36895,2024-10-04 19:47:29,0,0,0,0,0,0
2,201392387,1145490690,51393,47873,2024-10-04 19:47:29,0,0,0,0,0,0
2,201392387,2170660915,0,0,2024-10-04 19:47:29,0,0,0,0,0,0
2,201392387,2170660915,39639,36895,2024-10-04 19:47:30,0,0,0,0,0,0
2,201392387,2170660915,22663,36895,2024-10-04 19:47:30,0,0,0,0,0,0
2,201392387,1145490690,51393,47873,2024-10-04 19:47:30,0,0,0,0,0,0
2,201392387,2170660915,0,0,2024-10-04 19:47:30,0,0,0,0,0,0
2,201392387,2170660915,39639,36895,2024-10-04 19:47:31,0,0,0,0,0,0
2,201392387,2170660915,22663,36895,2024-10-04 19:47:31,0,0,0,0,0,0
2,201392387,1145490690,51393,47873,2024-10-04 19:47:31,0,0,0,0,0,0
2,201392387,2170660915,0,0,2024-10-04 19:47:31,0,0,0,0,0,0
2,201392387,2170660915,39639,36895,2024-10-04 19:47:32,0,0,0,0,0,0
2,201392387,2170660915,22663,36895,2024-10-04 19:47:32,0,0,0,0,0,0
2,201392387,1145490690,51393,47873,2024-10-04 19:47:32,720,8851,9571,7,8,15
2,201392387,2170660915,0,0,2024-10-04 19:47:32,0,0,0,0,0,0
2,201392387,2170660915,39639,36895,2024-10-04 19:47:33,0,0,0,0,0,0
2,201392387,2170660915,22663,36895,2024-10-04 19:47:33,0,0,0,0,0,0
2,201392387,1145490690,51393,47873,2024-10-04 19:47:33,0,0,0,0,0,0
2,201392387,2170660915,0,0,2024-10-04 19:47:33,0,0,0,0,0,0
2,201392387,2170660915,39639,36895,2024-10-04 19:47:34,0,0,0,0,0,0
2,201392387,2170660915,22663,36895,2024-10-04 19:47:34,0,0,0,0,0,0
2,201392387,1145490690,51393,47873,2024-10-04 19:47:34,0,0,0,0,0,0
2,201392387,2170660915,0,0,2024-10-04 19:47:34,0,0,0,0,0,0
2,201392387,2170660915,39639,36895,2024-10-04 19:47:35,0,0,0,0,0,0
2,201392387,2170660915,22663,36895,2024-10-04 19:47:35,0,0,0,0,0,0
2,201392387,1145490690,51393,47873,2024-10-04 19:47:35,0,0,0,0,0,0
2,201392387,2170660915,0,0,2024-10-04 19:47:35,0,0,0,0,0,0
2,201392387,2170660915,39639,36895,2024-10-04 19:47:36,0,0,0,0,0,0
2,201392387,2170660915,22663,36895,2024-10-04 19:47:36,0,0,0,0,0,0
2,201392387,1145490690,51393,47873,2024-10-04 19:47:36,0,0,0,0,0,0
2,201392387,2170660915,0,0,2024-10-04 19:47:36,0,0,0,0,0,0
2,201392387,2170660915,39639,36895,2024-10-04 19:47:37,0,0,0,0,0,0
2,201392387,2170660915,22663,36895,2024-10-04 19:47:37,0,0,0,0,0,0
2,201392387,1145490690,51393,47873,2024-10-04 19:47:37,0,0,0,0,0,0
2,201392387,2170660915,0,0,2024-10-04 19:47:37,128,0,128,1,0,1
2,201392387,2170660915,39639,36895,2024-10-04 19:47:38,0,0,0,0,0,0
2,201392387,2170660915,22663,36895,2024-10-04 19:47:38,0,0,0,0,0,0
2,201392387,1145490690,51393,47873,2024-10-04 19:47:38,0,0,0,0,0,0
2,201392387,2170660915,0,0,2024-10-04 19:47:38,128,84,212,1,1,2
2,201392387,2170660915,39639,36895,2024-10-04 19:47:39,0,0,0,0,0,0
2,201392387,2170660915,22663,36895,2024-10-04 19:47:39,0,0,0,0,0,0
2,201392387,1145490690,51393,47873,2024-10-04 19:47:39,0,0,0,0,0,0
2,201392387,2170660915,0,0,2024-10-04 19:47:39,128,84,212,1,1,2
2,201392387,2170660915,39639,36895,2024-10-04 19:47:40,0,0,0,0,0,0
2,201392387,2170660915,22663,36895,2024-10-04 19:47:40,0,0,0,0,0,0
2,201392387,1145490690,51393,47873,2024-10-04 19:47:40,0,0,0,0,0,0
2,201392387,2170660915,0,0,2024-10-04 19:47:40,128,84,212,1,1,2
2,201392387,2170660915,39639,36895,2024-10-04 19:47:41,0,0,0,0,0,0
2,201392387,2170660915,22663,36895,2024-10-04 19:47:41,0,0,0,0,0,0
2,201392387,1145490690,51393,47873,2024-10-04 19:47:41,0,0,0,0,0,0
2,201392387,2170660915,0,0,2024-10-04 19:47:41,128,84,212,1,1,2
2,201392387,2170660915,39639,36895,2024-10-04 19:47:42,0,0,0,0,0,0
2,201392387,2170660915,22663,36895,2024-10-04 19:47:42,0,0,0,0,0,0
2,201392387,1145490690,51393,47873,2024-10-04 19:47:42,0,0,0,0,0,0
2,201392387,2170660915,0,0,2024-10-04 19:47:42,128,84,212,1,1,2
2,201392387,2170660915,39639,36895,2024-10-04 19:47:43,0,0,0,0,0,0
2,201392387,2170660915,22663,36895,2024-10-04 19:47:43,0,0,0,0,0,0
2,201392387,2170660915,0,0,2024-10-04 19:47:43,128,84,212,1,1,2
2,201392387,2170660915,39639,36895,2024-10-04 19:47:44,0,0,0,0,0,0
2,201392387,2170660915,22663,36895,2024-10-04 19:47:44,0,0,0,0,0,0
2,201392387,2170660915,0,0,2024-10-04 19:47:44,128,84,212,1,1,2
2,201392387,2170660915,39639,36895,2024-10-04 19:47:45,0,0,0,0,0,0
2,201392387,2170660915,22663,36895,2024-10-04 19:47:45,0,0,0,0,0,0
2,201392387,2170660915,0,0,2024-10-04 19:47:45,128,84,212,1,1,2
2,201392387,2170660915,39639,36895,2024-10-04 19:47:46,0,0,0,0,0,0
2,201392387,2170660915,22663,36895,2024-10-04 19:47:46,0,0,0,0,0,0
2,201392387,2170660915,0,0,2024-10-04 19:47:46,128,84,212,1,1,2
2,201392387,2170660915,39639,36895,2024-10-04 19:47:47,0,0,0,0,0,0
2,201392387,2170660915,22663,36895,2024-10-04 19:47:47,0,0,0,0,0,0
2,201392387,2170660915,0,0,2024-10-04 19:47:47,0,84,84,0,1,1
2,201392387,2170660915,39639,36895,2024-10-04 19:47:48,0,0,0,0,0,0
2,201392387,2170660915,27360,36895,2024-10-04 19:47:48,666,507,1173,6,6,12
2,201392387,2170660915,22663,36895,2024-10-04 19:47:48,0,0,0,0,0,0
2,201392387,2170660915,0,0,2024-10-04 19:47:48,0,0,0,0,0,0
2,201392387,2170660915,39639,36895,2024-10-04 19:47:49,0,0,0,0,0,0
2,201392387,2170660915,27360,36895,2024-10-04 19:47:49,0,0,0,0,0,0
2,201392387,2170660915,22663,36895,2024-10-04 19:47:49,0,0,0,0,0,0
2,201392387,2170660915,0,0,2024-10-04 19:47:49,128,84,212,1,1,2
2,201392387,2170660915,39639,36895,2024-10-04 19:47:50,0,0,0,0,0,0
2,201392387,2170660915,27360,36895,2024-10-04 19:47:50,0,0,0,0,0,0
2,201392387,2170660915,22663,36895,2024-10-04 19:47:50,0,0,0,0,0,0
2,201392387,2170660915,0,0,2024-10-04 19:47:50,128,84,212,1,1,2
2,201392387,2170660915,39639,36895,2024-10-04 19:47:51,0,0,0,0,0,0
2,201392387,2170660915,27360,36895,2024-10-04 19:47:51,0,0,0,0,0,0
2,201392387,2170660915,22663,36895,2024-10-04 19:47:51,0,0,0,0,0,0
2,201392387,2170660915,0,0,2024-10-04 19:47:51,128,84,212,1,1,2
2,201392387,2170660915,39639,36895,2024-10-04 19:47:52,0,0,0,0,0,0
2,201392387,2170660915,22663,36895,2024-10-04 19:47:52,0,0,0,0,0,0
2,201392387,2170660915,0,0,2024-10-04 19:47:52,0,0,0,0,0,0
2,201392387,2170660915,39639,36895,2024-10-04 19:47:53,0,0,0,0,0,0
2,201392387,2170660915,22663,36895,2024-10-04 19:47:53,0,0,0,0,0,0
2,201392387,2170660915,0,0,2024-10-04 19:47:53,0,0,0,0,0,0
2,201392387,2170660915,39639,36895,2024-10-04 19:47:54,0,0,0,0,0,0
2,201392387,2170660915,22663,36895,2024-10-04 19:47:54,0,0,0,0,0,0
2,201392387,2170660915,0,0,2024-10-04 19:47:54,128,0,128,1,0,1
2,201392387,2170660915,39639,36895,2024-10-04 19:47:55,0,0,0,0,0,0
2,201392387,2170660915,22663,36895,2024-10-04 19:47:55,0,0,0,0,0,0
2,201392387,2170660915,0,0,2024-10-04 19:47:55,0,84,84,0,1,1
2,201392387,2170660915,39639,36895,2024-10-04 19:47:56,0,0,0,0,0,0
2,201392387,2170660915,22663,36895,2024-10-04 19:47:56,0,0,0,0,0,0
2,201392387,2170660915,0,0,2024-10-04 19:47:56,128,84,212,1,1,2
2,201392387,2170660915,39639,36895,2024-10-04 19:47:57,0,0,0,0,0,0
2,201392387,1145490690,61139,47873,2024-10-04 19:47:57,2424,21395,23819,16,23,39
2,201392387,2170660915,22663,36895,2024-10-04 19:47:57,0,0,0,0,0,0
2,201392387,2170660915,0,0,2024-10-04 19:47:57,128,84,212,1,1,2
2,201392387,2170660915,39639,36895,2024-10-04 19:47:58,0,0,0,0,0,0
2,201392387,1145490690,61139,47873,2024-10-04 19:47:58,3756,73839,77595,37,53,90
2,201392387,2170660915,22663,36895,2024-10-04 19:47:58,0,0,0,0,0,0
2,201392387,2170660915,0,0,2024-10-04 19:47:58,0,0,0,0,0,0
2,201392387,2170660915,39639,36895,2024-10-04 19:47:59,0,0,0,0,0,0
2,201392387,1145490690,61139,47873,2024-10-04 19:47:59,0,0,0,0,0,0
2,201392387,2170660915,22663,36895,2024-10-04 19:47:59,0,0,0,0,0,0
2,201392387,2170660915,0,0,2024-10-04 19:47:59,0,0,0,0,0,0
2,201392387,2170660915,39639,36895,2024-10-04 19:48:00,0,0,0,0,0,0
2,201392387,1145490690,61139,47873,2024-10-04 19:48:00,0,0,0,0,0,0
2,201392387,2170660915,22663,36895,2024-10-04 19:48:00,0,0,0,0,0,0
2,201392387,2170660915,0,0,2024-10-04 19:48:00,0,0,0,0,0,0
2,201392387,2170660915,39639,36895,2024-10-04 19:48:01,0,0,0,0,0,0
2,201392387,1145490690,61139,47873,2024-10-04 19:48:01,0,0,0,0,0,0
2,201392387,2170660915,22663,36895,2024-10-04 19:48:01,0,0,0,0,0,0
2,201392387,2170660915,0,0,2024-10-04 19:48:01,0,0,0,0,0,0
2,201392387,2170660915,39639,36895,2024-10-04 19:48:02,0,0,0,0,0,0
2,201392387,1145490690,61139,47873,2024-10-04 19:48:02,0,0,0,0,0,0
2,201392387,2170660915,22663,36895,2024-10-04 19:48:02,0,0,0,0,0,0
2,201392387,2170660915,0,0,2024-10-04 19:48:02,0,0,0,0,0,0
2,201392387,2170660915,39639,36895,2024-10-04 19:48:03,0,0,0,0,0,0
2,201392387,1145490690,61139,47873,2024-10-04 19:48:03,0,0,0,0,0,0
2,201392387,2170660915,22663,36895,2024-10-04 19:48:03,0,0,0,0,0,0
2,201392387,2170660915,0,0,2024-10-04 19:48:03,0,0,0,0,0,0
2,201392387,2170660915,39639,36895,2024-10-04 19:48:04,0,0,0,0,0,0
2,201392387,1145490690,61139,47873,2024-10-04 19:48:04,0,0,0,0,0,0
2,201392387,2170660915,22663,36895,2024-10-04 19:48:04,0,0,0,0,0,0
2,201392387,2170660915,0,0,2024-10-04 19:48:04,0,0,0,0,0,0
2,201392387,2170660915,39639,36895,2024-10-04 19:48:05,0,0,0,0,0,0
2,201392387,1145490690,61139,47873,2024-10-04 19:48:05,0,0,0,0,0,0
2,201392387,2170660915,22663,36895,2024-10-04 19:48:05,0,0,0,0,0,0
2,201392387,2170660915,0,0,2024-10-04 19:48:05,0,0,0,0,0,0
2,201392387,2170660915,39639,36895,2024-10-04 19:48:06,0,0,0,0,0,0
2,201392387,1145490690,61139,47873,2024-10-04 19:48:06,0,0,0,0,0,0
2,201392387,2170660915,22663,36895,2024-10-04 19:48:06,0,0,0,0,0,0
2,201392387,2170660915,0,0,2024-10-04 19:48:06,0,0,0,0,0,0
2,201392387,2170660915,39639,36895,2024-10-04 19:48:07,0,0,0,0,0,0
2,201392387,1145490690,61139,47873,2024-10-04 19:48:07,0,0,0,0,0,0
2,201392387,2170660915,22663,36895,2024-10-04 19:48:07,0,0,0,0,0,0
2,201392387,2170660915,0,0,2024-10-04 19:48:07,0,0,0,0,0,0
2,201392387,2170660915,39639,36895,2024-10-04 19:48:08,0,0,0,0,0,0
2,201392387,1145490690,61139,47873,2024-10-04 19:48:08,0,0,0,0,0,0
2,201392387,2170660915,22663,36895,2024-10-04 19:48:08,0,0,0,0,0,0
2,201392387,2170660915,0,0,2024-10-04 19:48:08,0,0,0,0,0,0
2,201392387,2170660915,39639,36895,2024-10-04 19:48:09,0,0,0,0,0,0
2,201392387,1145490690,61139,47873,2024-10-04 19:48:09,0,0,0,0,0,0
2,201392387,2170660915,22663,36895,2024-10-04 19:48:09,0,0,0,0,0,0
2,201392387,2170660915,0,0,2024-10-04 19:48:09,128,84,212,1,1,2
2,201392387,2170660915,39639,36895,2024-10-04 19:48:10,0,0,0,0,0,0
2,201392387,1145490690,61139,47873,2024-10-04 19:48:10,0,0,0,0,0,0
2,201392387,2170660915,22663,36895,2024-10-04 19:48:10,0,0,0,0,0,0
2,201392387,2170660915,0,0,2024-10-04 19:48:10,128,84,212,1,1,2
1,2673446010,201392386,47873,61162,2024-10-04 19:19:00,0,104,104,0,1,1
4,2673446010,201392389,47873,45711,2024-10-04 19:19:01,60,200,260,1,2,3
2,2673446010,201392387,47873,43757,2024-10-04 19:19:01,2760,1759,4519,4,10,14
3,2673446010,201392388,47873,55461,2024-10-04 19:19:01,2146,813,2959,3,3,6
1,2673446010,201392386,47873,61162,2024-10-04 19:19:01,6468,1794,8262,9,10,19
4,2673446010,201392389,47873,45711,2024-10-04 19:19:02,9789,2115,11904,10,13,23
2,2673446010,201392387,47873,43757,2024-10-04 19:19:02,4398,787,5185,11,8,19
3,2673446010,201392388,47873,55461,2024-10-04 19:19:02,6932,1565,8497,10,13,23
1,2673446010,201392386,47873,61162,2024-10-04 19:19:02,2622,480,3102,4,5,9
4,2673446010,201392389,47873,45711,2024-10-04 19:19:03,128,168,296,2,2,4
2,2673446010,201392387,47873,43757,2024-10-04 19:19:03,0,0,0,0,0,0
3,2673446010,201392388,47873,55461,2024-10-04 19:19:03,0,0,0,0,0,0
1,2673446010,201392386,47873,61162,2024-10-04 19:19:03,0,0,0,0,0,0
4,2673446010,201392389,47873,45711,2024-10-04 19:19:04,0,0,0,0,0,0
2,2673446010,201392387,47873,43757,2024-10-04 19:19:04,0,0,0,0,0,0
3,2673446010,201392388,47873,55461,2024-10-04 19:19:04,0,0,0,0,0,0
1,2673446010,201392386,47873,61162,2024-10-04 19:19:04,0,0,0,0,0,0
4,2673446010,201392389,47873,45711,2024-10-04 19:19:05,0,0,0,0,0,0
2,2673446010,201392387,47873,43757,2024-10-04 19:19:05,0,0,0,0,0,0
3,2673446010,201392388,47873,55461,2024-10-04 19:19:05,0,0,0,0,0,0
1,2673446010,201392386,47873,61162,2024-10-04 19:19:05,0,0,0,0,0,0
4,2673446010,201392389,47873,45711,2024-10-04 19:19:06,0,0,0,0,0,0
2,2673446010,201392387,47873,43757,2024-10-04 19:19:06,0,0,0,0,0,0
3,2673446010,201392388,47873,55461,2024-10-04 19:19:06,0,0,0,0,0,0
1,2673446010,201392386,47873,61162,2024-10-04 19:19:06,0,0,0,0,0,0
4,2673446010,201392389,47873,45711,2024-10-04 19:19:07,0,0,0,0,0,0
2,2673446010,201392387,47873,43757,2024-10-04 19:19:07,0,0,0,0,0,0
3,2673446010,201392388,47873,55461,2024-10-04 19:19:07,0,0,0,0,0,0
1,2673446010,201392386,47873,61162,2024-10-04 19:19:07,0,0,0,0,0,0
4,2673446010,201392389,47873,45711,2024-10-04 19:19:08,0,0,0,0,0,0
2,2673446010,201392387,47873,43757,2024-10-04 19:19:08,0,0,0,0,0,0
3,2673446010,201392388,47873,55461,2024-10-04 19:19:08,0,0,0,0,0,0
1,2673446010,201392386,47873,61162,2024-10-04 19:19:08,0,0,0,0,0,0
4,2673446010,201392389,47873,45711,2024-10-04 19:19:09,0,0,0,0,0,0
2,2673446010,201392387,47873,43757,2024-10-04 19:19:09,0,0,0,0,0,0
3,2673446010,201392388,47873,55461,2024-10-04 19:19:09,0,0,0,0,0,0
1,2673446010,201392386,47873,61162,2024-10-04 19:19:09,0,0,0,0,0,0
2,2673446010,201392387,47873,43757,2024-10-04 19:19:10,0,0,0,0,0,0
1,2673446010,201392386,47873,61162,2024-10-04 19:19:10,0,0,0,0,0,0
1,2673446010,201392386,47873,61162,2024-10-04 19:19:11,0,0,0,0,0,0
4,2673446010,201392389,47873,35049,2024-10-04 19:19:14,6064,2447,8511,14,17,31
4,2673446010,201392389,47873,35049,2024-10-04 19:19:15,0,0,0,0,0,0
4,2673446010,201392389,47873,35049,2024-10-04 19:19:16,0,0,0,0,0,0
4,2673446010,201392389,47873,35049,2024-10-04 19:19:17,0,0,0,0,0,0
4,2673446010,201392389,47873,35049,2024-10-04 19:19:18,0,0,0,0,0,0
4,2673446010,201392389,47873,35049,2024-10-04 19:19:19,0,0,0,0,0,0
4,2673446010,201392389,47873,35049,2024-10-04 19:19:20,0,0,0,0,0,0
4,2673446010,201392389,47873,35049,2024-10-04 19:19:21,0,0,0,0,0,0
4,2673446010,201392389,47873,35049,2024-10-04 19:19:22,0,0,0,0,0,0
4,2673446010,201392389,47873,13993,2024-10-04 19:19:23,4901,1768,6669,6,10,16
4,2673446010,201392389,47873,13993,2024-10-04 19:19:24,0,0,0,0,0,0
4,2673446010,201392389,47873,13993,2024-10-04 19:19:25,3063,799,3862,6,8,14
4,2673446010,201392389,47873,13993,2024-10-04 19:19:26,0,0,0,0,0,0
4,2673446010,201392389,47873,13993,2024-10-04 19:19:27,0,0,0,0,0,0
4,2673446010,201392389,47873,13993,2024-10-04 19:19:28,0,0,0,0,0,0
4,2673446010,201392389,47873,13993,2024-10-04 19:19:29,0,0,0,0,0,0
4,2673446010,201392389,47873,13993,2024-10-04 19:19:30,0,0,0,0,0,0
4,2673446010,201392389,47873,13993,2024-10-04 19:19:31,0,0,0,0,0,0
2,2673446010,201392387,47873,16041,2024-10-04 19:19:32,2146,813,2959,3,3,6
1,2673446010,201392386,47873,32994,2024-10-04 19:19:32,4794,921,5715,5,4,9
2,2673446010,201392387,47873,16041,2024-10-04 19:19:33,6919,1853,8772,10,16,26
3,2673446010,201392388,47873,18628,2024-10-04 19:19:33,3374,813,4187,4,3,7
1,2673446010,201392386,47873,32994,2024-10-04 19:19:33,6295,1673,7968,9,14,23
2,2673446010,201392387,47873,16041,2024-10-04 19:19:34,0,0,0,0,0,0
3,2673446010,201392388,47873,18628,2024-10-04 19:19:34,0,0,0,0,0,0
1,2673446010,201392386,47873,32994,2024-10-04 19:19:34,0,0,0,0,0,0
2,2673446010,201392387,47873,16041,2024-10-04 19:19:35,0,0,0,0,0,0
3,2673446010,201392388,47873,18628,2024-10-04 19:19:35,7808,1781,9589,11,15,26
1,2673446010,201392386,47873,32994,2024-10-04 19:19:35,0,0,0,0,0,0
2,2673446010,201392387,47873,16041,2024-10-04 19:19:36,0,0,0,0,0,0
3,2673446010,201392388,47873,18628,2024-10-04 19:19:36,0,0,0,0,0,0
1,2673446010,201392386,47873,32994,2024-10-04 19:19:36,0,0,0,0,0,0
2,2673446010,201392387,47873,16041,2024-10-04 19:19:37,0,0,0,0,0,0
3,2673446010,201392388,47873,18628,2024-10-04 19:19:37,0,0,0,0,0,0
1,2673446010,201392386,47873,32994,2024-10-04 19:19:37,0,0,0,0,0,0
2,2673446010,201392387,47873,16041,2024-10-04 19:19:38,0,0,0,0,0,0
3,2673446010,201392388,47873,18628,2024-10-04 19:19:38,0,0,0,0,0,0
1,2673446010,201392386,47873,32994,2024-10-04 19:19:38,0,0,0,0,0,0
2,2673446010,201392387,47873,16041,2024-10-04 19:19:39,0,0,0,0,0,0
3,2673446010,201392388,47873,18628,2024-10-04 19:19:39,0,0,0,0,0,0
1,2673446010,201392386,47873,32994,2024-10-04 19:19:39,0,0,0,0,0,0
2,2673446010,201392387,47873,16041,2024-10-04 19:19:40,0,0,0,0,0,0
3,2673446010,201392388,47873,18628,2024-10-04 19:19:40,0,0,0,0,0,0
1,2673446010,201392386,47873,32994,2024-10-04 19:19:40,0,0,0,0,0,0
2,2673446010,201392387,47873,16041,2024-10-04 19:19:41,0,0,0,0,0,0
3,2673446010,201392388,47873,18628,2024-10-04 19:19:41,0,0,0,0,0,0
1,2673446010,201392386,47873,32994,2024-10-04 19:19:41,0,0,0,0,0,0
1,2673446010,201392386,47873,32994,2024-10-04 19:19:42,0,0,0,0,0,0
2,2673446010,201392387,47873,13474,2024-10-04 19:20:03,0,104,104,0,1,1
1,2673446010,201392386,47873,2249,2024-10-04 19:20:04,8155,2006,10161,11,12,23
2,2673446010,201392387,47873,13474,2024-10-04 19:20:04,7346,2730,10076,16,20,36
3,2673446010,201392388,47873,34466,2024-10-04 19:20:04,60,104,164,1,1,2
1,2673446010,201392386,47873,2249,2024-10-04 19:20:05,3124,672,3796,7,7,14
2,2673446010,201392387,47873,13474,2024-10-04 19:20:05,0,0,0,0,0,0
3,2673446010,201392388,47873,34466,2024-10-04 19:20:05,9162,2574,11736,15,18,33
1,2673446010,201392386,47873,2249,2024-10-04 19:20:06,0,0,0,0,0,0
2,2673446010,201392387,47873,13474,2024-10-04 19:20:06,0,0,0,0,0,0
3,2673446010,201392388,47873,34466,2024-10-04 19:20:06,0,0,0,0,0,0
1,2673446010,201392386,47873,2249,2024-10-04 19:20:07,0,0,0,0,0,0
2,2673446010,201392387,47873,13474,2024-10-04 19:20:07,0,0,0,0,0,0
3,2673446010,201392388,47873,34466,2024-10-04 19:20:07,0,0,0,0,0,0
1,2673446010,201392386,47873,2249,2024-10-04 19:20:08,0,0,0,0,0,0
2,2673446010,201392387,47873,13474,2024-10-04 19:20:08,0,0,0,0,0,0
3,2673446010,201392388,47873,34466,2024-10-04 19:20:08,0,0,0,0,0,0
1,2673446010,201392386,47873,2249,2024-10-04 19:20:09,0,0,0,0,0,0
2,2673446010,201392387,47873,13474,2024-10-04 19:20:09,0,0,0,0,0,0
3,2673446010,201392388,47873,34466,2024-10-04 19:20:09,0,0,0,0,0,0
1,2673446010,201392386,47873,2249,2024-10-04 19:20:10,0,0,0,0,0,0
2,2673446010,201392387,47873,13474,2024-10-04 19:20:10,0,0,0,0,0,0
3,2673446010,201392388,47873,34466,2024-10-04 19:20:10,0,0,0,0,0,0
1,2673446010,201392386,47873,2249,2024-10-04 19:20:11,0,0,0,0,0,0
2,2673446010,201392387,47873,13474,2024-10-04 19:20:11,0,0,0,0,0,0
3,2673446010,201392388,47873,34466,2024-10-04 19:20:11,0,0,0,0,0,0
1,2673446010,201392386,47873,2249,2024-10-04 19:20:12,0,0,0,0,0,0
2,2673446010,201392387,47873,13474,2024-10-04 19:20:12,0,0,0,0,0,0
3,2673446010,201392388,47873,34466,2024-10-04 19:20:12,0,0,0,0,0,0
2,2673446010,201392387,47873,13474,2024-10-04 19:20:13,0,0,0,0,0,0
2,2673446010,201392387,47873,3793,2024-10-04 19:20:34,0,104,104,0,1,1
3,2673446010,201392388,47873,25299,2024-10-04 19:20:34,7114,2462,9576,14,17,31
1,2673446010,201392386,47873,39593,2024-10-04 19:20:35,2812,1759,4571,5,10,15
2,2673446010,201392387,47873,3793,2024-10-04 19:20:35,9111,2478,11589,15,17,32
3,2673446010,201392388,47873,25299,2024-10-04 19:20:35,0,0,0,0,0,0
1,2673446010,201392386,47873,39593,2024-10-04 19:20:36,4388,787,5175,10,8,18
2,2673446010,201392387,47873,3793,2024-10-04 19:20:36,0,0,0,0,0,0
3,2673446010,201392388,47873,25299,2024-10-04 19:20:36,0,0,0,0,0,0
1,2673446010,201392386,47873,39593,2024-10-04 19:20:37,0,0,0,0,0,0
2,2673446010,201392387,47873,3793,2024-10-04 19:20:37,0,0,0,0,0,0
3,2673446010,201392388,47873,25299,2024-10-04 19:20:37,0,0,0,0,0,0
1,2673446010,201392386,47873,39593,2024-10-04 19:20:38,0,0,0,0,0,0
2,2673446010,201392387,47873,3793,2024-10-04 19:20:38,0,0,0,0,0,0
3,2673446010,201392388,47873,25299,2024-10-04 19:20:38,0,0,0,0,0,0
1,2673446010,201392386,47873,39593,2024-10-04 19:20:39,0,0,0,0,0,0
2,2673446010,201392387,47873,3793,2024-10-04 19:20:39,0,0,0,0,0,0
3,2673446010,201392388,47873,25299,2024-10-04 19:20:39,0,0,0,0,0,0
1,2673446010,201392386,47873,39593,2024-10-04 19:20:40,0,0,0,0,0,0
2,2673446010,201392387,47873,3793,2024-10-04 19:20:40,0,0,0,0,0,0
3,2673446010,201392388,47873,25299,2024-10-04 19:20:40,0,0,0,0,0,0
1,2673446010,201392386,47873,39593,2024-10-04 19:20:41,0,0,0,0,0,0
2,2673446010,201392387,47873,3793,2024-10-04 19:20:41,0,0,0,0,0,0
3,2673446010,201392388,47873,25299,2024-10-04 19:20:41,0,0,0,0,0,0
1,2673446010,201392386,47873,39593,2024-10-04 19:20:42,0,0,0,0,0,0
2,2673446010,201392387,47873,3793,2024-10-04 19:20:42,0,0,0,0,0,0
3,2673446010,201392388,47873,25299,2024-10-04 19:20:42,0,0,0,0,0,0
2,2673446010,201392387,47873,3793,2024-10-04 19:20:43,0,0,0,0,0,0
3,2673446010,201392388,47873,25299,2024-10-04 19:20:43,0,0,0,0,0,0
3,2673446010,201392388,47873,8354,2024-10-04 19:21:03,60,813,873,1,3,4
1,2673446010,201392386,47873,2712,2024-10-04 19:21:04,0,104,104,0,1,1
3,2673446010,201392388,47873,8354,2024-10-04 19:21:04,9055,1853,10908,12,16,28
2,2673446010,201392387,47873,37096,2024-10-04 19:21:04,2146,813,2959,3,3,6
1,2673446010,201392386,47873,2712,2024-10-04 19:21:05,0,0,0,0,0,0
3,2673446010,201392388,47873,8354,2024-10-04 19:21:05,0,0,0,0,0,0
2,2673446010,201392387,47873,37096,2024-10-04 19:21:05,0,0,0,0,0,0
1,2673446010,201392386,47873,2712,2024-10-04 19:21:06,9364,2658,12022,18,19,37
3,2673446010,201392388,47873,8354,2024-10-04 19:21:06,0,0,0,0,0,0
2,2673446010,201392387,47873,37096,2024-10-04 19:21:06,9014,1877,10891,11,16,27
1,2673446010,201392386,47873,2712,2024-10-04 19:21:07,0,0,0,0,0,0
3,2673446010,201392388,47873,8354,2024-10-04 19:21:07,0,0,0,0,0,0
2,2673446010,201392387,47873,37096,2024-10-04 19:21:07,0,0,0,0,0,0
1,2673446010,201392386,47873,2712,2024-10-04 19:21:08,0,0,0,0,0,0
3,2673446010,201392388,47873,8354,2024-10-04 19:21:08,0,0,0,0,0,0
2,2673446010,201392387,47873,37096,2024-10-04 19:21:08,0,0,0,0,0,0
1,2673446010,201392386,47873,2712,2024-10-04 19:21:09,0,0,0,0,0,0
3,2673446010,201392388,47873,8354,2024-10-04 19:21:09,0,0,0,0,0,0
2,2673446010,201392387,47873,37096,2024-10-04 19:21:09,0,0,0,0,0,0
1,2673446010,201392386,47873,2712,2024-10-04 19:21:10,0,0,0,0,0,0
2,2673446010,201392387,47873,37096,2024-10-04 19:21:10,0,0,0,0,0,0
1,2673446010,201392386,47873,2712,2024-10-04 19:21:11,0,0,0,0,0,0
2,2673446010,201392387,47873,37096,2024-10-04 19:21:11,0,0,0,0,0,0
1,2673446010,201392386,47873,2712,2024-10-04 19:21:12,0,0,0,0,0,0
2,2673446010,201392387,47873,37096,2024-10-04 19:21:12,0,0,0,0,0,0
1,2673446010,201392386,47873,2712,2024-10-04 19:21:13,0,0,0,0,0,0
3,2673446010,201392388,47873,30344,2024-10-04 19:21:34,0,104,104,0,1,1
2,2673446010,201392387,47873,27373,2024-10-04 19:21:35,60,104,164,1,1,2
3,2673446010,201392388,47873,30344,2024-10-04 19:21:35,11285,2586,13871,18,18,36
1,2673446010,201392386,47873,36530,2024-10-04 19:21:35,9101,2678,11779,14,19,33
2,2673446010,201392387,47873,27373,2024-10-04 19:21:36,7150,2358,9508,13,16,29
3,2673446010,201392388,47873,30344,2024-10-04 19:21:36,0,0,0,0,0,0
1,2673446010,201392386,47873,36530,2024-10-04 19:21:36,0,0,0,0,0,0
2,2673446010,201392387,47873,27373,2024-10-04 19:21:37,0,0,0,0,0,0
3,2673446010,201392388,47873,30344,2024-10-04 19:21:37,0,0,0,0,0,0
1,2673446010,201392386,47873,36530,2024-10-04 19:21:37,0,0,0,0,0,0
2,2673446010,201392387,47873,27373,2024-10-04 19:21:38,0,0,0,0,0,0
3,2673446010,201392388,47873,30344,2024-10-04 19:21:38,0,0,0,0,0,0
1,2673446010,201392386,47873,36530,2024-10-04 19:21:38,0,0,0,0,0,0
2,2673446010,201392387,47873,27373,2024-10-04 19:21:39,0,0,0,0,0,0
3,2673446010,201392388,47873,30344,2024-10-04 19:21:39,0,0,0,0,0,0
1,2673446010,201392386,47873,36530,2024-10-04 19:21:39,0,0,0,0,0,0
2,2673446010,201392387,47873,27373,2024-10-04 19:21:40,0,0,0,0,0,0
3,2673446010,201392388,47873,30344,2024-10-04 19:21:40,0,0,0,0,0,0
1,2673446010,201392386,47873,36530,2024-10-04 19:21:40,0,0,0,0,0,0
2,2673446010,201392387,47873,27373,2024-10-04 19:21:41,0,0,0,0,0,0
3,2673446010,201392388,47873,30344,2024-10-04 19:21:41,0,0,0,0,0,0
1,2673446010,201392386,47873,36530,2024-10-04 19:21:41,0,0,0,0,0,0
2,2673446010,201392387,47873,27373,2024-10-04 19:21:42,0,0,0,0,0,0
3,2673446010,201392388,47873,30344,2024-10-04 19:21:42,0,0,0,0,0,0
1,2673446010,201392386,47873,36530,2024-10-04 19:21:42,0,0,0,0,0,0
2,2673446010,201392387,47873,27373,2024-10-04 19:21:43,0,0,0,0,0,0
3,2673446010,201392388,47873,30344,2024-10-04 19:21:43,0,0,0,0,0,0
1,2673446010,201392386,47873,36530,2024-10-04 19:21:43,0,0,0,0,0,0
1,2673446010,201392386,47873,32896,2024-10-04 19:22:05,60,200,260,1,2,3
3,2673446010,201392388,47873,30400,2024-10-04 19:22:05,9054,2294,11348,13,15,28
2,2673446010,201392387,47873,5259,2024-10-04 19:22:06,9290,2678,11968,16,19,35
1,2673446010,201392386,47873,32896,2024-10-04 19:22:06,7095,2262,9357,14,15,29
3,2673446010,201392388,47873,30400,2024-10-04 19:22:06,128,480,608,2,5,7
2,2673446010,201392387,47873,5259,2024-10-04 19:22:07,0,0,0,0,0,0
1,2673446010,201392386,47873,32896,2024-10-04 19:22:07,0,0,0,0,0,0
3,2673446010,201392388,47873,30400,2024-10-04 19:22:07,0,0,0,0,0,0
2,2673446010,201392387,47873,5259,2024-10-04 19:22:08,0,0,0,0,0,0
1,2673446010,201392386,47873,32896,2024-10-04 19:22:08,0,0,0,0,0,0
3,2673446010,201392388,47873,30400,2024-10-04 19:22:08,0,0,0,0,0,0
2,2673446010,201392387,47873,5259,2024-10-04 19:22:09,0,0,0,0,0,0
1,2673446010,201392386,47873,32896,2024-10-04 19:22:09,0,0,0,0,0,0
3,2673446010,201392388,47873,30400,2024-10-04 19:22:09,0,0,0,0,0,0
2,2673446010,201392387,47873,5259,2024-10-04 19:22:10,0,0,0,0,0,0
1,2673446010,201392386,47873,32896,2024-10-04 19:22:10,0,0,0,0,0,0
3,2673446010,201392388,47873,30400,2024-10-04 19:22:10,0,0,0,0,0,0
2,2673446010,201392387,47873,5259,2024-10-04 19:22:11,0,0,0,0,0,0
1,2673446010,201392386,47873,32896,2024-10-04 19:22:11,0,0,0,0,0,0
3,2673446010,201392388,47873,30400,2024-10-04 19:22:11,0,0,0,0,0,0
2,2673446010,201392387,47873,5259,2024-10-04 19:22:12,0,0,0,0,0,0
1,2673446010,201392386,47873,32896,2024-10-04 19:22:12,0,0,0,0,0,0
3,2673446010,201392388,47873,30400,2024-10-04 19:22:12,0,0,0,0,0,0
2,2673446010,201392387,47873,5259,2024-10-04 19:22:13,0,0,0,0,0,0
1,2673446010,201392386,47873,32896,2024-10-04 19:22:13,0,0,0,0,0,0
3,2673446010,201392388,47873,30400,2024-10-04 19:22:13,0,0,0,0,0,0
3,2673446010,201392388,47873,30400,2024-10-04 19:22:14,0,0,0,0,0,0
3,2673446010,201392388,47873,54984,2024-10-04 19:22:35,0,104,104,0,1,1
2,2673446010,201392387,47873,59544,2024-10-04 19:22:36,60,813,873,1,3,4
1,2673446010,201392386,47873,51920,2024-10-04 19:22:36,9124,2606,11730,15,18,33
3,2673446010,201392388,47873,54984,2024-10-04 19:22:36,9645,2202,11847,13,14,27
2,2673446010,201392387,47873,59544,2024-10-04 19:22:37,7125,1649,8774,14,14,28
1,2673446010,201392386,47873,51920,2024-10-04 19:22:37,128,168,296,2,2,4
3,2673446010,201392388,47873,54984,2024-10-04 19:22:37,1600,480,2080,4,5,9
2,2673446010,201392387,47873,59544,2024-10-04 19:22:38,0,0,0,0,0,0
1,2673446010,201392386,47873,51920,2024-10-04 19:22:38,0,0,0,0,0,0
3,2673446010,201392388,47873,54984,2024-10-04 19:22:38,0,0,0,0,0,0
2,2673446010,201392387,47873,59544,2024-10-04 19:22:39,0,0,0,0,0,0
1,2673446010,201392386,47873,51920,2024-10-04 19:22:39,0,0,0,0,0,0
3,2673446010,201392388,47873,54984,2024-10-04 19:22:39,0,0,0,0,0,0
2,2673446010,201392387,47873,59544,2024-10-04 19:22:40,0,0,0,0,0,0
1,2673446010,201392386,47873,51920,2024-10-04 19:22:40,0,0,0,0,0,0
3,2673446010,201392388,47873,54984,2024-10-04 19:22:40,0,0,0,0,0,0
2,2673446010,201392387,47873,59544,2024-10-04 19:22:41,0,0,0,0,0,0
1,2673446010,201392386,47873,51920,2024-10-04 19:22:41,0,0,0,0,0,0
3,2673446010,201392388,47873,54984,2024-10-04 19:22:41,0,0,0,0,0,0
2,2673446010,201392387,47873,59544,2024-10-04 19:22:42,0,0,0,0,0,0
1,2673446010,201392386,47873,51920,2024-10-04 19:22:42,0,0,0,0,0,0
3,2673446010,201392388,47873,54984,2024-10-04 19:22:42,0,0,0,0,0,0
2,2673446010,201392387,47873,59544,2024-10-04 19:22:43,0,0,0,0,0,0
1,2673446010,201392386,47873,51920,2024-10-04 19:22:43,0,0,0,0,0,0
3,2673446010,201392388,47873,54984,2024-10-04 19:22:43,0,0,0,0,0,0
2,2673446010,201392387,47873,59544,2024-10-04 19:22:44,0,0,0,0,0,0
1,2673446010,201392386,47873,51920,2024-10-04 19:22:44,0,0,0,0,0,0
3,2673446010,201392388,47873,54984,2024-10-04 19:22:44,0,0,0,0,0,0
2,2673446010,201392387,47873,32942,2024-10-04 19:23:06,0,104,104,0,1,1
1,2673446010,201392386,47873,51342,2024-10-04 19:23:07,3374,813,4187,4,3,7
2,2673446010,201392387,47873,32942,2024-10-04 19:23:07,7164,2358,9522,14,16,30
3,2673446010,201392388,47873,1208,2024-10-04 19:23:08,9286,2666,11952,17,19,36
1,2673446010,201392386,47873,51342,2024-10-04 19:23:08,5856,1757,7613,12,15,27
2,2673446010,201392387,47873,32942,2024-10-04 19:23:08,0,0,0,0,0,0
3,2673446010,201392388,47873,1208,2024-10-04 19:23:09,0,0,0,0,0,0
1,2673446010,201392386,47873,51342,2024-10-04 19:23:09,0,0,0,0,0,0
2,2673446010,201392387,47873,32942,2024-10-04 19:23:09,0,0,0,0,0,0
3,2673446010,201392388,47873,1208,2024-10-04 19:23:10,0,0,0,0,0,0
1,2673446010,201392386,47873,51342,2024-10-04 19:23:10,0,0,0,0,0,0
2,2673446010,201392387,47873,32942,2024-10-04 19:23:10,0,0,0,0,0,0
3,2673446010,201392388,47873,1208,2024-10-04 19:23:11,0,0,0,0,0,0
1,2673446010,201392386,47873,51342,2024-10-04 19:23:11,0,0,0,0,0,0
2,2673446010,201392387,47873,32942,2024-10-04 19:23:11,0,0,0,0,0,0
3,2673446010,201392388,47873,1208,2024-10-04 19:23:12,0,0,0,0,0,0
1,2673446010,201392386,47873,51342,2024-10-04 19:23:12,0,0,0,0,0,0
2,2673446010,201392387,47873,32942,2024-10-04 19:23:12,0,0,0,0,0,0
3,2673446010,201392388,47873,1208,2024-10-04 19:23:13,0,0,0,0,0,0
1,2673446010,201392386,47873,51342,2024-10-04 19:23:13,0,0,0,0,0,0
2,2673446010,201392387,47873,32942,2024-10-04 19:23:13,0,0,0,0,0,0
3,2673446010,201392388,47873,1208,2024-10-04 19:23:14,0,0,0,0,0,0
1,2673446010,201392386,47873,51342,2024-10-04 19:23:14,0,0,0,0,0,0
2,2673446010,201392387,47873,32942,2024-10-04 19:23:14,0,0,0,0,0,0
3,2673446010,201392388,47873,1208,2024-10-04 19:23:15,0,0,0,0,0,0
1,2673446010,201392386,47873,51342,2024-10-04 19:23:15,0,0,0,0,0,0
2,2673446010,201392387,47873,32942,2024-10-04 19:23:15,0,0,0,0,0,0
2,2673446010,201392387,47873,32942,2024-10-04 19:23:16,0,0,0,0,0,0
2,2673446010,201392387,47873,40162,2024-10-04 19:23:37,4953,1771,6724,7,10,17
1,2673446010,201392386,47873,15577,2024-10-04 19:23:38,11372,2690,14062,18,19,37
3,2673446010,201392388,47873,41638,2024-10-04 19:23:38,7202,2294,9496,14,15,29
2,2673446010,201392387,47873,40162,2024-10-04 19:23:38,4219,979,5198,8,10,18
1,2673446010,201392386,47873,15577,2024-10-04 19:23:39,0,0,0,0,0,0
3,2673446010,201392388,47873,41638,2024-10-04 19:23:39,128,168,296,2,2,4
2,2673446010,201392387,47873,40162,2024-10-04 19:23:39,0,0,0,0,0,0
1,2673446010,201392386,47873,15577,2024-10-04 19:23:40,0,0,0,0,0,0
3,2673446010,201392388,47873,41638,2024-10-04 19:23:40,0,0,0,0,0,0
2,2673446010,201392387,47873,40162,2024-10-04 19:23:40,0,0,0,0,0,0
1,2673446010,201392386,47873,15577,2024-10-04 19:23:41,0,0,0,0,0,0
3,2673446010,201392388,47873,41638,2024-10-04 19:23:41,0,0,0,0,0,0
2,2673446010,201392387,47873,40162,2024-10-04 19:23:41,0,0,0,0,0,0
1,2673446010,201392386,47873,15577,2024-10-04 19:23:42,0,0,0,0,0,0
3,2673446010,201392388,47873,41638,2024-10-04 19:23:42,0,0,0,0,0,0
2,2673446010,201392387,47873,40162,2024-10-04 19:23:42,0,0,0,0,0,0
1,2673446010,201392386,47873,15577,2024-10-04 19:23:43,0,0,0,0,0,0
3,2673446010,201392388,47873,41638,2024-10-04 19:23:43,0,0,0,0,0,0
2,2673446010,201392387,47873,40162,2024-10-04 19:23:43,0,0,0,0,0,0
1,2673446010,201392386,47873,15577,2024-10-04 19:23:44,0,0,0,0,0,0
3,2673446010,201392388,47873,41638,2024-10-04 19:23:44,0,0,0,0,0,0
2,2673446010,201392387,47873,40162,2024-10-04 19:23:44,0,0,0,0,0,0
1,2673446010,201392386,47873,15577,2024-10-04 19:23:45,0,0,0,0,0,0
2,2673446010,201392387,47873,40162,2024-10-04 19:23:45,0,0,0,0,0,0
2,2673446010,201392387,47873,2239,2024-10-04 19:24:07,0,104,104,0,1,1
2,2673446010,201392387,47873,2239,2024-10-04 19:24:08,11342,2586,13928,18,18,36
1,2673446010,201392386,47873,28304,2024-10-04 19:24:08,0,104,104,0,1,1
2,2673446010,201392387,47873,2239,2024-10-04 19:24:09,0,0,0,0,0,0
3,2673446010,201392388,47873,39132,2024-10-04 19:24:09,4902,1771,6673,6,10,16
1,2673446010,201392386,47873,28304,2024-10-04 19:24:09,4794,1667,6461,5,9,14
2,2673446010,201392387,47873,2239,2024-10-04 19:24:10,0,0,0,0,0,0
3,2673446010,201392388,47873,39132,2024-10-04 19:24:10,6295,823,7118,8,8,16
1,2673446010,201392386,47873,28304,2024-10-04 19:24:10,6338,823,7161,9,8,17
2,2673446010,201392387,47873,2239,2024-10-04 19:24:11,0,0,0,0,0,0
3,2673446010,201392388,47873,39132,2024-10-04 19:24:11,0,0,0,0,0,0
1,2673446010,201392386,47873,28304,2024-10-04 19:24:11,0,0,0,0,0,0
2,2673446010,201392387,47873,2239,2024-10-04 19:24:12,0,0,0,0,0,0
3,2673446010,201392388,47873,39132,2024-10-04 19:24:12,0,0,0,0,0,0
1,2673446010,201392386,47873,28304,2024-10-04 19:24:12,0,0,0,0,0,0
2,2673446010,201392387,47873,2239,2024-10-04 19:24:13,0,0,0,0,0,0
3,2673446010,201392388,47873,39132,2024-10-04 19:24:13,0,0,0,0,0,0
1,2673446010,201392386,47873,28304,2024-10-04 19:24:13,0,0,0,0,0,0
2,2673446010,201392387,47873,2239,2024-10-04 19:24:14,0,0,0,0,0,0
3,2673446010,201392388,47873,39132,2024-10-04 19:24:14,0,0,0,0,0,0
1,2673446010,201392386,47873,28304,2024-10-04 19:24:14,0,0,0,0,0,0
2,2673446010,201392387,47873,2239,2024-10-04 19:24:15,0,0,0,0,0,0
3,2673446010,201392388,47873,39132,2024-10-04 19:24:15,0,0,0,0,0,0
1,2673446010,201392386,47873,28304,2024-10-04 19:24:15,0,0,0,0,0,0
2,2673446010,201392387,47873,2239,2024-10-04 19:24:16,0,0,0,0,0,0
3,2673446010,201392388,47873,39132,2024-10-04 19:24:16,0,0,0,0,0,0
1,2673446010,201392386,47873,28304,2024-10-04 19:24:16,0,0,0,0,0,0
2,2673446010,201392387,47873,2239,2024-10-04 19:24:17,0,0,0,0,0,0
3,2673446010,201392388,47873,39132,2024-10-04 19:24:17,0,0,0,0,0,0
3,2673446010,201392388,47873,20183,2024-10-04 19:24:38,0,104,104,0,1,1
3,2673446010,201392388,47873,20183,2024-10-04 19:24:39,9260,2682,11942,17,19,36
1,2673446010,201392386,47873,40153,2024-10-04 19:24:39,3373,813,4186,4,3,7
2,2673446010,201392387,47873,5351,2024-10-04 19:24:39,3374,921,4295,4,4,8
3,2673446010,201392388,47873,20183,2024-10-04 19:24:40,0,0,0,0,0,0
1,2673446010,201392386,47873,40153,2024-10-04 19:24:40,0,0,0,0,0,0
2,2673446010,201392387,47873,5351,2024-10-04 19:24:40,0,0,0,0,0,0
3,2673446010,201392388,47873,20183,2024-10-04 19:24:41,0,0,0,0,0,0
1,2673446010,201392386,47873,40153,2024-10-04 19:24:41,7867,1865,9732,13,16,29
2,2673446010,201392387,47873,5351,2024-10-04 19:24:41,5643,1457,7100,9,12,21
3,2673446010,201392388,47873,20183,2024-10-04 19:24:42,0,0,0,0,0,0
1,2673446010,201392386,47873,40153,2024-10-04 19:24:42,0,0,0,0,0,0
2,2673446010,201392387,47873,5351,2024-10-04 19:24:42,0,0,0,0,0,0
3,2673446010,201392388,47873,20183,2024-10-04 19:24:43,0,0,0,0,0,0
1,2673446010,201392386,47873,40153,2024-10-04 19:24:43,0,0,0,0,0,0
2,2673446010,201392387,47873,5351,2024-10-04 19:24:43,0,0,0,0,0,0
3,2673446010,201392388,47873,20183,2024-10-04 19:24:44,0,0,0,0,0,0
1,2673446010,201392386,47873,40153,2024-10-04 19:24:44,0,0,0,0,0,0
2,2673446010,201392387,47873,5351,2024-10-04 19:24:44,0,0,0,0,0,0
3,2673446010,201392388,47873,20183,2024-10-04 19:24:45,0,0,0,0,0,0
1,2673446010,201392386,47873,40153,2024-10-04 19:24:45,0,0,0,0,0,0
2,2673446010,201392387,47873,5351,2024-10-04 19:24:45,0,0,0,0,0,0
3,2673446010,201392388,47873,20183,2024-10-04 19:24:46,0,0,0,0,0,0
1,2673446010,201392386,47873,40153,2024-10-04 19:24:46,0,0,0,0,0,0
2,2673446010,201392387,47873,5351,2024-10-04 19:24:46,0,0,0,0,0,0
3,2673446010,201392388,47873,20183,2024-10-04 19:24:47,0,0,0,0,0,0
1,2673446010,201392386,47873,40153,2024-10-04 19:24:47,0,0,0,0,0,0
2,2673446010,201392387,47873,5351,2024-10-04 19:24:47,0,0,0,0,0,0
3,2673446010,201392388,47873,20183,2024-10-04 19:24:48,0,0,0,0,0,0
3,2673446010,201392388,47873,20183,2024-10-04 19:24:49,0,0,0,0,0,0
3,2673446010,201392388,47873,20183,2024-10-04 19:24:50,0,0,0,0,0,0
3,2673446010,201392388,47873,20183,2024-10-04 19:24:51,0,0,0,0,0,0
3,2673446010,201392388,47873,20183,2024-10-04 19:24:52,0,0,0,0,0,0
3,2673446010,201392388,47873,20183,2024-10-04 19:24:53,0,0,0,0,0,0
3,2673446010,201392388,47873,20183,2024-10-04 19:24:54,0,0,0,0,0,0
3,2673446010,201392388,47873,20183,2024-10-04 19:24:55,0,0,0,0,0,0
3,2673446010,201392388,47873,20183,2024-10-04 19:24:56,0,0,0,0,0,0
3,2673446010,201392388,47873,20183,2024-10-04 19:24:57,0,0,0,0,0,0
3,2673446010,201392388,47873,20183,2024-10-04 19:24:58,0,0,0,0,0,0
3,2673446010,201392388,47873,20183,2024-10-04 19:24:59,0,0,0,0,0,0
3,2673446010,201392388,47873,20183,2024-10-04 19:25:00,0,0,0,0,0,0
3,2673446010,201392388,47873,20183,2024-10-04 19:25:01,0,0,0,0,0,0
3,2673446010,201392388,47873,20183,2024-10-04 19:25:02,0,0,0,0,0,0
3,2673446010,201392388,47873,20183,2024-10-04 19:25:03,0,0,0,0,0,0
3,2673446010,201392388,47873,20183,2024-10-04 19:25:04,0,0,0,0,0,0
3,2673446010,201392388,47873,20183,2024-10-04 19:25:05,0,0,0,0,0,0
3,2673446010,201392388,47873,20183,2024-10-04 19:25:06,0,0,0,0,0,0
3,2673446010,201392388,47873,20183,2024-10-04 19:25:07,0,0,0,0,0,0
3,2673446010,201392388,47873,20183,2024-10-04 19:25:08,0,0,0,0,0,0
3,2673446010,201392388,47873,20183,2024-10-04 19:25:09,0,0,0,0,0,0
2,2673446010,201392387,47873,40655,2024-10-04 19:25:09,60,104,164,1,1,2
1,2673446010,201392386,47873,55015,2024-10-04 19:25:09,0,104,104,0,1,1
3,2673446010,201392388,47873,5264,2024-10-04 19:25:09,7229,2462,9691,16,17,33
3,2673446010,201392388,47873,20183,2024-10-04 19:25:10,0,0,0,0,0,0
2,2673446010,201392387,47873,40655,2024-10-04 19:25:10,0,0,0,0,0,0
1,2673446010,201392386,47873,55015,2024-10-04 19:25:10,0,0,0,0,0,0
3,2673446010,201392388,47873,5264,2024-10-04 19:25:10,0,0,0,0,0,0
2,2673446010,201392387,47873,40655,2024-10-04 19:25:11,9119,2574,11693,14,18,32
1,2673446010,201392386,47873,55015,2024-10-04 19:25:11,9308,2478,11786,17,17,34
3,2673446010,201392388,47873,5264,2024-10-04 19:25:11,0,0,0,0,0,0
2,2673446010,201392387,47873,40655,2024-10-04 19:25:12,0,0,0,0,0,0
1,2673446010,201392386,47873,55015,2024-10-04 19:25:12,0,0,0,0,0,0
3,2673446010,201392388,47873,5264,2024-10-04 19:25:12,0,0,0,0,0,0
2,2673446010,201392387,47873,40655,2024-10-04 19:25:13,0,0,0,0,0,0
1,2673446010,201392386,47873,55015,2024-10-04 19:25:13,0,0,0,0,0,0
3,2673446010,201392388,47873,5264,2024-10-04 19:25:13,0,0,0,0,0,0
2,2673446010,201392387,47873,40655,2024-10-04 19:25:14,0,0,0,0,0,0
1,2673446010,201392386,47873,55015,2024-10-04 19:25:14,0,0,0,0,0,0
3,2673446010,201392388,47873,5264,2024-10-04 19:25:14,0,0,0,0,0,0
2,2673446010,201392387,47873,40655,2024-10-04 19:25:15,0,0,0,0,0,0
1,2673446010,201392386,47873,55015,2024-10-04 19:25:15,0,0,0,0,0,0
3,2673446010,201392388,47873,5264,2024-10-04 19:25:15,0,0,0,0,0,0
2,2673446010,201392387,47873,40655,2024-10-04 19:25:16,0,0,0,0,0,0
1,2673446010,201392386,47873,55015,2024-10-04 19:25:16,0,0,0,0,0,0
3,2673446010,201392388,47873,5264,2024-10-04 19:25:16,0,0,0,0,0,0
2,2673446010,201392387,47873,40655,2024-10-04 19:25:17,0,0,0,0,0,0
1,2673446010,201392386,47873,55015,2024-10-04 19:25:17,0,0,0,0,0,0
3,2673446010,201392388,47873,5264,2024-10-04 19:25:17,0,0,0,0,0,0
1,2673446010,201392386,47873,55015,2024-10-04 19:25:18,0,0,0,0,0,0
3,2673446010,201392388,47873,5264,2024-10-04 19:25:18,0,0,0,0,0,0
2,2673446010,201392387,47873,36527,2024-10-04 19:25:39,0,104,104,0,1,1
1,2673446010,201392386,47873,43188,2024-10-04 19:25:40,3373,813,4186,4,3,7
3,2673446010,201392388,47873,8938,2024-10-04 19:25:40,7183,2462,9645,14,17,31
2,2673446010,201392387,47873,36527,2024-10-04 19:25:40,8999,2190,11189,12,14,26
1,2673446010,201392386,47873,43188,2024-10-04 19:25:41,0,0,0,0,0,0
3,2673446010,201392388,47873,8938,2024-10-04 19:25:41,0,0,0,0,0,0
2,2673446010,201392387,47873,36527,2024-10-04 19:25:41,0,0,0,0,0,0
1,2673446010,201392386,47873,43188,2024-10-04 19:25:42,7746,1781,9527,10,15,25
3,2673446010,201392388,47873,8938,2024-10-04 19:25:42,0,0,0,0,0,0
2,2673446010,201392387,47873,36527,2024-10-04 19:25:42,0,0,0,0,0,0
1,2673446010,201392386,47873,43188,2024-10-04 19:25:43,0,0,0,0,0,0
3,2673446010,201392388,47873,8938,2024-10-04 19:25:43,0,0,0,0,0,0
2,2673446010,201392387,47873,36527,2024-10-04 19:25:43,0,0,0,0,0,0
1,2673446010,201392386,47873,43188,2024-10-04 19:25:44,0,0,0,0,0,0
3,2673446010,201392388,47873,8938,2024-10-04 19:25:44,0,0,0,0,0,0
2,2673446010,201392387,47873,36527,2024-10-04 19:25:44,0,0,0,0,0,0
1,2673446010,201392386,47873,43188,2024-10-04 19:25:45,0,0,0,0,0,0
3,2673446010,201392388,47873,8938,2024-10-04 19:25:45,0,0,0,0,0,0
2,2673446010,201392387,47873,36527,2024-10-04 19:25:45,0,0,0,0,0,0
1,2673446010,201392386,47873,43188,2024-10-04 19:25:46,0,0,0,0,0,0
3,2673446010,201392388,47873,8938,2024-10-04 19:25:46,0,0,0,0,0,0
2,2673446010,201392387,47873,36527,2024-10-04 19:25:46,0,0,0,0,0,0
1,2673446010,201392386,47873,43188,2024-10-04 19:25:47,0,0,0,0,0,0
3,2673446010,201392388,47873,8938,2024-10-04 19:25:47,0,0,0,0,0,0
2,2673446010,201392387,47873,36527,2024-10-04 19:25:47,0,0,0,0,0,0
1,2673446010,201392386,47873,43188,2024-10-04 19:25:48,0,0,0,0,0,0
3,2673446010,201392388,47873,8938,2024-10-04 19:25:48,0,0,0,0,0,0
2,2673446010,201392387,47873,36527,2024-10-04 19:25:48,0,0,0,0,0,0
3,2673446010,201392388,47873,8938,2024-10-04 19:25:49,0,0,0,0,0,0
3,2673446010,201392388,47873,18049,2024-10-04 19:26:09,0,104,104,0,1,1
2,2673446010,201392387,47873,43704,2024-10-04 19:26:09,0,104,104,0,1,1
3,2673446010,201392388,47873,18049,2024-10-04 19:26:10,9113,2562,11675,13,18,31
2,2673446010,201392387,47873,43704,2024-10-04 19:26:10,7148,2358,9506,15,16,31
3,2673446010,201392388,47873,18049,2024-10-04 19:26:11,0,0,0,0,0,0
2,2673446010,201392387,47873,43704,2024-10-04 19:26:11,0,0,0,0,0,0
1,2673446010,201392386,47873,46269,2024-10-04 19:26:11,0,104,104,0,1,1
3,2673446010,201392388,47873,18049,2024-10-04 19:26:12,0,0,0,0,0,0
2,2673446010,201392387,47873,43704,2024-10-04 19:26:12,0,0,0,0,0,0
1,2673446010,201392386,47873,46269,2024-10-04 19:26:12,9334,2478,11812,16,17,33
3,2673446010,201392388,47873,18049,2024-10-04 19:26:13,0,0,0,0,0,0
2,2673446010,201392387,47873,43704,2024-10-04 19:26:13,0,0,0,0,0,0
1,2673446010,201392386,47873,46269,2024-10-04 19:26:13,0,0,0,0,0,0
3,2673446010,201392388,47873,18049,2024-10-04 19:26:14,0,0,0,0,0,0
2,2673446010,201392387,47873,43704,2024-10-04 19:26:14,0,0,0,0,0,0
1,2673446010,201392386,47873,46269,2024-10-04 19:26:14,0,0,0,0,0,0
3,2673446010,201392388,47873,18049,2024-10-04 19:26:15,0,0,0,0,0,0
2,2673446010,201392387,47873,43704,2024-10-04 19:26:15,0,0,0,0,0,0
1,2673446010,201392386,47873,46269,2024-10-04 19:26:15,0,0,0,0,0,0
3,2673446010,201392388,47873,18049,2024-10-04 19:26:16,0,0,0,0,0,0
2,2673446010,201392387,47873,43704,2024-10-04 19:26:16,0,0,0,0,0,0
1,2673446010,201392386,47873,46269,2024-10-04 19:26:16,0,0,0,0,0,0
3,2673446010,201392388,47873,18049,2024-10-04 19:26:17,0,0,0,0,0,0
2,2673446010,201392387,47873,43704,2024-10-04 19:26:17,0,0,0,0,0,0
1,2673446010,201392386,47873,46269,2024-10-04 19:26:17,0,0,0,0,0,0
3,2673446010,201392388,47873,18049,2024-10-04 19:26:18,0,0,0,0,0,0
2,2673446010,201392387,47873,43704,2024-10-04 19:26:18,0,0,0,0,0,0
2,2673446010,201392387,47873,43704,2024-10-04 19:26:19,0,0,0,0,0,0
2,2673446010,201392387,47873,43704,2024-10-04 19:26:20,0,0,0,0,0,0
3,2673446010,201392388,47873,6871,2024-10-04 19:26:40,2955,1759,4714,6,10,16
2,2673446010,201392387,47873,39144,2024-10-04 19:26:41,3374,813,4187,4,3,7
3,2673446010,201392388,47873,6871,2024-10-04 19:26:41,4295,619,4914,9,6,15
2,2673446010,201392387,47873,39144,2024-10-04 19:26:42,7801,1865,9666,12,16,28
3,2673446010,201392388,47873,6871,2024-10-04 19:26:42,0,0,0,0,0,0
1,2673446010,201392386,47873,56462,2024-10-04 19:26:42,3375,921,4296,4,4,8
2,2673446010,201392387,47873,39144,2024-10-04 19:26:43,0,0,0,0,0,0
3,2673446010,201392388,47873,6871,2024-10-04 19:26:43,0,0,0,0,0,0
1,2673446010,201392386,47873,56462,2024-10-04 19:26:43,5753,1457,7210,10,12,22
2,2673446010,201392387,47873,39144,2024-10-04 19:26:44,0,0,0,0,0,0
3,2673446010,201392388,47873,6871,2024-10-04 19:26:44,0,0,0,0,0,0
1,2673446010,201392386,47873,56462,2024-10-04 19:26:44,0,0,0,0,0,0
2,2673446010,201392387,47873,39144,2024-10-04 19:26:45,0,0,0,0,0,0
3,2673446010,201392388,47873,6871,2024-10-04 19:26:45,0,0,0,0,0,0
1,2673446010,201392386,47873,56462,2024-10-04 19:26:45,0,0,0,0,0,0
2,2673446010,201392387,47873,39144,2024-10-04 19:26:46,0,0,0,0,0,0
3,2673446010,201392388,47873,6871,2024-10-04 19:26:46,0,0,0,0,0,0
1,2673446010,201392386,47873,56462,2024-10-04 19:26:46,0,0,0,0,0,0
2,2673446010,201392387,47873,39144,2024-10-04 19:26:47,0,0,0,0,0,0
3,2673446010,201392388,47873,6871,2024-10-04 19:26:47,0,0,0,0,0,0
1,2673446010,201392386,47873,56462,2024-10-04 19:26:47,0,0,0,0,0,0
2,2673446010,201392387,47873,39144,2024-10-04 19:26:48,0,0,0,0,0,0
3,2673446010,201392388,47873,6871,2024-10-04 19:26:48,0,0,0,0,0,0
1,2673446010,201392386,47873,56462,2024-10-04 19:26:48,0,0,0,0,0,0
2,2673446010,201392387,47873,39144,2024-10-04 19:26:49,0,0,0,0,0,0
3,2673446010,201392388,47873,6871,2024-10-04 19:26:49,0,0,0,0,0,0
2,2673446010,201392387,47873,39144,2024-10-04 19:26:50,0,0,0,0,0,0
3,2673446010,201392388,47873,6871,2024-10-04 19:26:50,0,0,0,0,0,0
3,2673446010,201392388,47873,6871,2024-10-04 19:26:51,0,0,0,0,0,0
3,2673446010,201392388,47873,6871,2024-10-04 19:26:52,0,0,0,0,0,0
3,2673446010,201392388,47873,6871,2024-10-04 19:26:53,0,0,0,0,0,0
3,2673446010,201392388,47873,6871,2024-10-04 19:26:54,0,0,0,0,0,0
3,2673446010,201392388,47873,6871,2024-10-04 19:26:55,0,0,0,0,0,0
3,2673446010,201392388,47873,6871,2024-10-04 19:26:56,0,0,0,0,0,0
3,2673446010,201392388,47873,6871,2024-10-04 19:26:57,0,0,0,0,0,0
3,2673446010,201392388,47873,6871,2024-10-04 19:26:58,0,0,0,0,0,0
3,2673446010,201392388,47873,6871,2024-10-04 19:26:59,0,0,0,0,0,0
3,2673446010,201392388,47873,6871,2024-10-04 19:27:00,0,0,0,0,0,0
3,2673446010,201392388,47873,6871,2024-10-04 19:27:01,0,0,0,0,0,0
3,2673446010,201392388,47873,6871,2024-10-04 19:27:02,0,0,0,0,0,0
3,2673446010,201392388,47873,6871,2024-10-04 19:27:03,0,0,0,0,0,0
3,2673446010,201392388,47873,6871,2024-10-04 19:27:04,0,0,0,0,0,0
3,2673446010,201392388,47873,6871,2024-10-04 19:27:05,0,0,0,0,0,0
3,2673446010,201392388,47873,6871,2024-10-04 19:27:06,0,0,0,0,0,0
3,2673446010,201392388,47873,6871,2024-10-04 19:27:07,0,0,0,0,0,0
3,2673446010,201392388,47873,6871,2024-10-04 19:27:08,0,0,0,0,0,0
3,2673446010,201392388,47873,6871,2024-10-04 19:27:09,0,0,0,0,0,0
3,2673446010,201392388,47873,6871,2024-10-04 19:27:10,0,0,0,0,0,0
3,2673446010,201392388,47873,6871,2024-10-04 19:27:11,0,0,0,0,0,0
3,2673446010,201392388,47873,60038,2024-10-04 19:27:11,4794,921,5715,5,4,9
3,2673446010,201392388,47873,6871,2024-10-04 19:27:12,0,0,0,0,0,0
3,2673446010,201392388,47873,60038,2024-10-04 19:27:12,6266,1589,7855,8,13,21
2,2673446010,201392387,47873,23774,2024-10-04 19:27:12,2146,813,2959,3,3,6
1,2673446010,201392386,47873,64706,2024-10-04 19:27:13,0,104,104,0,1,1
3,2673446010,201392388,47873,60038,2024-10-04 19:27:13,0,0,0,0,0,0
2,2673446010,201392387,47873,23774,2024-10-04 19:27:13,6950,1853,8803,10,16,26
1,2673446010,201392386,47873,64706,2024-10-04 19:27:14,0,0,0,0,0,0
3,2673446010,201392388,47873,60038,2024-10-04 19:27:14,0,0,0,0,0,0
2,2673446010,201392387,47873,23774,2024-10-04 19:27:14,0,0,0,0,0,0
1,2673446010,201392386,47873,64706,2024-10-04 19:27:15,9098,2574,11672,14,18,32
3,2673446010,201392388,47873,60038,2024-10-04 19:27:15,0,0,0,0,0,0
2,2673446010,201392387,47873,23774,2024-10-04 19:27:15,0,0,0,0,0,0
1,2673446010,201392386,47873,64706,2024-10-04 19:27:16,0,0,0,0,0,0
3,2673446010,201392388,47873,60038,2024-10-04 19:27:16,0,0,0,0,0,0
2,2673446010,201392387,47873,23774,2024-10-04 19:27:16,0,0,0,0,0,0
1,2673446010,201392386,47873,64706,2024-10-04 19:27:17,0,0,0,0,0,0
3,2673446010,201392388,47873,60038,2024-10-04 19:27:17,0,0,0,0,0,0
2,2673446010,201392387,47873,23774,2024-10-04 19:27:17,0,0,0,0,0,0
1,2673446010,201392386,47873,64706,2024-10-04 19:27:18,0,0,0,0,0,0
3,2673446010,201392388,47873,60038,2024-10-04 19:27:18,0,0,0,0,0,0
2,2673446010,201392387,47873,23774,2024-10-04 19:27:18,0,0,0,0,0,0
1,2673446010,201392386,47873,64706,2024-10-04 19:27:19,0,0,0,0,0,0
2,2673446010,201392387,47873,23774,2024-10-04 19:27:19,0,0,0,0,0,0
1,2673446010,201392386,47873,64706,2024-10-04 19:27:20,0,0,0,0,0,0
2,2673446010,201392387,47873,23774,2024-10-04 19:27:20,0,0,0,0,0,0
2,2673446010,201392387,47873,23774,2024-10-04 19:27:21,0,0,0,0,0,0
3,2673446010,201392388,47873,13476,2024-10-04 19:27:41,7623,1994,9617,13,12,25
3,2673446010,201392388,47873,13476,2024-10-04 19:27:42,1600,588,2188,4,6,10
3,2673446010,201392388,47873,13476,2024-10-04 19:27:43,0,0,0,0,0,0
2,2673446010,201392387,47873,22680,2024-10-04 19:27:44,60,104,164,1,1,2
1,2673446010,201392386,47873,1725,2024-10-04 19:27:44,9205,2582,11787,16,18,34
3,2673446010,201392388,47873,13476,2024-10-04 19:27:44,0,0,0,0,0,0
2,2673446010,201392387,47873,22680,2024-10-04 19:27:45,0,0,0,0,0,0
1,2673446010,201392386,47873,1725,2024-10-04 19:27:45,0,0,0,0,0,0
3,2673446010,201392388,47873,13476,2024-10-04 19:27:45,0,0,0,0,0,0
2,2673446010,201392387,47873,22680,2024-10-04 19:27:46,11071,2670,13741,14,19,33
1,2673446010,201392386,47873,1725,2024-10-04 19:27:46,0,0,0,0,0,0
3,2673446010,201392388,47873,13476,2024-10-04 19:27:46,0,0,0,0,0,0
2,2673446010,201392387,47873,22680,2024-10-04 19:27:47,0,0,0,0,0,0
1,2673446010,201392386,47873,1725,2024-10-04 19:27:47,0,0,0,0,0,0
3,2673446010,201392388,47873,13476,2024-10-04 19:27:47,0,0,0,0,0,0
2,2673446010,201392387,47873,22680,2024-10-04 19:27:48,0,0,0,0,0,0
1,2673446010,201392386,47873,1725,2024-10-04 19:27:48,0,0,0,0,0,0
3,2673446010,201392388,47873,13476,2024-10-04 19:27:48,0,0,0,0,0,0
2,2673446010,201392387,47873,22680,2024-10-04 19:27:49,0,0,0,0,0,0
1,2673446010,201392386,47873,1725,2024-10-04 19:27:49,0,0,0,0,0,0
3,2673446010,201392388,47873,13476,2024-10-04 19:27:49,0,0,0,0,0,0
2,2673446010,201392387,47873,22680,2024-10-04 19:27:50,0,0,0,0,0,0
3,2673446010,201392388,47873,13476,2024-10-04 19:27:50,0,0,0,0,0,0
2,2673446010,201392387,47873,22680,2024-10-04 19:27:51,0,0,0,0,0,0
3,2673446010,201392388,47873,13476,2024-10-04 19:27:51,0,0,0,0,0,0
2,2673446010,201392387,47873,22680,2024-10-04 19:27:52,0,0,0,0,0,0
3,2673446010,201392388,47873,13476,2024-10-04 19:27:52,0,0,0,0,0,0
3,2673446010,201392388,47873,13476,2024-10-04 19:27:53,0,0,0,0,0,0
3,2673446010,201392388,47873,13476,2024-10-04 19:27:54,0,0,0,0,0,0
3,2673446010,201392388,47873,13476,2024-10-04 19:27:55,0,0,0,0,0,0
3,2673446010,201392388,47873,13476,2024-10-04 19:27:56,0,0,0,0,0,0
3,2673446010,201392388,47873,13476,2024-10-04 19:27:57,0,0,0,0,0,0
3,2673446010,201392388,47873,13476,2024-10-04 19:27:58,0,0,0,0,0,0
3,2673446010,201392388,47873,13476,2024-10-04 19:27:59,0,0,0,0,0,0
3,2673446010,201392388,47873,13476,2024-10-04 19:28:00,0,0,0,0,0,0
3,2673446010,201392388,47873,13476,2024-10-04 19:28:01,0,0,0,0,0,0
3,2673446010,201392388,47873,13476,2024-10-04 19:28:02,0,0,0,0,0,0
3,2673446010,201392388,47873,13476,2024-10-04 19:28:03,0,0,0,0,0,0
3,2673446010,201392388,47873,13476,2024-10-04 19:28:04,0,0,0,0,0,0
3,2673446010,201392388,47873,13476,2024-10-04 19:28:05,0,0,0,0,0,0
3,2673446010,201392388,47873,13476,2024-10-04 19:28:06,0,0,0,0,0,0
3,2673446010,201392388,47873,13476,2024-10-04 19:28:07,0,0,0,0,0,0
3,2673446010,201392388,47873,13476,2024-10-04 19:28:08,0,0,0,0,0,0
3,2673446010,201392388,47873,13476,2024-10-04 19:28:09,0,0,0,0,0,0
3,2673446010,201392388,47873,13476,2024-10-04 19:28:10,0,0,0,0,0,0
3,2673446010,201392388,47873,13036,2024-10-04 19:28:11,4793,921,5714,5,4,9
3,2673446010,201392388,47873,13476,2024-10-04 19:28:11,0,0,0,0,0,0
3,2673446010,201392388,47873,13036,2024-10-04 19:28:12,0,0,0,0,0,0
3,2673446010,201392388,47873,13476,2024-10-04 19:28:12,0,0,0,0,0,0
3,2673446010,201392388,47873,13036,2024-10-04 19:28:13,6266,1673,7939,9,14,23
3,2673446010,201392388,47873,13476,2024-10-04 19:28:13,0,0,0,0,0,0
1,2673446010,201392386,47873,42200,2024-10-04 19:28:14,60,813,873,1,3,4
3,2673446010,201392388,47873,13036,2024-10-04 19:28:14,0,0,0,0,0,0
3,2673446010,201392388,47873,13476,2024-10-04 19:28:14,0,0,0,0,0,0
1,2673446010,201392386,47873,42200,2024-10-04 19:28:15,9132,1649,10781,13,14,27
3,2673446010,201392388,47873,13036,2024-10-04 19:28:15,0,0,0,0,0,0
2,2673446010,201392387,47873,31455,2024-10-04 19:28:15,0,104,104,0,1,1
3,2673446010,201392388,47873,13476,2024-10-04 19:28:15,0,0,0,0,0,0
1,2673446010,201392386,47873,42200,2024-10-04 19:28:16,0,0,0,0,0,0
3,2673446010,201392388,47873,13036,2024-10-04 19:28:16,0,0,0,0,0,0
2,2673446010,201392387,47873,31455,2024-10-04 19:28:16,0,0,0,0,0,0
3,2673446010,201392388,47873,13476,2024-10-04 19:28:16,0,0,0,0,0,0
1,2673446010,201392386,47873,42200,2024-10-04 19:28:17,0,0,0,0,0,0
3,2673446010,201392388,47873,13036,2024-10-04 19:28:17,0,0,0,0,0,0
2,2673446010,201392387,47873,31455,2024-10-04 19:28:17,11218,2490,13708,15,17,32
1,2673446010,201392386,47873,42200,2024-10-04 19:28:18,0,0,0,0,0,0
3,2673446010,201392388,47873,13036,2024-10-04 19:28:18,0,0,0,0,0,0
2,2673446010,201392387,47873,31455,2024-10-04 19:28:18,0,0,0,0,0,0
1,2673446010,201392386,47873,42200,2024-10-04 19:28:19,0,0,0,0,0,0
3,2673446010,201392388,47873,13036,2024-10-04 19:28:19,0,0,0,0,0,0
2,2673446010,201392387,47873,31455,2024-10-04 19:28:19,0,0,0,0,0,0
1,2673446010,201392386,47873,42200,2024-10-04 19:28:20,0,0,0,0,0,0
3,2673446010,201392388,47873,13036,2024-10-04 19:28:20,0,0,0,0,0,0
2,2673446010,201392387,47873,31455,2024-10-04 19:28:20,0,0,0,0,0,0
1,2673446010,201392386,47873,42200,2024-10-04 19:28:21,0,0,0,0,0,0
3,2673446010,201392388,47873,13036,2024-10-04 19:28:21,0,0,0,0,0,0
2,2673446010,201392387,47873,31455,2024-10-04 19:28:21,0,0,0,0,0,0
1,2673446010,201392386,47873,42200,2024-10-04 19:28:22,0,0,0,0,0,0
3,2673446010,201392388,47873,13036,2024-10-04 19:28:22,0,0,0,0,0,0
2,2673446010,201392387,47873,31455,2024-10-04 19:28:22,0,0,0,0,0,0
1,2673446010,201392386,47873,42200,2024-10-04 19:28:23,0,0,0,0,0,0
3,2673446010,201392388,47873,13036,2024-10-04 19:28:23,0,0,0,0,0,0
2,2673446010,201392387,47873,31455,2024-10-04 19:28:23,0,0,0,0,0,0
1,2673446010,201392386,47873,42200,2024-10-04 19:28:24,0,0,0,0,0,0
3,2673446010,201392388,47873,13036,2024-10-04 19:28:24,0,0,0,0,0,0
2,2673446010,201392387,47873,31455,2024-10-04 19:28:24,0,0,0,0,0,0
1,2673446010,201392386,47873,42200,2024-10-04 19:28:25,0,0,0,0,0,0
3,2673446010,201392388,47873,13036,2024-10-04 19:28:25,0,0,0,0,0,0
1,2673446010,201392386,47873,42200,2024-10-04 19:28:26,0,0,0,0,0,0
3,2673446010,201392388,47873,13036,2024-10-04 19:28:26,0,0,0,0,0,0
1,2673446010,201392386,47873,42200,2024-10-04 19:28:27,0,0,0,0,0,0
3,2673446010,201392388,47873,13036,2024-10-04 19:28:27,0,0,0,0,0,0
1,2673446010,201392386,47873,42200,2024-10-04 19:28:28,0,0,0,0,0,0
3,2673446010,201392388,47873,13036,2024-10-04 19:28:28,0,0,0,0,0,0
1,2673446010,201392386,47873,42200,2024-10-04 19:28:29,0,0,0,0,0,0
3,2673446010,201392388,47873,13036,2024-10-04 19:28:29,0,0,0,0,0,0
1,2673446010,201392386,47873,42200,2024-10-04 19:28:30,0,0,0,0,0,0
3,2673446010,201392388,47873,13036,2024-10-04 19:28:30,0,0,0,0,0,0
1,2673446010,201392386,47873,42200,2024-10-04 19:28:31,0,0,0,0,0,0
3,2673446010,201392388,47873,13036,2024-10-04 19:28:31,0,0,0,0,0,0
1,2673446010,201392386,47873,42200,2024-10-04 19:28:32,0,0,0,0,0,0
3,2673446010,201392388,47873,13036,2024-10-04 19:28:32,0,0,0,0,0,0
1,2673446010,201392386,47873,42200,2024-10-04 19:28:33,0,0,0,0,0,0
3,2673446010,201392388,47873,13036,2024-10-04 19:28:33,0,0,0,0,0,0
1,2673446010,201392386,47873,42200,2024-10-04 19:28:34,0,0,0,0,0,0
3,2673446010,201392388,47873,13036,2024-10-04 19:28:34,0,0,0,0,0,0
1,2673446010,201392386,47873,42200,2024-10-04 19:28:35,0,0,0,0,0,0
3,2673446010,201392388,47873,13036,2024-10-04 19:28:35,0,0,0,0,0,0
1,2673446010,201392386,47873,42200,2024-10-04 19:28:36,0,0,0,0,0,0
3,2673446010,201392388,47873,13036,2024-10-04 19:28:36,0,0,0,0,0,0
1,2673446010,201392386,47873,42200,2024-10-04 19:28:37,0,0,0,0,0,0
3,2673446010,201392388,47873,13036,2024-10-04 19:28:37,0,0,0,0,0,0
1,2673446010,201392386,47873,42200,2024-10-04 19:28:38,0,0,0,0,0,0
3,2673446010,201392388,47873,13036,2024-10-04 19:28:38,0,0,0,0,0,0
1,2673446010,201392386,47873,42200,2024-10-04 19:28:39,0,0,0,0,0,0
3,2673446010,201392388,47873,13036,2024-10-04 19:28:39,0,0,0,0,0,0
1,2673446010,201392386,47873,42200,2024-10-04 19:28:40,0,0,0,0,0,0
3,2673446010,201392388,47873,13036,2024-10-04 19:28:40,0,0,0,0,0,0
1,2673446010,201392386,47873,42200,2024-10-04 19:28:41,0,0,0,0,0,0
3,2673446010,201392388,47873,13036,2024-10-04 19:28:41,0,0,0,0,0,0
3,2673446010,201392388,47873,11433,2024-10-04 19:28:41,0,104,104,0,1,1
1,2673446010,201392386,47873,42200,2024-10-04 19:28:42,0,0,0,0,0,0
3,2673446010,201392388,47873,13036,2024-10-04 19:28:42,0,0,0,0,0,0
3,2673446010,201392388,47873,11433,2024-10-04 19:28:42,11088,2010,13098,13,12,25
3,2673446010,201392388,47873,13036,2024-10-04 19:28:43,0,0,0,0,0,0
3,2673446010,201392388,47873,11433,2024-10-04 19:28:43,128,480,608,2,5,7
3,2673446010,201392388,47873,13036,2024-10-04 19:28:44,0,0,0,0,0,0
3,2673446010,201392388,47873,11433,2024-10-04 19:28:44,0,0,0,0,0,0
1,2673446010,201392386,47873,56532,2024-10-04 19:28:45,60,104,164,1,1,2
3,2673446010,201392388,47873,13036,2024-10-04 19:28:45,0,0,0,0,0,0
3,2673446010,201392388,47873,11433,2024-10-04 19:28:45,0,0,0,0,0,0
1,2673446010,201392386,47873,56532,2024-10-04 19:28:46,0,0,0,0,0,0
3,2673446010,201392388,47873,13036,2024-10-04 19:28:46,0,0,0,0,0,0
3,2673446010,201392388,47873,11433,2024-10-04 19:28:46,0,0,0,0,0,0
1,2673446010,201392386,47873,56532,2024-10-04 19:28:47,8998,2274,11272,12,15,27
2,2673446010,201392387,47873,8393,2024-10-04 19:28:47,7081,2462,9543,14,17,31
3,2673446010,201392388,47873,11433,2024-10-04 19:28:47,0,0,0,0,0,0
1,2673446010,201392386,47873,56532,2024-10-04 19:28:48,0,0,0,0,0,0
2,2673446010,201392387,47873,8393,2024-10-04 19:28:48,0,0,0,0,0,0
3,2673446010,201392388,47873,11433,2024-10-04 19:28:48,0,0,0,0,0,0
1,2673446010,201392386,47873,56532,2024-10-04 19:28:49,0,0,0,0,0,0
2,2673446010,201392387,47873,8393,2024-10-04 19:28:49,0,0,0,0,0,0
3,2673446010,201392388,47873,11433,2024-10-04 19:28:49,0,0,0,0,0,0
1,2673446010,201392386,47873,56532,2024-10-04 19:28:50,0,0,0,0,0,0
2,2673446010,201392387,47873,8393,2024-10-04 19:28:50,0,0,0,0,0,0
3,2673446010,201392388,47873,11433,2024-10-04 19:28:50,0,0,0,0,0,0
1,2673446010,201392386,47873,56532,2024-10-04 19:28:51,0,0,0,0,0,0
2,2673446010,201392387,47873,8393,2024-10-04 19:28:51,0,0,0,0,0,0
3,2673446010,201392388,47873,11433,2024-10-04 19:28:51,0,0,0,0,0,0
1,2673446010,201392386,47873,56532,2024-10-04 19:28:52,0,0,0,0,0,0
2,2673446010,201392387,47873,8393,2024-10-04 19:28:52,0,0,0,0,0,0
3,2673446010,201392388,47873,11433,2024-10-04 19:28:52,0,0,0,0,0,0
1,2673446010,201392386,47873,56532,2024-10-04 19:28:53,0,0,0,0,0,0
2,2673446010,201392387,47873,8393,2024-10-04 19:28:53,0,0,0,0,0,0
3,2673446010,201392388,47873,11433,2024-10-04 19:28:53,0,0,0,0,0,0
1,2673446010,201392386,47873,56532,2024-10-04 19:28:54,0,0,0,0,0,0
2,2673446010,201392387,47873,8393,2024-10-04 19:28:54,0,0,0,0,0,0
3,2673446010,201392388,47873,11433,2024-10-04 19:28:54,0,0,0,0,0,0
1,2673446010,201392386,47873,56532,2024-10-04 19:28:55,0,0,0,0,0,0
3,2673446010,201392388,47873,11433,2024-10-04 19:28:55,0,0,0,0,0,0
1,2673446010,201392386,47873,56532,2024-10-04 19:28:56,0,0,0,0,0,0
3,2673446010,201392388,47873,11433,2024-10-04 19:28:56,0,0,0,0,0,0
3,2673446010,201392388,47873,11433,2024-10-04 19:28:57,0,0,0,0,0,0
3,2673446010,201392388,47873,11433,2024-10-04 19:28:58,0,0,0,0,0,0
3,2673446010,201392388,47873,11433,2024-10-04 19:28:59,0,0,0,0,0,0
3,2673446010,201392388,47873,11433,2024-10-04 19:29:00,0,0,0,0,0,0
3,2673446010,201392388,47873,11433,2024-10-04 19:29:01,0,0,0,0,0,0
3,2673446010,201392388,47873,11433,2024-10-04 19:29:02,0,0,0,0,0,0
3,2673446010,201392388,47873,11433,2024-10-04 19:29:03,0,0,0,0,0,0
3,2673446010,201392388,47873,11433,2024-10-04 19:29:04,0,0,0,0,0,0
3,2673446010,201392388,47873,11433,2024-10-04 19:29:05,0,0,0,0,0,0
3,2673446010,201392388,47873,11433,2024-10-04 19:29:06,0,0,0,0,0,0
3,2673446010,201392388,47873,11433,2024-10-04 19:29:07,0,0,0,0,0,0
3,2673446010,201392388,47873,11433,2024-10-04 19:29:08,0,0,0,0,0,0
3,2673446010,201392388,47873,11433,2024-10-04 19:29:09,0,0,0,0,0,0
3,2673446010,201392388,47873,11433,2024-10-04 19:29:10,0,0,0,0,0,0
3,2673446010,201392388,47873,11433,2024-10-04 19:29:11,0,0,0,0,0,0
3,2673446010,201392388,47873,27791,2024-10-04 19:29:12,2759,1759,4518,4,10,14
3,2673446010,201392388,47873,11433,2024-10-04 19:29:12,0,0,0,0,0,0
3,2673446010,201392388,47873,27791,2024-10-04 19:29:13,6499,1015,7514,12,10,22
3,2673446010,201392388,47873,11433,2024-10-04 19:29:13,0,0,0,0,0,0
3,2673446010,201392388,47873,27791,2024-10-04 19:29:14,0,0,0,0,0,0
3,2673446010,201392388,47873,11433,2024-10-04 19:29:14,0,0,0,0,0,0
3,2673446010,201392388,47873,27791,2024-10-04 19:29:15,0,0,0,0,0,0
3,2673446010,201392388,47873,11433,2024-10-04 19:29:15,0,0,0,0,0,0
1,2673446010,201392386,47873,28876,2024-10-04 19:29:16,2146,813,2959,3,3,6
3,2673446010,201392388,47873,27791,2024-10-04 19:29:16,0,0,0,0,0,0
2,2673446010,201392387,47873,23273,2024-10-04 19:29:16,0,104,104,0,1,1
1,2673446010,201392386,47873,28876,2024-10-04 19:29:17,0,0,0,0,0,0
3,2673446010,201392388,47873,27791,2024-10-04 19:29:17,0,0,0,0,0,0
2,2673446010,201392387,47873,23273,2024-10-04 19:29:17,0,0,0,0,0,0
1,2673446010,201392386,47873,28876,2024-10-04 19:29:18,9049,1781,10830,12,15,27
3,2673446010,201392388,47873,27791,2024-10-04 19:29:18,0,0,0,0,0,0
2,2673446010,201392387,47873,23273,2024-10-04 19:29:18,11273,2490,13763,17,17,34
1,2673446010,201392386,47873,28876,2024-10-04 19:29:19,0,0,0,0,0,0
3,2673446010,201392388,47873,27791,2024-10-04 19:29:19,0,0,0,0,0,0
2,2673446010,201392387,47873,23273,2024-10-04 19:29:19,0,0,0,0,0,0
1,2673446010,201392386,47873,28876,2024-10-04 19:29:20,0,0,0,0,0,0
3,2673446010,201392388,47873,27791,2024-10-04 19:29:20,0,0,0,0,0,0
2,2673446010,201392387,47873,23273,2024-10-04 19:29:20,0,0,0,0,0,0
1,2673446010,201392386,47873,28876,2024-10-04 19:29:21,0,0,0,0,0,0
3,2673446010,201392388,47873,27791,2024-10-04 19:29:21,0,0,0,0,0,0
2,2673446010,201392387,47873,23273,2024-10-04 19:29:21,0,0,0,0,0,0
1,2673446010,201392386,47873,28876,2024-10-04 19:29:22,0,0,0,0,0,0
3,2673446010,201392388,47873,27791,2024-10-04 19:29:22,0,0,0,0,0,0
2,2673446010,201392387,47873,23273,2024-10-04 19:29:22,0,0,0,0,0,0
1,2673446010,201392386,47873,28876,2024-10-04 19:29:23,0,0,0,0,0,0
3,2673446010,201392388,47873,27791,2024-10-04 19:29:23,0,0,0,0,0,0
2,2673446010,201392387,47873,23273,2024-10-04 19:29:23,0,0,0,0,0,0
1,2673446010,201392386,47873,28876,2024-10-04 19:29:24,0,0,0,0,0,0
3,2673446010,201392388,47873,27791,2024-10-04 19:29:24,0,0,0,0,0,0
2,2673446010,201392387,47873,23273,2024-10-04 19:29:24,0,0,0,0,0,0
1,2673446010,201392386,47873,28876,2024-10-04 19:29:25,0,0,0,0,0,0
3,2673446010,201392388,47873,27791,2024-10-04 19:29:25,0,0,0,0,0,0
2,2673446010,201392387,47873,23273,2024-10-04 19:29:25,0,0,0,0,0,0
3,2673446010,201392388,47873,27791,2024-10-04 19:29:26,0,0,0,0,0,0
2,2673446010,201392387,47873,23273,2024-10-04 19:29:26,0,0,0,0,0,0
3,2673446010,201392388,47873,27791,2024-10-04 19:29:27,0,0,0,0,0,0
2,2673446010,201392387,47873,23273,2024-10-04 19:29:27,0,0,0,0,0,0
3,2673446010,201392388,47873,27791,2024-10-04 19:29:28,0,0,0,0,0,0
2,2673446010,201392387,47873,23273,2024-10-04 19:29:28,0,0,0,0,0,0
3,2673446010,201392388,47873,27791,2024-10-04 19:29:29,0,0,0,0,0,0
2,2673446010,201392387,47873,23273,2024-10-04 19:29:29,0,0,0,0,0,0
3,2673446010,201392388,47873,27791,2024-10-04 19:29:30,0,0,0,0,0,0
2,2673446010,201392387,47873,23273,2024-10-04 19:29:30,0,0,0,0,0,0
3,2673446010,201392388,47873,27791,2024-10-04 19:29:31,0,0,0,0,0,0
2,2673446010,201392387,47873,23273,2024-10-04 19:29:31,0,0,0,0,0,0
3,2673446010,201392388,47873,27791,2024-10-04 19:29:32,0,0,0,0,0,0
2,2673446010,201392387,47873,23273,2024-10-04 19:29:32,0,0,0,0,0,0
3,2673446010,201392388,47873,27791,2024-10-04 19:29:33,0,0,0,0,0,0
2,2673446010,201392387,47873,23273,2024-10-04 19:29:33,0,0,0,0,0,0
3,2673446010,201392388,47873,27791,2024-10-04 19:29:34,0,0,0,0,0,0
2,2673446010,201392387,47873,23273,2024-10-04 19:29:34,0,0,0,0,0,0
3,2673446010,201392388,47873,27791,2024-10-04 19:29:35,0,0,0,0,0,0
2,2673446010,201392387,47873,23273,2024-10-04 19:29:35,0,0,0,0,0,0
3,2673446010,201392388,47873,27791,2024-10-04 19:29:36,0,0,0,0,0,0
2,2673446010,201392387,47873,23273,2024-10-04 19:29:36,0,0,0,0,0,0
3,2673446010,201392388,47873,27791,2024-10-04 19:29:37,0,0,0,0,0,0
2,2673446010,201392387,47873,23273,2024-10-04 19:29:37,0,0,0,0,0,0
3,2673446010,201392388,47873,27791,2024-10-04 19:29:38,0,0,0,0,0,0
2,2673446010,201392387,47873,23273,2024-10-04 19:29:38,0,0,0,0,0,0
3,2673446010,201392388,47873,27791,2024-10-04 19:29:39,0,0,0,0,0,0
2,2673446010,201392387,47873,23273,2024-10-04 19:29:39,0,0,0,0,0,0
3,2673446010,201392388,47873,27791,2024-10-04 19:29:40,0,0,0,0,0,0
2,2673446010,201392387,47873,23273,2024-10-04 19:29:40,0,0,0,0,0,0
3,2673446010,201392388,47873,27791,2024-10-04 19:29:41,0,0,0,0,0,0
2,2673446010,201392387,47873,23273,2024-10-04 19:29:41,0,0,0,0,0,0
3,2673446010,201392388,47873,52396,2024-10-04 19:29:42,0,104,104,0,1,1
3,2673446010,201392388,47873,27791,2024-10-04 19:29:42,0,0,0,0,0,0
2,2673446010,201392387,47873,23273,2024-10-04 19:29:42,0,0,0,0,0,0
3,2673446010,201392388,47873,52396,2024-10-04 19:29:43,9207,2670,11877,16,19,35
3,2673446010,201392388,47873,27791,2024-10-04 19:29:43,0,0,0,0,0,0
2,2673446010,201392387,47873,23273,2024-10-04 19:29:43,0,0,0,0,0,0
3,2673446010,201392388,47873,52396,2024-10-04 19:29:44,0,0,0,0,0,0
3,2673446010,201392388,47873,27791,2024-10-04 19:29:44,0,0,0,0,0,0
2,2673446010,201392387,47873,23273,2024-10-04 19:29:44,0,0,0,0,0,0
3,2673446010,201392388,47873,52396,2024-10-04 19:29:45,0,0,0,0,0,0
3,2673446010,201392388,47873,27791,2024-10-04 19:29:45,0,0,0,0,0,0
2,2673446010,201392387,47873,23273,2024-10-04 19:29:45,0,0,0,0,0,0
3,2673446010,201392388,47873,52396,2024-10-04 19:29:46,0,0,0,0,0,0
3,2673446010,201392388,47873,27791,2024-10-04 19:29:46,0,0,0,0,0,0
2,2673446010,201392387,47873,23273,2024-10-04 19:29:46,0,0,0,0,0,0
2,2673446010,201392387,47873,31970,2024-10-04 19:29:47,112,813,925,2,3,5
3,2673446010,201392388,47873,52396,2024-10-04 19:29:47,0,0,0,0,0,0
3,2673446010,201392388,47873,27791,2024-10-04 19:29:47,0,0,0,0,0,0
2,2673446010,201392387,47873,23273,2024-10-04 19:29:47,0,0,0,0,0,0
2,2673446010,201392387,47873,31970,2024-10-04 19:29:48,9139,1865,11004,14,16,30
1,2673446010,201392386,47873,40605,2024-10-04 19:29:48,7241,2462,9703,14,17,31
3,2673446010,201392388,47873,52396,2024-10-04 19:29:48,0,0,0,0,0,0
3,2673446010,201392388,47873,27791,2024-10-04 19:29:48,0,0,0,0,0,0
2,2673446010,201392387,47873,31970,2024-10-04 19:29:49,0,0,0,0,0,0
1,2673446010,201392386,47873,40605,2024-10-04 19:29:49,0,0,0,0,0,0
3,2673446010,201392388,47873,52396,2024-10-04 19:29:49,0,0,0,0,0,0
3,2673446010,201392388,47873,27791,2024-10-04 19:29:49,0,0,0,0,0,0
2,2673446010,201392387,47873,31970,2024-10-04 19:29:50,0,0,0,0,0,0
1,2673446010,201392386,47873,40605,2024-10-04 19:29:50,0,0,0,0,0,0
3,2673446010,201392388,47873,52396,2024-10-04 19:29:50,0,0,0,0,0,0
3,2673446010,201392388,47873,27791,2024-10-04 19:29:50,0,0,0,0,0,0
2,2673446010,201392387,47873,31970,2024-10-04 19:29:51,0,0,0,0,0,0
1,2673446010,201392386,47873,40605,2024-10-04 19:29:51,0,0,0,0,0,0
3,2673446010,201392388,47873,52396,2024-10-04 19:29:51,0,0,0,0,0,0
3,2673446010,201392388,47873,27791,2024-10-04 19:29:51,0,0,0,0,0,0
2,2673446010,201392387,47873,31970,2024-10-04 19:29:52,0,0,0,0,0,0
1,2673446010,201392386,47873,40605,2024-10-04 19:29:52,0,0,0,0,0,0
3,2673446010,201392388,47873,52396,2024-10-04 19:29:52,0,0,0,0,0,0
3,2673446010,201392388,47873,27791,2024-10-04 19:29:52,0,0,0,0,0,0
2,2673446010,201392387,47873,31970,2024-10-04 19:29:53,0,0,0,0,0,0
1,2673446010,201392386,47873,40605,2024-10-04 19:29:53,0,0,0,0,0,0
3,2673446010,201392388,47873,52396,2024-10-04 19:29:53,0,0,0,0,0,0
3,2673446010,201392388,47873,27791,2024-10-04 19:29:53,0,0,0,0,0,0
2,2673446010,201392387,47873,31970,2024-10-04 19:29:54,0,0,0,0,0,0
1,2673446010,201392386,47873,40605,2024-10-04 19:29:54,0,0,0,0,0,0
3,2673446010,201392388,47873,52396,2024-10-04 19:29:54,0,0,0,0,0,0
3,2673446010,201392388,47873,27791,2024-10-04 19:29:54,0,0,0,0,0,0
2,2673446010,201392387,47873,31970,2024-10-04 19:29:55,0,0,0,0,0,0
1,2673446010,201392386,47873,40605,2024-10-04 19:29:55,0,0,0,0,0,0
3,2673446010,201392388,47873,52396,2024-10-04 19:29:55,0,0,0,0,0,0
3,2673446010,201392388,47873,27791,2024-10-04 19:29:55,0,0,0,0,0,0
2,2673446010,201392387,47873,31970,2024-10-04 19:29:56,0,0,0,0,0,0
1,2673446010,201392386,47873,40605,2024-10-04 19:29:56,0,0,0,0,0,0
3,2673446010,201392388,47873,52396,2024-10-04 19:29:56,0,0,0,0,0,0
3,2673446010,201392388,47873,27791,2024-10-04 19:29:56,0,0,0,0,0,0
2,2673446010,201392387,47873,31970,2024-10-04 19:29:57,0,0,0,0,0,0
3,2673446010,201392388,47873,52396,2024-10-04 19:29:57,0,0,0,0,0,0
3,2673446010,201392388,47873,27791,2024-10-04 19:29:57,0,0,0,0,0,0
2,2673446010,201392387,47873,31970,2024-10-04 19:29:58,0,0,0,0,0,0
3,2673446010,201392388,47873,52396,2024-10-04 19:29:58,0,0,0,0,0,0
3,2673446010,201392388,47873,27791,2024-10-04 19:29:58,0,0,0,0,0,0
2,2673446010,201392387,47873,31970,2024-10-04 19:29:59,0,0,0,0,0,0
3,2673446010,201392388,47873,52396,2024-10-04 19:29:59,0,0,0,0,0,0
3,2673446010,201392388,47873,27791,2024-10-04 19:29:59,0,0,0,0,0,0
2,2673446010,201392387,47873,31970,2024-10-04 19:30:00,0,0,0,0,0,0
3,2673446010,201392388,47873,52396,2024-10-04 19:30:00,0,0,0,0,0,0
3,2673446010,201392388,47873,27791,2024-10-04 19:30:00,0,0,0,0,0,0
2,2673446010,201392387,47873,31970,2024-10-04 19:30:01,0,0,0,0,0,0
3,2673446010,201392388,47873,52396,2024-10-04 19:30:01,0,0,0,0,0,0
3,2673446010,201392388,47873,27791,2024-10-04 19:30:01,0,0,0,0,0,0
2,2673446010,201392387,47873,31970,2024-10-04 19:30:02,0,0,0,0,0,0
3,2673446010,201392388,47873,52396,2024-10-04 19:30:02,0,0,0,0,0,0
3,2673446010,201392388,47873,27791,2024-10-04 19:30:02,0,0,0,0,0,0
2,2673446010,201392387,47873,31970,2024-10-04 19:30:03,0,0,0,0,0,0
3,2673446010,201392388,47873,52396,2024-10-04 19:30:03,0,0,0,0,0,0
3,2673446010,201392388,47873,27791,2024-10-04 19:30:03,0,0,0,0,0,0
2,2673446010,201392387,47873,31970,2024-10-04 19:30:04,0,0,0,0,0,0
3,2673446010,201392388,47873,52396,2024-10-04 19:30:04,0,0,0,0,0,0
3,2673446010,201392388,47873,27791,2024-10-04 19:30:04,0,0,0,0,0,0
2,2673446010,201392387,47873,31970,2024-10-04 19:30:05,0,0,0,0,0,0
3,2673446010,201392388,47873,52396,2024-10-04 19:30:05,0,0,0,0,0,0
3,2673446010,201392388,47873,27791,2024-10-04 19:30:05,0,0,0,0,0,0
2,2673446010,201392387,47873,31970,2024-10-04 19:30:06,0,0,0,0,0,0
3,2673446010,201392388,47873,52396,2024-10-04 19:30:06,0,0,0,0,0,0
3,2673446010,201392388,47873,27791,2024-10-04 19:30:06,0,0,0,0,0,0
2,2673446010,201392387,47873,31970,2024-10-04 19:30:07,0,0,0,0,0,0
3,2673446010,201392388,47873,52396,2024-10-04 19:30:07,0,0,0,0,0,0
3,2673446010,201392388,47873,27791,2024-10-04 19:30:07,0,0,0,0,0,0
2,2673446010,201392387,47873,31970,2024-10-04 19:30:08,0,0,0,0,0,0
3,2673446010,201392388,47873,52396,2024-10-04 19:30:08,0,0,0,0,0,0
3,2673446010,201392388,47873,27791,2024-10-04 19:30:08,0,0,0,0,0,0
2,2673446010,201392387,47873,31970,2024-10-04 19:30:09,0,0,0,0,0,0
3,2673446010,201392388,47873,52396,2024-10-04 19:30:09,0,0,0,0,0,0
3,2673446010,201392388,47873,27791,2024-10-04 19:30:09,0,0,0,0,0,0
2,2673446010,201392387,47873,31970,2024-10-04 19:30:10,0,0,0,0,0,0
3,2673446010,201392388,47873,52396,2024-10-04 19:30:10,0,0,0,0,0,0
3,2673446010,201392388,47873,27791,2024-10-04 19:30:10,0,0,0,0,0,0
2,2673446010,201392387,47873,31970,2024-10-04 19:30:11,0,0,0,0,0,0
3,2673446010,201392388,47873,52396,2024-10-04 19:30:11,0,0,0,0,0,0
3,2673446010,201392388,47873,27791,2024-10-04 19:30:11,0,0,0,0,0,0
2,2673446010,201392387,47873,31970,2024-10-04 19:30:12,0,0,0,0,0,0
3,2673446010,201392388,47873,52396,2024-10-04 19:30:12,0,0,0,0,0,0
3,2673446010,201392388,47873,27791,2024-10-04 19:30:12,0,0,0,0,0,0
2,2673446010,201392387,47873,31970,2024-10-04 19:30:13,0,0,0,0,0,0
3,2673446010,201392388,47873,6295,2024-10-04 19:30:13,2813,1759,4572,5,10,15
3,2673446010,201392388,47873,52396,2024-10-04 19:30:13,0,0,0,0,0,0
3,2673446010,201392388,47873,27791,2024-10-04 19:30:13,0,0,0,0,0,0
2,2673446010,201392387,47873,31970,2024-10-04 19:30:14,0,0,0,0,0,0
3,2673446010,201392388,47873,6295,2024-10-04 19:30:14,4433,703,5136,11,7,18
3,2673446010,201392388,47873,52396,2024-10-04 19:30:14,0,0,0,0,0,0
3,2673446010,201392388,47873,27791,2024-10-04 19:30:14,0,0,0,0,0,0
2,2673446010,201392387,47873,31970,2024-10-04 19:30:15,0,0,0,0,0,0
3,2673446010,201392388,47873,6295,2024-10-04 19:30:15,0,0,0,0,0,0
3,2673446010,201392388,47873,52396,2024-10-04 19:30:15,0,0,0,0,0,0
3,2673446010,201392388,47873,27791,2024-10-04 19:30:15,0,0,0,0,0,0
2,2673446010,201392387,47873,31970,2024-10-04 19:30:16,0,0,0,0,0,0
3,2673446010,201392388,47873,6295,2024-10-04 19:30:16,0,0,0,0,0,0
3,2673446010,201392388,47873,52396,2024-10-04 19:30:16,0,0,0,0,0,0
3,2673446010,201392388,47873,27791,2024-10-04 19:30:16,0,0,0,0,0,0
2,2673446010,201392387,47873,31970,2024-10-04 19:30:17,0,0,0,0,0,0
3,2673446010,201392388,47873,6295,2024-10-04 19:30:17,0,0,0,0,0,0
3,2673446010,201392388,47873,52396,2024-10-04 19:30:17,0,0,0,0,0,0
3,2673446010,201392388,47873,27791,2024-10-04 19:30:17,0,0,0,0,0,0
2,2673446010,201392387,47873,31970,2024-10-04 19:30:18,0,0,0,0,0,0
2,2673446010,201392387,47873,52408,2024-10-04 19:30:18,4846,1771,6617,6,10,16
3,2673446010,201392388,47873,6295,2024-10-04 19:30:18,0,0,0,0,0,0
3,2673446010,201392388,47873,52396,2024-10-04 19:30:18,0,0,0,0,0,0
3,2673446010,201392388,47873,27791,2024-10-04 19:30:18,0,0,0,0,0,0
1,2673446010,201392386,47873,28321,2024-10-04 19:30:19,10989,2426,13415,13,16,29
2,2673446010,201392387,47873,31970,2024-10-04 19:30:19,0,0,0,0,0,0
2,2673446010,201392387,47873,52408,2024-10-04 19:30:19,4204,607,4811,7,6,13
3,2673446010,201392388,47873,52396,2024-10-04 19:30:19,0,0,0,0,0,0
3,2673446010,201392388,47873,27791,2024-10-04 19:30:19,0,0,0,0,0,0
1,2673446010,201392386,47873,28321,2024-10-04 19:30:20,52,168,220,1,2,3
2,2673446010,201392387,47873,31970,2024-10-04 19:30:20,0,0,0,0,0,0
2,2673446010,201392387,47873,52408,2024-10-04 19:30:20,0,0,0,0,0,0
3,2673446010,201392388,47873,52396,2024-10-04 19:30:20,0,0,0,0,0,0
3,2673446010,201392388,47873,27791,2024-10-04 19:30:20,0,0,0,0,0,0
1,2673446010,201392386,47873,28321,2024-10-04 19:30:21,0,0,0,0,0,0
2,2673446010,201392387,47873,31970,2024-10-04 19:30:21,0,0,0,0,0,0
2,2673446010,201392387,47873,52408,2024-10-04 19:30:21,0,0,0,0,0,0
3,2673446010,201392388,47873,52396,2024-10-04 19:30:21,0,0,0,0,0,0
3,2673446010,201392388,47873,27791,2024-10-04 19:30:21,0,0,0,0,0,0
1,2673446010,201392386,47873,28321,2024-10-04 19:30:22,0,0,0,0,0,0
2,2673446010,201392387,47873,31970,2024-10-04 19:30:22,0,0,0,0,0,0
2,2673446010,201392387,47873,52408,2024-10-04 19:30:22,0,0,0,0,0,0
3,2673446010,201392388,47873,52396,2024-10-04 19:30:22,0,0,0,0,0,0
3,2673446010,201392388,47873,27791,2024-10-04 19:30:22,0,0,0,0,0,0
1,2673446010,201392386,47873,28321,2024-10-04 19:30:23,0,0,0,0,0,0
2,2673446010,201392387,47873,31970,2024-10-04 19:30:23,0,0,0,0,0,0
2,2673446010,201392387,47873,52408,2024-10-04 19:30:23,0,0,0,0,0,0
3,2673446010,201392388,47873,52396,2024-10-04 19:30:23,0,0,0,0,0,0
3,2673446010,201392388,47873,27791,2024-10-04 19:30:23,0,0,0,0,0,0
1,2673446010,201392386,47873,28321,2024-10-04 19:30:24,0,0,0,0,0,0
2,2673446010,201392387,47873,31970,2024-10-04 19:30:24,0,0,0,0,0,0
2,2673446010,201392387,47873,52408,2024-10-04 19:30:24,0,0,0,0,0,0
3,2673446010,201392388,47873,52396,2024-10-04 19:30:24,0,0,0,0,0,0
3,2673446010,201392388,47873,27791,2024-10-04 19:30:24,0,0,0,0,0,0
1,2673446010,201392386,47873,28321,2024-10-04 19:30:25,0,0,0,0,0,0
2,2673446010,201392387,47873,31970,2024-10-04 19:30:25,0,0,0,0,0,0
2,2673446010,201392387,47873,52408,2024-10-04 19:30:25,0,0,0,0,0,0
3,2673446010,201392388,47873,52396,2024-10-04 19:30:25,0,0,0,0,0,0
3,2673446010,201392388,47873,27791,2024-10-04 19:30:25,0,0,0,0,0,0
1,2673446010,201392386,47873,28321,2024-10-04 19:30:26,0,0,0,0,0,0
2,2673446010,201392387,47873,31970,2024-10-04 19:30:26,0,0,0,0,0,0
2,2673446010,201392387,47873,52408,2024-10-04 19:30:26,0,0,0,0,0,0
3,2673446010,201392388,47873,52396,2024-10-04 19:30:26,0,0,0,0,0,0
3,2673446010,201392388,47873,27791,2024-10-04 19:30:26,0,0,0,0,0,0
1,2673446010,201392386,47873,28321,2024-10-04 19:30:27,0,0,0,0,0,0
2,2673446010,201392387,47873,31970,2024-10-04 19:30:27,0,0,0,0,0,0
2,2673446010,201392387,47873,52408,2024-10-04 19:30:27,0,0,0,0,0,0
3,2673446010,201392388,47873,52396,2024-10-04 19:30:27,0,0,0,0,0,0
3,2673446010,201392388,47873,27791,2024-10-04 19:30:27,0,0,0,0,0,0
2,2673446010,201392387,47873,31970,2024-10-04 19:30:28,0,0,0,0,0,0
2,2673446010,201392387,47873,52408,2024-10-04 19:30:28,0,0,0,0,0,0
3,2673446010,201392388,47873,52396,2024-10-04 19:30:28,0,0,0,0,0,0
3,2673446010,201392388,47873,27791,2024-10-04 19:30:28,0,0,0,0,0,0
2,2673446010,201392387,47873,31970,2024-10-04 19:30:29,0,0,0,0,0,0
2,2673446010,201392387,47873,52408,2024-10-04 19:30:29,0,0,0,0,0,0
3,2673446010,201392388,47873,52396,2024-10-04 19:30:29,0,0,0,0,0,0
3,2673446010,201392388,47873,27791,2024-10-04 19:30:29,0,0,0,0,0,0
2,2673446010,201392387,47873,31970,2024-10-04 19:30:30,0,0,0,0,0,0
2,2673446010,201392387,47873,52408,2024-10-04 19:30:30,0,0,0,0,0,0
3,2673446010,201392388,47873,52396,2024-10-04 19:30:30,0,0,0,0,0,0
3,2673446010,201392388,47873,27791,2024-10-04 19:30:30,0,0,0,0,0,0
2,2673446010,201392387,47873,31970,2024-10-04 19:30:31,0,0,0,0,0,0
2,2673446010,201392387,47873,52408,2024-10-04 19:30:31,0,0,0,0,0,0
3,2673446010,201392388,47873,52396,2024-10-04 19:30:31,0,0,0,0,0,0
3,2673446010,201392388,47873,27791,2024-10-04 19:30:31,0,0,0,0,0,0
2,2673446010,201392387,47873,31970,2024-10-04 19:30:32,0,0,0,0,0,0
2,2673446010,201392387,47873,52408,2024-10-04 19:30:32,0,0,0,0,0,0
3,2673446010,201392388,47873,52396,2024-10-04 19:30:32,0,0,0,0,0,0
3,2673446010,201392388,47873,27791,2024-10-04 19:30:32,0,0,0,0,0,0
2,2673446010,201392387,47873,31970,2024-10-04 19:30:33,0,0,0,0,0,0
2,2673446010,201392387,47873,52408,2024-10-04 19:30:33,0,0,0,0,0,0
3,2673446010,201392388,47873,52396,2024-10-04 19:30:33,0,0,0,0,0,0
3,2673446010,201392388,47873,27791,2024-10-04 19:30:33,0,0,0,0,0,0
2,2673446010,201392387,47873,31970,2024-10-04 19:30:34,0,0,0,0,0,0
2,2673446010,201392387,47873,52408,2024-10-04 19:30:34,0,0,0,0,0,0
3,2673446010,201392388,47873,52396,2024-10-04 19:30:34,0,0,0,0,0,0
3,2673446010,201392388,47873,27791,2024-10-04 19:30:34,0,0,0,0,0,0
2,2673446010,201392387,47873,31970,2024-10-04 19:30:35,0,0,0,0,0,0
2,2673446010,201392387,47873,52408,2024-10-04 19:30:35,0,0,0,0,0,0
3,2673446010,201392388,47873,52396,2024-10-04 19:30:35,0,0,0,0,0,0
3,2673446010,201392388,47873,27791,2024-10-04 19:30:35,0,0,0,0,0,0
2,2673446010,201392387,47873,31970,2024-10-04 19:30:36,0,0,0,0,0,0
2,2673446010,201392387,47873,52408,2024-10-04 19:30:36,0,0,0,0,0,0
3,2673446010,201392388,47873,52396,2024-10-04 19:30:36,0,0,0,0,0,0
3,2673446010,201392388,47873,27791,2024-10-04 19:30:36,0,0,0,0,0,0
2,2673446010,201392387,47873,31970,2024-10-04 19:30:37,0,0,0,0,0,0
2,2673446010,201392387,47873,52408,2024-10-04 19:30:37,0,0,0,0,0,0
3,2673446010,201392388,47873,52396,2024-10-04 19:30:37,0,0,0,0,0,0
3,2673446010,201392388,47873,27791,2024-10-04 19:30:37,0,0,0,0,0,0
2,2673446010,201392387,47873,31970,2024-10-04 19:30:38,0,0,0,0,0,0
2,2673446010,201392387,47873,52408,2024-10-04 19:30:38,0,0,0,0,0,0
3,2673446010,201392388,47873,52396,2024-10-04 19:30:38,0,0,0,0,0,0
3,2673446010,201392388,47873,27791,2024-10-04 19:30:38,0,0,0,0,0,0
2,2673446010,201392387,47873,31970,2024-10-04 19:30:39,0,0,0,0,0,0
2,2673446010,201392387,47873,52408,2024-10-04 19:30:39,0,0,0,0,0,0
3,2673446010,201392388,47873,52396,2024-10-04 19:30:39,0,0,0,0,0,0
3,2673446010,201392388,47873,27791,2024-10-04 19:30:39,0,0,0,0,0,0
2,2673446010,201392387,47873,31970,2024-10-04 19:30:40,0,0,0,0,0,0
2,2673446010,201392387,47873,52408,2024-10-04 19:30:40,0,0,0,0,0,0
3,2673446010,201392388,47873,52396,2024-10-04 19:30:40,0,0,0,0,0,0
3,2673446010,201392388,47873,27791,2024-10-04 19:30:40,0,0,0,0,0,0
2,2673446010,201392387,47873,31970,2024-10-04 19:30:41,0,0,0,0,0,0
2,2673446010,201392387,47873,52408,2024-10-04 19:30:41,0,0,0,0,0,0
3,2673446010,201392388,47873,52396,2024-10-04 19:30:41,0,0,0,0,0,0
3,2673446010,201392388,47873,27791,2024-10-04 19:30:41,0,0,0,0,0,0
2,2673446010,201392387,47873,31970,2024-10-04 19:30:42,0,0,0,0,0,0
2,2673446010,201392387,47873,52408,2024-10-04 19:30:42,0,0,0,0,0,0
3,2673446010,201392388,47873,52396,2024-10-04 19:30:42,0,0,0,0,0,0
3,2673446010,201392388,47873,27791,2024-10-04 19:30:42,0,0,0,0,0,0
2,2673446010,201392387,47873,31970,2024-10-04 19:30:43,0,0,0,0,0,0
2,2673446010,201392387,47873,52408,2024-10-04 19:30:43,0,0,0,0,0,0
3,2673446010,201392388,47873,52396,2024-10-04 19:30:43,0,0,0,0,0,0
3,2673446010,201392388,47873,27791,2024-10-04 19:30:43,0,0,0,0,0,0
2,2673446010,201392387,47873,31970,2024-10-04 19:30:44,0,0,0,0,0,0
2,2673446010,201392387,47873,52408,2024-10-04 19:30:44,0,0,0,0,0,0
3,2673446010,201392388,47873,46209,2024-10-04 19:30:44,9270,2582,11852,17,18,35
3,2673446010,201392388,47873,52396,2024-10-04 19:30:44,0,0,0,0,0,0
3,2673446010,201392388,47873,27791,2024-10-04 19:30:44,0,0,0,0,0,0
2,2673446010,201392387,47873,31970,2024-10-04 19:30:45,0,0,0,0,0,0
2,2673446010,201392387,47873,52408,2024-10-04 19:30:45,0,0,0,0,0,0
3,2673446010,201392388,47873,46209,2024-10-04 19:30:45,0,0,0,0,0,0
3,2673446010,201392388,47873,52396,2024-10-04 19:30:45,0,0,0,0,0,0
3,2673446010,201392388,47873,27791,2024-10-04 19:30:45,0,0,0,0,0,0
2,2673446010,201392387,47873,31970,2024-10-04 19:30:46,0,0,0,0,0,0
2,2673446010,201392387,47873,52408,2024-10-04 19:30:46,0,0,0,0,0,0
3,2673446010,201392388,47873,46209,2024-10-04 19:30:46,0,0,0,0,0,0
3,2673446010,201392388,47873,52396,2024-10-04 19:30:46,0,0,0,0,0,0
3,2673446010,201392388,47873,27791,2024-10-04 19:30:46,0,0,0,0,0,0
2,2673446010,201392387,47873,31970,2024-10-04 19:30:47,0,0,0,0,0,0
2,2673446010,201392387,47873,52408,2024-10-04 19:30:47,0,0,0,0,0,0
3,2673446010,201392388,47873,46209,2024-10-04 19:30:47,0,0,0,0,0,0
3,2673446010,201392388,47873,52396,2024-10-04 19:30:47,0,0,0,0,0,0
3,2673446010,201392388,47873,27791,2024-10-04 19:30:47,0,0,0,0,0,0
2,2673446010,201392387,47873,31970,2024-10-04 19:30:48,0,0,0,0,0,0
2,2673446010,201392387,47873,52408,2024-10-04 19:30:48,0,0,0,0,0,0
3,2673446010,201392388,47873,46209,2024-10-04 19:30:48,0,0,0,0,0,0
3,2673446010,201392388,47873,52396,2024-10-04 19:30:48,0,0,0,0,0,0
3,2673446010,201392388,47873,27791,2024-10-04 19:30:48,0,0,0,0,0,0
1,2673446010,201392386,47873,60138,2024-10-04 19:30:49,112,813,925,2,3,5
2,2673446010,201392387,47873,31970,2024-10-04 19:30:49,0,0,0,0,0,0
2,2673446010,201392387,47873,52408,2024-10-04 19:30:49,0,0,0,0,0,0
3,2673446010,201392388,47873,46209,2024-10-04 19:30:49,0,0,0,0,0,0
3,2673446010,201392388,47873,52396,2024-10-04 19:30:49,0,0,0,0,0,0
3,2673446010,201392388,47873,27791,2024-10-04 19:30:49,0,0,0,0,0,0
1,2673446010,201392386,47873,60138,2024-10-04 19:30:50,11148,1877,13025,15,16,31
2,2673446010,201392387,47873,31970,2024-10-04 19:30:50,0,0,0,0,0,0
2,2673446010,201392387,47873,51330,2024-10-04 19:30:50,9125,2462,11587,14,17,31
3,2673446010,201392388,47873,52396,2024-10-04 19:30:50,0,0,0,0,0,0
3,2673446010,201392388,47873,27791,2024-10-04 19:30:50,0,0,0,0,0,0
1,2673446010,201392386,47873,60138,2024-10-04 19:30:51,0,0,0,0,0,0
2,2673446010,201392387,47873,31970,2024-10-04 19:30:51,0,0,0,0,0,0
2,2673446010,201392387,47873,51330,2024-10-04 19:30:51,0,0,0,0,0,0
3,2673446010,201392388,47873,52396,2024-10-04 19:30:51,0,0,0,0,0,0
3,2673446010,201392388,47873,27791,2024-10-04 19:30:51,0,0,0,0,0,0
1,2673446010,201392386,47873,60138,2024-10-04 19:30:52,0,0,0,0,0,0
2,2673446010,201392387,47873,31970,2024-10-04 19:30:52,0,0,0,0,0,0
2,2673446010,201392387,47873,51330,2024-10-04 19:30:52,0,0,0,0,0,0
3,2673446010,201392388,47873,52396,2024-10-04 19:30:52,0,0,0,0,0,0
3,2673446010,201392388,47873,27791,2024-10-04 19:30:52,0,0,0,0,0,0
1,2673446010,201392386,47873,60138,2024-10-04 19:30:53,0,0,0,0,0,0
2,2673446010,201392387,47873,31970,2024-10-04 19:30:53,0,0,0,0,0,0
2,2673446010,201392387,47873,51330,2024-10-04 19:30:53,0,0,0,0,0,0
3,2673446010,201392388,47873,52396,2024-10-04 19:30:53,0,0,0,0,0,0
3,2673446010,201392388,47873,27791,2024-10-04 19:30:53,0,0,0,0,0,0
1,2673446010,201392386,47873,60138,2024-10-04 19:30:54,0,0,0,0,0,0
2,2673446010,201392387,47873,31970,2024-10-04 19:30:54,0,0,0,0,0,0
2,2673446010,201392387,47873,51330,2024-10-04 19:30:54,0,0,0,0,0,0
3,2673446010,201392388,47873,52396,2024-10-04 19:30:54,0,0,0,0,0,0
3,2673446010,201392388,47873,27791,2024-10-04 19:30:54,0,0,0,0,0,0
1,2673446010,201392386,47873,60138,2024-10-04 19:30:55,0,0,0,0,0,0
2,2673446010,201392387,47873,31970,2024-10-04 19:30:55,0,0,0,0,0,0
2,2673446010,201392387,47873,51330,2024-10-04 19:30:55,0,0,0,0,0,0
3,2673446010,201392388,47873,52396,2024-10-04 19:30:55,0,0,0,0,0,0
3,2673446010,201392388,47873,27791,2024-10-04 19:30:55,0,0,0,0,0,0
1,2673446010,201392386,47873,60138,2024-10-04 19:30:56,0,0,0,0,0,0
2,2673446010,201392387,47873,31970,2024-10-04 19:30:56,0,0,0,0,0,0
2,2673446010,201392387,47873,51330,2024-10-04 19:30:56,0,0,0,0,0,0
3,2673446010,201392388,47873,52396,2024-10-04 19:30:56,0,0,0,0,0,0
3,2673446010,201392388,47873,27791,2024-10-04 19:30:56,0,0,0,0,0,0
1,2673446010,201392386,47873,60138,2024-10-04 19:30:57,0,0,0,0,0,0
2,2673446010,201392387,47873,31970,2024-10-04 19:30:57,0,0,0,0,0,0
2,2673446010,201392387,47873,51330,2024-10-04 19:30:57,0,0,0,0,0,0
3,2673446010,201392388,47873,52396,2024-10-04 19:30:57,0,0,0,0,0,0
3,2673446010,201392388,47873,27791,2024-10-04 19:30:57,0,0,0,0,0,0
1,2673446010,201392386,47873,60138,2024-10-04 19:30:58,0,0,0,0,0,0
2,2673446010,201392387,47873,31970,2024-10-04 19:30:58,0,0,0,0,0,0
2,2673446010,201392387,47873,51330,2024-10-04 19:30:58,0,0,0,0,0,0
3,2673446010,201392388,47873,52396,2024-10-04 19:30:58,0,0,0,0,0,0
3,2673446010,201392388,47873,27791,2024-10-04 19:30:58,0,0,0,0,0,0
1,2673446010,201392386,47873,60138,2024-10-04 19:30:59,0,0,0,0,0,0
2,2673446010,201392387,47873,31970,2024-10-04 19:30:59,0,0,0,0,0,0
3,2673446010,201392388,47873,52396,2024-10-04 19:30:59,0,0,0,0,0,0
3,2673446010,201392388,47873,27791,2024-10-04 19:30:59,0,0,0,0,0,0
1,2673446010,201392386,47873,60138,2024-10-04 19:31:00,0,0,0,0,0,0
2,2673446010,201392387,47873,31970,2024-10-04 19:31:00,0,0,0,0,0,0
3,2673446010,201392388,47873,52396,2024-10-04 19:31:00,0,0,0,0,0,0
3,2673446010,201392388,47873,27791,2024-10-04 19:31:00,0,0,0,0,0,0
1,2673446010,201392386,47873,60138,2024-10-04 19:31:01,0,0,0,0,0,0
2,2673446010,201392387,47873,31970,2024-10-04 19:31:01,0,0,0,0,0,0
3,2673446010,201392388,47873,52396,2024-10-04 19:31:01,0,0,0,0,0,0
3,2673446010,201392388,47873,27791,2024-10-04 19:31:01,0,0,0,0,0,0
1,2673446010,201392386,47873,60138,2024-10-04 19:31:02,0,0,0,0,0,0
2,2673446010,201392387,47873,31970,2024-10-04 19:31:02,0,0,0,0,0,0
3,2673446010,201392388,47873,52396,2024-10-04 19:31:02,0,0,0,0,0,0
3,2673446010,201392388,47873,27791,2024-10-04 19:31:02,0,0,0,0,0,0
1,2673446010,201392386,47873,60138,2024-10-04 19:31:03,0,0,0,0,0,0
2,2673446010,201392387,47873,31970,2024-10-04 19:31:03,0,0,0,0,0,0
3,2673446010,201392388,47873,52396,2024-10-04 19:31:03,0,0,0,0,0,0
3,2673446010,201392388,47873,27791,2024-10-04 19:31:03,0,0,0,0,0,0
1,2673446010,201392386,47873,60138,2024-10-04 19:31:04,0,0,0,0,0,0
2,2673446010,201392387,47873,31970,2024-10-04 19:31:04,0,0,0,0,0,0
3,2673446010,201392388,47873,52396,2024-10-04 19:31:04,0,0,0,0,0,0
3,2673446010,201392388,47873,27791,2024-10-04 19:31:04,0,0,0,0,0,0
1,2673446010,201392386,47873,60138,2024-10-04 19:31:05,0,0,0,0,0,0
2,2673446010,201392387,47873,31970,2024-10-04 19:31:05,0,0,0,0,0,0
3,2673446010,201392388,47873,52396,2024-10-04 19:31:05,0,0,0,0,0,0
3,2673446010,201392388,47873,27791,2024-10-04 19:31:05,0,0,0,0,0,0
1,2673446010,201392386,47873,60138,2024-10-04 19:31:06,0,0,0,0,0,0
2,2673446010,201392387,47873,31970,2024-10-04 19:31:06,0,0,0,0,0,0
3,2673446010,201392388,47873,52396,2024-10-04 19:31:06,0,0,0,0,0,0
3,2673446010,201392388,47873,27791,2024-10-04 19:31:06,0,0,0,0,0,0
1,2673446010,201392386,47873,60138,2024-10-04 19:31:07,0,0,0,0,0,0
2,2673446010,201392387,47873,31970,2024-10-04 19:31:07,0,0,0,0,0,0
3,2673446010,201392388,47873,52396,2024-10-04 19:31:07,0,0,0,0,0,0
3,2673446010,201392388,47873,27791,2024-10-04 19:31:07,0,0,0,0,0,0
1,2673446010,201392386,47873,60138,2024-10-04 19:31:08,0,0,0,0,0,0
2,2673446010,201392387,47873,31970,2024-10-04 19:31:08,0,0,0,0,0,0
3,2673446010,201392388,47873,52396,2024-10-04 19:31:08,0,0,0,0,0,0
3,2673446010,201392388,47873,27791,2024-10-04 19:31:08,0,0,0,0,0,0
1,2673446010,201392386,47873,60138,2024-10-04 19:31:09,0,0,0,0,0,0
2,2673446010,201392387,47873,31970,2024-10-04 19:31:09,0,0,0,0,0,0
3,2673446010,201392388,47873,52396,2024-10-04 19:31:09,0,0,0,0,0,0
3,2673446010,201392388,47873,27791,2024-10-04 19:31:09,0,0,0,0,0,0
1,2673446010,201392386,47873,60138,2024-10-04 19:31:10,0,0,0,0,0,0
2,2673446010,201392387,47873,31970,2024-10-04 19:31:10,0,0,0,0,0,0
3,2673446010,201392388,47873,52396,2024-10-04 19:31:10,0,0,0,0,0,0
3,2673446010,201392388,47873,27791,2024-10-04 19:31:10,0,0,0,0,0,0
1,2673446010,201392386,47873,60138,2024-10-04 19:31:11,0,0,0,0,0,0
2,2673446010,201392387,47873,31970,2024-10-04 19:31:11,0,0,0,0,0,0
3,2673446010,201392388,47873,52396,2024-10-04 19:31:11,0,0,0,0,0,0
3,2673446010,201392388,47873,27791,2024-10-04 19:31:11,0,0,0,0,0,0
1,2673446010,201392386,47873,60138,2024-10-04 19:31:12,0,0,0,0,0,0
2,2673446010,201392387,47873,31970,2024-10-04 19:31:12,0,0,0,0,0,0
3,2673446010,201392388,47873,52396,2024-10-04 19:31:12,0,0,0,0,0,0
3,2673446010,201392388,47873,27791,2024-10-04 19:31:12,0,0,0,0,0,0
1,2673446010,201392386,47873,60138,2024-10-04 19:31:13,0,0,0,0,0,0
2,2673446010,201392387,47873,31970,2024-10-04 19:31:13,0,0,0,0,0,0
3,2673446010,201392388,47873,52396,2024-10-04 19:31:13,0,0,0,0,0,0
3,2673446010,201392388,47873,27791,2024-10-04 19:31:13,0,0,0,0,0,0
1,2673446010,201392386,47873,60138,2024-10-04 19:31:14,0,0,0,0,0,0
2,2673446010,201392387,47873,31970,2024-10-04 19:31:14,0,0,0,0,0,0
3,2673446010,201392388,47873,21726,2024-10-04 19:31:14,4793,921,5714,5,4,9
3,2673446010,201392388,47873,52396,2024-10-04 19:31:14,0,0,0,0,0,0
3,2673446010,201392388,47873,27791,2024-10-04 19:31:14,0,0,0,0,0,0
1,2673446010,201392386,47873,60138,2024-10-04 19:31:15,0,0,0,0,0,0
2,2673446010,201392387,47873,31970,2024-10-04 19:31:15,0,0,0,0,0,0
3,2673446010,201392388,47873,21726,2024-10-04 19:31:15,6405,1757,8162,10,15,25
3,2673446010,201392388,47873,52396,2024-10-04 19:31:15,0,0,0,0,0,0
3,2673446010,201392388,47873,27791,2024-10-04 19:31:15,0,0,0,0,0,0
1,2673446010,201392386,47873,60138,2024-10-04 19:31:16,0,0,0,0,0,0
2,2673446010,201392387,47873,31970,2024-10-04 19:31:16,0,0,0,0,0,0
3,2673446010,201392388,47873,21726,2024-10-04 19:31:16,0,0,0,0,0,0
3,2673446010,201392388,47873,52396,2024-10-04 19:31:16,0,0,0,0,0,0
3,2673446010,201392388,47873,27791,2024-10-04 19:31:16,0,0,0,0,0,0
1,2673446010,201392386,47873,60138,2024-10-04 19:31:17,0,0,0,0,0,0
2,2673446010,201392387,47873,31970,2024-10-04 19:31:17,0,0,0,0,0,0
3,2673446010,201392388,47873,21726,2024-10-04 19:31:17,0,0,0,0,0,0
3,2673446010,201392388,47873,52396,2024-10-04 19:31:17,0,0,0,0,0,0
3,2673446010,201392388,47873,27791,2024-10-04 19:31:17,0,0,0,0,0,0
1,2673446010,201392386,47873,60138,2024-10-04 19:31:18,0,0,0,0,0,0
2,2673446010,201392387,47873,31970,2024-10-04 19:31:18,0,0,0,0,0,0
3,2673446010,201392388,47873,21726,2024-10-04 19:31:18,0,0,0,0,0,0
3,2673446010,201392388,47873,52396,2024-10-04 19:31:18,0,0,0,0,0,0
3,2673446010,201392388,47873,27791,2024-10-04 19:31:18,0,0,0,0,0,0
1,2673446010,201392386,47873,23193,2024-10-04 19:31:19,0,104,104,0,1,1
1,2673446010,201392386,47873,60138,2024-10-04 19:31:19,0,0,0,0,0,0
2,2673446010,201392387,47873,31970,2024-10-04 19:31:19,0,0,0,0,0,0
3,2673446010,201392388,47873,21726,2024-10-04 19:31:19,0,0,0,0,0,0
3,2673446010,201392388,47873,52396,2024-10-04 19:31:19,0,0,0,0,0,0
3,2673446010,201392388,47873,27791,2024-10-04 19:31:19,0,0,0,0,0,0
1,2673446010,201392386,47873,23193,2024-10-04 19:31:20,11038,2322,13360,13,15,28
2,2673446010,201392387,47873,11491,2024-10-04 19:31:20,60,200,260,1,2,3
2,2673446010,201392387,47873,31970,2024-10-04 19:31:20,0,0,0,0,0,0
3,2673446010,201392388,47873,21726,2024-10-04 19:31:20,0,0,0,0,0,0
3,2673446010,201392388,47873,52396,2024-10-04 19:31:20,0,0,0,0,0,0
3,2673446010,201392388,47873,27791,2024-10-04 19:31:20,0,0,0,0,0,0
1,2673446010,201392386,47873,23193,2024-10-04 19:31:21,0,0,0,0,0,0
2,2673446010,201392387,47873,11491,2024-10-04 19:31:21,0,0,0,0,0,0
2,2673446010,201392387,47873,31970,2024-10-04 19:31:21,0,0,0,0,0,0
3,2673446010,201392388,47873,21726,2024-10-04 19:31:21,0,0,0,0,0,0
3,2673446010,201392388,47873,52396,2024-10-04 19:31:21,0,0,0,0,0,0
3,2673446010,201392388,47873,27791,2024-10-04 19:31:21,0,0,0,0,0,0
1,2673446010,201392386,47873,23193,2024-10-04 19:31:22,52,168,220,1,2,3
2,2673446010,201392387,47873,11491,2024-10-04 19:31:22,11127,2394,13521,14,16,30
2,2673446010,201392387,47873,31970,2024-10-04 19:31:22,0,0,0,0,0,0
3,2673446010,201392388,47873,52396,2024-10-04 19:31:22,0,0,0,0,0,0
3,2673446010,201392388,47873,27791,2024-10-04 19:31:22,0,0,0,0,0,0
1,2673446010,201392386,47873,23193,2024-10-04 19:31:23,0,0,0,0,0,0
2,2673446010,201392387,47873,11491,2024-10-04 19:31:23,0,0,0,0,0,0
2,2673446010,201392387,47873,31970,2024-10-04 19:31:23,0,0,0,0,0,0
3,2673446010,201392388,47873,52396,2024-10-04 19:31:23,0,0,0,0,0,0
3,2673446010,201392388,47873,27791,2024-10-04 19:31:23,0,0,0,0,0,0
1,2673446010,201392386,47873,23193,2024-10-04 19:31:24,0,0,0,0,0,0
2,2673446010,201392387,47873,11491,2024-10-04 19:31:24,0,0,0,0,0,0
2,2673446010,201392387,47873,31970,2024-10-04 19:31:24,0,0,0,0,0,0
3,2673446010,201392388,47873,52396,2024-10-04 19:31:24,0,0,0,0,0,0
3,2673446010,201392388,47873,27791,2024-10-04 19:31:24,0,0,0,0,0,0
1,2673446010,201392386,47873,23193,2024-10-04 19:31:25,0,0,0,0,0,0
2,2673446010,201392387,47873,11491,2024-10-04 19:31:25,0,0,0,0,0,0
2,2673446010,201392387,47873,31970,2024-10-04 19:31:25,0,0,0,0,0,0
3,2673446010,201392388,47873,52396,2024-10-04 19:31:25,0,0,0,0,0,0
3,2673446010,201392388,47873,27791,2024-10-04 19:31:25,0,0,0,0,0,0
1,2673446010,201392386,47873,23193,2024-10-04 19:31:26,0,0,0,0,0,0
2,2673446010,201392387,47873,11491,2024-10-04 19:31:26,0,0,0,0,0,0
2,2673446010,201392387,47873,31970,2024-10-04 19:31:26,0,0,0,0,0,0
3,2673446010,201392388,47873,52396,2024-10-04 19:31:26,0,0,0,0,0,0
3,2673446010,201392388,47873,27791,2024-10-04 19:31:26,0,0,0,0,0,0
1,2673446010,201392386,47873,23193,2024-10-04 19:31:27,0,0,0,0,0,0
2,2673446010,201392387,47873,11491,2024-10-04 19:31:27,0,0,0,0,0,0
2,2673446010,201392387,47873,31970,2024-10-04 19:31:27,0,0,0,0,0,0
3,2673446010,201392388,47873,52396,2024-10-04 19:31:27,0,0,0,0,0,0
3,2673446010,201392388,47873,27791,2024-10-04 19:31:27,0,0,0,0,0,0
1,2673446010,201392386,47873,23193,2024-10-04 19:31:28,0,0,0,0,0,0
2,2673446010,201392387,47873,11491,2024-10-04 19:31:28,0,0,0,0,0,0
2,2673446010,201392387,47873,31970,2024-10-04 19:31:28,0,0,0,0,0,0
3,2673446010,201392388,47873,52396,2024-10-04 19:31:28,0,0,0,0,0,0
3,2673446010,201392388,47873,27791,2024-10-04 19:31:28,0,0,0,0,0,0
1,2673446010,201392386,47873,23193,2024-10-04 19:31:29,0,0,0,0,0,0
2,2673446010,201392387,47873,11491,2024-10-04 19:31:29,0,0,0,0,0,0
2,2673446010,201392387,47873,31970,2024-10-04 19:31:29,0,0,0,0,0,0
3,2673446010,201392388,47873,52396,2024-10-04 19:31:29,0,0,0,0,0,0
3,2673446010,201392388,47873,27791,2024-10-04 19:31:29,0,0,0,0,0,0
1,2673446010,201392386,47873,23193,2024-10-04 19:31:30,0,0,0,0,0,0
2,2673446010,201392387,47873,31970,2024-10-04 19:31:30,0,0,0,0,0,0
3,2673446010,201392388,47873,52396,2024-10-04 19:31:30,0,0,0,0,0,0
3,2673446010,201392388,47873,27791,2024-10-04 19:31:30,0,0,0,0,0,0
1,2673446010,201392386,47873,23193,2024-10-04 19:31:31,0,0,0,0,0,0
2,2673446010,201392387,47873,31970,2024-10-04 19:31:31,0,0,0,0,0,0
3,2673446010,201392388,47873,52396,2024-10-04 19:31:31,0,0,0,0,0,0
3,2673446010,201392388,47873,27791,2024-10-04 19:31:31,0,0,0,0,0,0
1,2673446010,201392386,47873,23193,2024-10-04 19:31:32,0,0,0,0,0,0
2,2673446010,201392387,47873,31970,2024-10-04 19:31:32,0,0,0,0,0,0
3,2673446010,201392388,47873,52396,2024-10-04 19:31:32,0,0,0,0,0,0
3,2673446010,201392388,47873,27791,2024-10-04 19:31:32,0,0,0,0,0,0
1,2673446010,201392386,47873,23193,2024-10-04 19:31:33,0,0,0,0,0,0
2,2673446010,201392387,47873,31970,2024-10-04 19:31:33,0,0,0,0,0,0
3,2673446010,201392388,47873,52396,2024-10-04 19:31:33,0,0,0,0,0,0
3,2673446010,201392388,47873,27791,2024-10-04 19:31:33,0,0,0,0,0,0
1,2673446010,201392386,47873,23193,2024-10-04 19:31:34,0,0,0,0,0,0
2,2673446010,201392387,47873,31970,2024-10-04 19:31:34,0,0,0,0,0,0
3,2673446010,201392388,47873,52396,2024-10-04 19:31:34,0,0,0,0,0,0
3,2673446010,201392388,47873,27791,2024-10-04 19:31:34,0,0,0,0,0,0
1,2673446010,201392386,47873,23193,2024-10-04 19:31:35,0,0,0,0,0,0
2,2673446010,201392387,47873,31970,2024-10-04 19:31:35,0,0,0,0,0,0
3,2673446010,201392388,47873,52396,2024-10-04 19:31:35,0,0,0,0,0,0
3,2673446010,201392388,47873,27791,2024-10-04 19:31:35,0,0,0,0,0,0
1,2673446010,201392386,47873,23193,2024-10-04 19:31:36,0,0,0,0,0,0
2,2673446010,201392387,47873,31970,2024-10-04 19:31:36,0,0,0,0,0,0
3,2673446010,201392388,47873,52396,2024-10-04 19:31:36,0,0,0,0,0,0
3,2673446010,201392388,47873,27791,2024-10-04 19:31:36,0,0,0,0,0,0
1,2673446010,201392386,47873,23193,2024-10-04 19:31:37,0,0,0,0,0,0
2,2673446010,201392387,47873,31970,2024-10-04 19:31:37,0,0,0,0,0,0
3,2673446010,201392388,47873,52396,2024-10-04 19:31:37,0,0,0,0,0,0
3,2673446010,201392388,47873,27791,2024-10-04 19:31:37,0,0,0,0,0,0
1,2673446010,201392386,47873,23193,2024-10-04 19:31:38,0,0,0,0,0,0
2,2673446010,201392387,47873,31970,2024-10-04 19:31:38,0,0,0,0,0,0
3,2673446010,201392388,47873,52396,2024-10-04 19:31:38,0,0,0,0,0,0
3,2673446010,201392388,47873,27791,2024-10-04 19:31:38,0,0,0,0,0,0
1,2673446010,201392386,47873,23193,2024-10-04 19:31:39,0,0,0,0,0,0
2,2673446010,201392387,47873,31970,2024-10-04 19:31:39,0,0,0,0,0,0
3,2673446010,201392388,47873,52396,2024-10-04 19:31:39,0,0,0,0,0,0
3,2673446010,201392388,47873,27791,2024-10-04 19:31:39,0,0,0,0,0,0
1,2673446010,201392386,47873,23193,2024-10-04 19:31:40,0,0,0,0,0,0
2,2673446010,201392387,47873,31970,2024-10-04 19:31:40,0,0,0,0,0,0
3,2673446010,201392388,47873,52396,2024-10-04 19:31:40,0,0,0,0,0,0
3,2673446010,201392388,47873,27791,2024-10-04 19:31:40,0,0,0,0,0,0
1,2673446010,201392386,47873,23193,2024-10-04 19:31:41,0,0,0,0,0,0
2,2673446010,201392387,47873,31970,2024-10-04 19:31:41,0,0,0,0,0,0
3,2673446010,201392388,47873,52396,2024-10-04 19:31:41,0,0,0,0,0,0
3,2673446010,201392388,47873,27791,2024-10-04 19:31:41,0,0,0,0,0,0
1,2673446010,201392386,47873,23193,2024-10-04 19:31:42,0,0,0,0,0,0
2,2673446010,201392387,47873,31970,2024-10-04 19:31:42,0,0,0,0,0,0
3,2673446010,201392388,47873,52396,2024-10-04 19:31:42,0,0,0,0,0,0
3,2673446010,201392388,47873,27791,2024-10-04 19:31:42,0,0,0,0,0,0
1,2673446010,201392386,47873,23193,2024-10-04 19:31:43,0,0,0,0,0,0
2,2673446010,201392387,47873,31970,2024-10-04 19:31:43,0,0,0,0,0,0
3,2673446010,201392388,47873,52396,2024-10-04 19:31:43,0,0,0,0,0,0
3,2673446010,201392388,47873,27791,2024-10-04 19:31:43,0,0,0,0,0,0
1,2673446010,201392386,47873,23193,2024-10-04 19:31:44,0,0,0,0,0,0
2,2673446010,201392387,47873,31970,2024-10-04 19:31:44,0,0,0,0,0,0
3,2673446010,201392388,47873,52396,2024-10-04 19:31:44,0,0,0,0,0,0
3,2673446010,201392388,47873,27791,2024-10-04 19:31:44,0,0,0,0,0,0
1,2673446010,201392386,47873,23193,2024-10-04 19:31:45,0,0,0,0,0,0
2,2673446010,201392387,47873,31970,2024-10-04 19:31:45,0,0,0,0,0,0
3,2673446010,201392388,47873,52396,2024-10-04 19:31:45,0,0,0,0,0,0
3,2673446010,201392388,47873,27791,2024-10-04 19:31:45,0,0,0,0,0,0
1,2673446010,201392386,47873,23193,2024-10-04 19:31:46,0,0,0,0,0,0
3,2673446010,201392388,47873,30888,2024-10-04 19:31:46,7164,2546,9710,15,18,33
2,2673446010,201392387,47873,31970,2024-10-04 19:31:46,0,0,0,0,0,0
3,2673446010,201392388,47873,52396,2024-10-04 19:31:46,0,0,0,0,0,0
3,2673446010,201392388,47873,27791,2024-10-04 19:31:46,0,0,0,0,0,0
1,2673446010,201392386,47873,23193,2024-10-04 19:31:47,0,0,0,0,0,0
3,2673446010,201392388,47873,30888,2024-10-04 19:31:47,0,0,0,0,0,0
2,2673446010,201392387,47873,31970,2024-10-04 19:31:47,0,0,0,0,0,0
3,2673446010,201392388,47873,52396,2024-10-04 19:31:47,0,0,0,0,0,0
3,2673446010,201392388,47873,27791,2024-10-04 19:31:47,0,0,0,0,0,0
1,2673446010,201392386,47873,23193,2024-10-04 19:31:48,0,0,0,0,0,0
3,2673446010,201392388,47873,30888,2024-10-04 19:31:48,0,0,0,0,0,0
2,2673446010,201392387,47873,31970,2024-10-04 19:31:48,0,0,0,0,0,0
3,2673446010,201392388,47873,52396,2024-10-04 19:31:48,0,0,0,0,0,0
3,2673446010,201392388,47873,27791,2024-10-04 19:31:48,0,0,0,0,0,0
1,2673446010,201392386,47873,23193,2024-10-04 19:31:49,0,0,0,0,0,0
3,2673446010,201392388,47873,30888,2024-10-04 19:31:49,0,0,0,0,0,0
2,2673446010,201392387,47873,31970,2024-10-04 19:31:49,0,0,0,0,0,0
3,2673446010,201392388,47873,52396,2024-10-04 19:31:49,0,0,0,0,0,0
3,2673446010,201392388,47873,27791,2024-10-04 19:31:49,0,0,0,0,0,0
1,2673446010,201392386,47873,23193,2024-10-04 19:31:50,0,0,0,0,0,0
3,2673446010,201392388,47873,30888,2024-10-04 19:31:50,0,0,0,0,0,0
2,2673446010,201392387,47873,31970,2024-10-04 19:31:50,0,0,0,0,0,0
1,2673446010,201392386,47873,1716,2024-10-04 19:31:50,0,104,104,0,1,1
3,2673446010,201392388,47873,52396,2024-10-04 19:31:50,0,0,0,0,0,0
3,2673446010,201392388,47873,27791,2024-10-04 19:31:50,0,0,0,0,0,0
3,2673446010,201392388,47873,30888,2024-10-04 19:31:51,0,0,0,0,0,0
2,2673446010,201392387,47873,31970,2024-10-04 19:31:51,0,0,0,0,0,0
2,2673446010,201392387,47873,32404,2024-10-04 19:31:51,3374,813,4187,4,3,7
1,2673446010,201392386,47873,1716,2024-10-04 19:31:51,9200,2478,11678,15,17,32
3,2673446010,201392388,47873,52396,2024-10-04 19:31:51,0,0,0,0,0,0
3,2673446010,201392388,47873,27791,2024-10-04 19:31:51,0,0,0,0,0,0
3,2673446010,201392388,47873,30888,2024-10-04 19:31:52,0,0,0,0,0,0
2,2673446010,201392387,47873,31970,2024-10-04 19:31:52,0,0,0,0,0,0
2,2673446010,201392387,47873,32404,2024-10-04 19:31:52,0,0,0,0,0,0
1,2673446010,201392386,47873,1716,2024-10-04 19:31:52,0,0,0,0,0,0
3,2673446010,201392388,47873,52396,2024-10-04 19:31:52,0,0,0,0,0,0
3,2673446010,201392388,47873,27791,2024-10-04 19:31:52,0,0,0,0,0,0
2,2673446010,201392387,47873,31970,2024-10-04 19:31:53,0,0,0,0,0,0
2,2673446010,201392387,47873,32404,2024-10-04 19:31:53,7831,1781,9612,11,15,26
1,2673446010,201392386,47873,1716,2024-10-04 19:31:53,0,0,0,0,0,0
3,2673446010,201392388,47873,52396,2024-10-04 19:31:53,0,0,0,0,0,0
3,2673446010,201392388,47873,27791,2024-10-04 19:31:53,0,0,0,0,0,0
2,2673446010,201392387,47873,31970,2024-10-04 19:31:54,0,0,0,0,0,0
2,2673446010,201392387,47873,32404,2024-10-04 19:31:54,0,0,0,0,0,0
1,2673446010,201392386,47873,1716,2024-10-04 19:31:54,0,0,0,0,0,0
3,2673446010,201392388,47873,52396,2024-10-04 19:31:54,0,0,0,0,0,0
3,2673446010,201392388,47873,27791,2024-10-04 19:31:54,0,0,0,0,0,0
2,2673446010,201392387,47873,31970,2024-10-04 19:31:55,0,0,0,0,0,0
2,2673446010,201392387,47873,32404,2024-10-04 19:31:55,0,0,0,0,0,0
1,2673446010,201392386,47873,1716,2024-10-04 19:31:55,0,0,0,0,0,0
3,2673446010,201392388,47873,52396,2024-10-04 19:31:55,0,0,0,0,0,0
3,2673446010,201392388,47873,27791,2024-10-04 19:31:55,0,0,0,0,0,0
2,2673446010,201392387,47873,31970,2024-10-04 19:31:56,0,0,0,0,0,0
2,2673446010,201392387,47873,32404,2024-10-04 19:31:56,0,0,0,0,0,0
1,2673446010,201392386,47873,1716,2024-10-04 19:31:56,0,0,0,0,0,0
3,2673446010,201392388,47873,52396,2024-10-04 19:31:56,0,0,0,0,0,0
3,2673446010,201392388,47873,27791,2024-10-04 19:31:56,0,0,0,0,0,0
2,2673446010,201392387,47873,31970,2024-10-04 19:31:57,0,0,0,0,0,0
2,2673446010,201392387,47873,32404,2024-10-04 19:31:57,0,0,0,0,0,0
1,2673446010,201392386,47873,1716,2024-10-04 19:31:57,0,0,0,0,0,0
3,2673446010,201392388,47873,52396,2024-10-04 19:31:57,0,0,0,0,0,0
3,2673446010,201392388,47873,27791,2024-10-04 19:31:57,0,0,0,0,0,0
2,2673446010,201392387,47873,31970,2024-10-04 19:31:58,0,0,0,0,0,0
2,2673446010,201392387,47873,32404,2024-10-04 19:31:58,0,0,0,0,0,0
1,2673446010,201392386,47873,1716,2024-10-04 19:31:58,0,0,0,0,0,0
3,2673446010,201392388,47873,52396,2024-10-04 19:31:58,0,0,0,0,0,0
3,2673446010,201392388,47873,27791,2024-10-04 19:31:58,0,0,0,0,0,0
2,2673446010,201392387,47873,31970,2024-10-04 19:31:59,0,0,0,0,0,0
2,2673446010,201392387,47873,32404,2024-10-04 19:31:59,0,0,0,0,0,0
1,2673446010,201392386,47873,1716,2024-10-04 19:31:59,0,0,0,0,0,0
3,2673446010,201392388,47873,52396,2024-10-04 19:31:59,0,0,0,0,0,0
3,2673446010,201392388,47873,27791,2024-10-04 19:31:59,0,0,0,0,0,0
2,2673446010,201392387,47873,31970,2024-10-04 19:32:00,0,0,0,0,0,0
2,2673446010,201392387,47873,32404,2024-10-04 19:32:00,0,0,0,0,0,0
1,2673446010,201392386,47873,1716,2024-10-04 19:32:00,0,0,0,0,0,0
3,2673446010,201392388,47873,52396,2024-10-04 19:32:00,0,0,0,0,0,0
3,2673446010,201392388,47873,27791,2024-10-04 19:32:00,0,0,0,0,0,0
2,2673446010,201392387,47873,31970,2024-10-04 19:32:01,0,0,0,0,0,0
1,2673446010,201392386,47873,1716,2024-10-04 19:32:01,0,0,0,0,0,0
3,2673446010,201392388,47873,52396,2024-10-04 19:32:01,0,0,0,0,0,0
3,2673446010,201392388,47873,27791,2024-10-04 19:32:01,0,0,0,0,0,0
2,2673446010,201392387,47873,31970,2024-10-04 19:32:02,0,0,0,0,0,0
1,2673446010,201392386,47873,1716,2024-10-04 19:32:02,0,0,0,0,0,0
3,2673446010,201392388,47873,52396,2024-10-04 19:32:02,0,0,0,0,0,0
3,2673446010,201392388,47873,27791,2024-10-04 19:32:02,0,0,0,0,0,0
2,2673446010,201392387,47873,31970,2024-10-04 19:32:03,0,0,0,0,0,0
1,2673446010,201392386,47873,1716,2024-10-04 19:32:03,0,0,0,0,0,0
3,2673446010,201392388,47873,52396,2024-10-04 19:32:03,0,0,0,0,0,0
3,2673446010,201392388,47873,27791,2024-10-04 19:32:03,0,0,0,0,0,0
2,2673446010,201392387,47873,31970,2024-10-04 19:32:04,0,0,0,0,0,0
1,2673446010,201392386,47873,1716,2024-10-04 19:32:04,0,0,0,0,0,0
3,2673446010,201392388,47873,52396,2024-10-04 19:32:04,0,0,0,0,0,0
3,2673446010,201392388,47873,27791,2024-10-04 19:32:04,0,0,0,0,0,0
2,2673446010,201392387,47873,31970,2024-10-04 19:32:05,0,0,0,0,0,0
1,2673446010,201392386,47873,1716,2024-10-04 19:32:05,0,0,0,0,0,0
3,2673446010,201392388,47873,52396,2024-10-04 19:32:05,0,0,0,0,0,0
3,2673446010,201392388,47873,27791,2024-10-04 19:32:05,0,0,0,0,0,0
2,2673446010,201392387,47873,31970,2024-10-04 19:32:06,0,0,0,0,0,0
1,2673446010,201392386,47873,1716,2024-10-04 19:32:06,0,0,0,0,0,0
3,2673446010,201392388,47873,52396,2024-10-04 19:32:06,0,0,0,0,0,0
3,2673446010,201392388,47873,27791,2024-10-04 19:32:06,0,0,0,0,0,0
2,2673446010,201392387,47873,31970,2024-10-04 19:32:07,0,0,0,0,0,0
1,2673446010,201392386,47873,1716,2024-10-04 19:32:07,0,0,0,0,0,0
3,2673446010,201392388,47873,52396,2024-10-04 19:32:07,0,0,0,0,0,0
3,2673446010,201392388,47873,27791,2024-10-04 19:32:07,0,0,0,0,0,0
2,2673446010,201392387,47873,31970,2024-10-04 19:32:08,0,0,0,0,0,0
1,2673446010,201392386,47873,1716,2024-10-04 19:32:08,0,0,0,0,0,0
3,2673446010,201392388,47873,52396,2024-10-04 19:32:08,0,0,0,0,0,0
3,2673446010,201392388,47873,27791,2024-10-04 19:32:08,0,0,0,0,0,0
2,2673446010,201392387,47873,31970,2024-10-04 19:32:09,0,0,0,0,0,0
1,2673446010,201392386,47873,1716,2024-10-04 19:32:09,0,0,0,0,0,0
3,2673446010,201392388,47873,52396,2024-10-04 19:32:09,0,0,0,0,0,0
3,2673446010,201392388,47873,27791,2024-10-04 19:32:09,0,0,0,0,0,0
2,2673446010,201392387,47873,31970,2024-10-04 19:32:10,0,0,0,0,0,0
1,2673446010,201392386,47873,1716,2024-10-04 19:32:10,0,0,0,0,0,0
3,2673446010,201392388,47873,52396,2024-10-04 19:32:10,0,0,0,0,0,0
3,2673446010,201392388,47873,27791,2024-10-04 19:32:10,0,0,0,0,0,0
2,2673446010,201392387,47873,31970,2024-10-04 19:32:11,0,0,0,0,0,0
1,2673446010,201392386,47873,1716,2024-10-04 19:32:11,0,0,0,0,0,0
3,2673446010,201392388,47873,52396,2024-10-04 19:32:11,0,0,0,0,0,0
3,2673446010,201392388,47873,27791,2024-10-04 19:32:11,0,0,0,0,0,0
2,2673446010,201392387,47873,31970,2024-10-04 19:32:12,0,0,0,0,0,0
1,2673446010,201392386,47873,1716,2024-10-04 19:32:12,0,0,0,0,0,0
3,2673446010,201392388,47873,52396,2024-10-04 19:32:12,0,0,0,0,0,0
3,2673446010,201392388,47873,27791,2024-10-04 19:32:12,0,0,0,0,0,0
2,2673446010,201392387,47873,31970,2024-10-04 19:32:13,0,0,0,0,0,0
1,2673446010,201392386,47873,1716,2024-10-04 19:32:13,0,0,0,0,0,0
3,2673446010,201392388,47873,52396,2024-10-04 19:32:13,0,0,0,0,0,0
3,2673446010,201392388,47873,27791,2024-10-04 19:32:13,0,0,0,0,0,0
2,2673446010,201392387,47873,31970,2024-10-04 19:32:14,0,0,0,0,0,0
1,2673446010,201392386,47873,1716,2024-10-04 19:32:14,0,0,0,0,0,0
3,2673446010,201392388,47873,52396,2024-10-04 19:32:14,0,0,0,0,0,0
3,2673446010,201392388,47873,27791,2024-10-04 19:32:14,0,0,0,0,0,0
2,2673446010,201392387,47873,31970,2024-10-04 19:32:15,0,0,0,0,0,0
1,2673446010,201392386,47873,1716,2024-10-04 19:32:15,0,0,0,0,0,0
3,2673446010,201392388,47873,52396,2024-10-04 19:32:15,0,0,0,0,0,0
3,2673446010,201392388,47873,27791,2024-10-04 19:32:15,0,0,0,0,0,0
2,2673446010,201392387,47873,31970,2024-10-04 19:32:16,0,0,0,0,0,0
3,2673446010,201392388,47873,53898,2024-10-04 19:32:16,0,104,104,0,1,1
1,2673446010,201392386,47873,1716,2024-10-04 19:32:16,0,0,0,0,0,0
3,2673446010,201392388,47873,52396,2024-10-04 19:32:16,0,0,0,0,0,0
3,2673446010,201392388,47873,27791,2024-10-04 19:32:16,0,0,0,0,0,0
2,2673446010,201392387,47873,31970,2024-10-04 19:32:17,0,0,0,0,0,0
3,2673446010,201392388,47873,53898,2024-10-04 19:32:17,7162,2262,9424,15,15,30
1,2673446010,201392386,47873,1716,2024-10-04 19:32:17,0,0,0,0,0,0
3,2673446010,201392388,47873,52396,2024-10-04 19:32:17,0,0,0,0,0,0
3,2673446010,201392388,47873,27791,2024-10-04 19:32:17,0,0,0,0,0,0
2,2673446010,201392387,47873,31970,2024-10-04 19:32:18,0,0,0,0,0,0
3,2673446010,201392388,47873,53898,2024-10-04 19:32:18,0,0,0,0,0,0
1,2673446010,201392386,47873,1716,2024-10-04 19:32:18,0,0,0,0,0,0
3,2673446010,201392388,47873,52396,2024-10-04 19:32:18,0,0,0,0,0,0
3,2673446010,201392388,47873,27791,2024-10-04 19:32:18,0,0,0,0,0,0
2,2673446010,201392387,47873,31970,2024-10-04 19:32:19,0,0,0,0,0,0
3,2673446010,201392388,47873,53898,2024-10-04 19:32:19,0,0,0,0,0,0
1,2673446010,201392386,47873,1716,2024-10-04 19:32:19,0,0,0,0,0,0
3,2673446010,201392388,47873,52396,2024-10-04 19:32:19,0,0,0,0,0,0
3,2673446010,201392388,47873,27791,2024-10-04 19:32:19,0,0,0,0,0,0
1,2673446010,201392386,47873,8915,2024-10-04 19:32:20,60,200,260,1,2,3
2,2673446010,201392387,47873,31970,2024-10-04 19:32:20,0,0,0,0,0,0
3,2673446010,201392388,47873,53898,2024-10-04 19:32:20,0,0,0,0,0,0
1,2673446010,201392386,47873,1716,2024-10-04 19:32:20,0,0,0,0,0,0
3,2673446010,201392388,47873,52396,2024-10-04 19:32:20,0,0,0,0,0,0
3,2673446010,201392388,47873,27791,2024-10-04 19:32:20,0,0,0,0,0,0
1,2673446010,201392386,47873,8915,2024-10-04 19:32:21,9202,2466,11668,16,17,33
2,2673446010,201392387,47873,31970,2024-10-04 19:32:21,0,0,0,0,0,0
3,2673446010,201392388,47873,53898,2024-10-04 19:32:21,0,0,0,0,0,0
3,2673446010,201392388,47873,52396,2024-10-04 19:32:21,0,0,0,0,0,0
3,2673446010,201392388,47873,27791,2024-10-04 19:32:21,0,0,0,0,0,0
1,2673446010,201392386,47873,8915,2024-10-04 19:32:22,0,0,0,0,0,0
2,2673446010,201392387,47873,31970,2024-10-04 19:32:22,0,0,0,0,0,0
2,2673446010,201392387,47873,7345,2024-10-04 19:32:22,0,104,104,0,1,1
3,2673446010,201392388,47873,52396,2024-10-04 19:32:22,0,0,0,0,0,0
3,2673446010,201392388,47873,27791,2024-10-04 19:32:22,0,0,0,0,0,0
1,2673446010,201392386,47873,8915,2024-10-04 19:32:23,0,0,0,0,0,0
2,2673446010,201392387,47873,31970,2024-10-04 19:32:23,0,0,0,0,0,0
2,2673446010,201392387,47873,7345,2024-10-04 19:32:23,11074,2418,13492,14,16,30
3,2673446010,201392388,47873,52396,2024-10-04 19:32:23,0,0,0,0,0,0
3,2673446010,201392388,47873,27791,2024-10-04 19:32:23,0,0,0,0,0,0
1,2673446010,201392386,47873,8915,2024-10-04 19:32:24,0,0,0,0,0,0
2,2673446010,201392387,47873,31970,2024-10-04 19:32:24,0,0,0,0,0,0
2,2673446010,201392387,47873,7345,2024-10-04 19:32:24,52,168,220,1,2,3
3,2673446010,201392388,47873,52396,2024-10-04 19:32:24,0,0,0,0,0,0
3,2673446010,201392388,47873,27791,2024-10-04 19:32:24,0,0,0,0,0,0
1,2673446010,201392386,47873,8915,2024-10-04 19:32:25,0,0,0,0,0,0
2,2673446010,201392387,47873,31970,2024-10-04 19:32:25,0,0,0,0,0,0
2,2673446010,201392387,47873,7345,2024-10-04 19:32:25,0,0,0,0,0,0
3,2673446010,201392388,47873,52396,2024-10-04 19:32:25,0,0,0,0,0,0
3,2673446010,201392388,47873,27791,2024-10-04 19:32:25,0,0,0,0,0,0
1,2673446010,201392386,47873,8915,2024-10-04 19:32:26,0,0,0,0,0,0
2,2673446010,201392387,47873,31970,2024-10-04 19:32:26,0,0,0,0,0,0
2,2673446010,201392387,47873,7345,2024-10-04 19:32:26,0,0,0,0,0,0
3,2673446010,201392388,47873,52396,2024-10-04 19:32:26,0,0,0,0,0,0
3,2673446010,201392388,47873,27791,2024-10-04 19:32:26,0,0,0,0,0,0
1,2673446010,201392386,47873,8915,2024-10-04 19:32:27,0,0,0,0,0,0
2,2673446010,201392387,47873,31970,2024-10-04 19:32:27,0,0,0,0,0,0
2,2673446010,201392387,47873,7345,2024-10-04 19:32:27,0,0,0,0,0,0
3,2673446010,201392388,47873,52396,2024-10-04 19:32:27,0,0,0,0,0,0
3,2673446010,201392388,47873,27791,2024-10-04 19:32:27,0,0,0,0,0,0
1,2673446010,201392386,47873,8915,2024-10-04 19:32:28,0,0,0,0,0,0
2,2673446010,201392387,47873,31970,2024-10-04 19:32:28,0,0,0,0,0,0
2,2673446010,201392387,47873,7345,2024-10-04 19:32:28,0,0,0,0,0,0
3,2673446010,201392388,47873,52396,2024-10-04 19:32:28,0,0,0,0,0,0
3,2673446010,201392388,47873,27791,2024-10-04 19:32:28,0,0,0,0,0,0
1,2673446010,201392386,47873,8915,2024-10-04 19:32:29,0,0,0,0,0,0
2,2673446010,201392387,47873,31970,2024-10-04 19:32:29,0,0,0,0,0,0
2,2673446010,201392387,47873,7345,2024-10-04 19:32:29,0,0,0,0,0,0
3,2673446010,201392388,47873,52396,2024-10-04 19:32:29,0,0,0,0,0,0
3,2673446010,201392388,47873,27791,2024-10-04 19:32:29,0,0,0,0,0,0
1,2673446010,201392386,47873,8915,2024-10-04 19:32:30,0,0,0,0,0,0
2,2673446010,201392387,47873,31970,2024-10-04 19:32:30,0,0,0,0,0,0
2,2673446010,201392387,47873,7345,2024-10-04 19:32:30,0,0,0,0,0,0
3,2673446010,201392388,47873,52396,2024-10-04 19:32:30,0,0,0,0,0,0
3,2673446010,201392388,47873,27791,2024-10-04 19:32:30,0,0,0,0,0,0
1,2673446010,201392386,47873,8915,2024-10-04 19:32:31,0,0,0,0,0,0
2,2673446010,201392387,47873,31970,2024-10-04 19:32:31,0,0,0,0,0,0
3,2673446010,201392388,47873,52396,2024-10-04 19:32:31,0,0,0,0,0,0
3,2673446010,201392388,47873,27791,2024-10-04 19:32:31,0,0,0,0,0,0
1,2673446010,201392386,47873,8915,2024-10-04 19:32:32,0,0,0,0,0,0
2,2673446010,201392387,47873,31970,2024-10-04 19:32:32,0,0,0,0,0,0
3,2673446010,201392388,47873,52396,2024-10-04 19:32:32,0,0,0,0,0,0
3,2673446010,201392388,47873,27791,2024-10-04 19:32:32,0,0,0,0,0,0
1,2673446010,201392386,47873,8915,2024-10-04 19:32:33,0,0,0,0,0,0
2,2673446010,201392387,47873,31970,2024-10-04 19:32:33,0,0,0,0,0,0
3,2673446010,201392388,47873,52396,2024-10-04 19:32:33,0,0,0,0,0,0
3,2673446010,201392388,47873,27791,2024-10-04 19:32:33,0,0,0,0,0,0
1,2673446010,201392386,47873,8915,2024-10-04 19:32:34,0,0,0,0,0,0
2,2673446010,201392387,47873,31970,2024-10-04 19:32:34,0,0,0,0,0,0
3,2673446010,201392388,47873,52396,2024-10-04 19:32:34,0,0,0,0,0,0
3,2673446010,201392388,47873,27791,2024-10-04 19:32:34,0,0,0,0,0,0
1,2673446010,201392386,47873,8915,2024-10-04 19:32:35,0,0,0,0,0,0
2,2673446010,201392387,47873,31970,2024-10-04 19:32:35,0,0,0,0,0,0
3,2673446010,201392388,47873,52396,2024-10-04 19:32:35,0,0,0,0,0,0
3,2673446010,201392388,47873,27791,2024-10-04 19:32:35,0,0,0,0,0,0
1,2673446010,201392386,47873,8915,2024-10-04 19:32:36,0,0,0,0,0,0
2,2673446010,201392387,47873,31970,2024-10-04 19:32:36,0,0,0,0,0,0
3,2673446010,201392388,47873,52396,2024-10-04 19:32:36,0,0,0,0,0,0
3,2673446010,201392388,47873,27791,2024-10-04 19:32:36,0,0,0,0,0,0
1,2673446010,201392386,47873,8915,2024-10-04 19:32:37,0,0,0,0,0,0
2,2673446010,201392387,47873,31970,2024-10-04 19:32:37,0,0,0,0,0,0
3,2673446010,201392388,47873,52396,2024-10-04 19:32:37,0,0,0,0,0,0
3,2673446010,201392388,47873,27791,2024-10-04 19:32:37,0,0,0,0,0,0
1,2673446010,201392386,47873,8915,2024-10-04 19:32:38,0,0,0,0,0,0
2,2673446010,201392387,47873,31970,2024-10-04 19:32:38,0,0,0,0,0,0
3,2673446010,201392388,47873,52396,2024-10-04 19:32:38,0,0,0,0,0,0
3,2673446010,201392388,47873,27791,2024-10-04 19:32:38,0,0,0,0,0,0
1,2673446010,201392386,47873,8915,2024-10-04 19:32:39,0,0,0,0,0,0
2,2673446010,201392387,47873,31970,2024-10-04 19:32:39,0,0,0,0,0,0
3,2673446010,201392388,47873,52396,2024-10-04 19:32:39,0,0,0,0,0,0
3,2673446010,201392388,47873,27791,2024-10-04 19:32:39,0,0,0,0,0,0
1,2673446010,201392386,47873,8915,2024-10-04 19:32:40,0,0,0,0,0,0
2,2673446010,201392387,47873,31970,2024-10-04 19:32:40,0,0,0,0,0,0
3,2673446010,201392388,47873,52396,2024-10-04 19:32:40,0,0,0,0,0,0
3,2673446010,201392388,47873,27791,2024-10-04 19:32:40,0,0,0,0,0,0
1,2673446010,201392386,47873,8915,2024-10-04 19:32:41,0,0,0,0,0,0
2,2673446010,201392387,47873,31970,2024-10-04 19:32:41,0,0,0,0,0,0
3,2673446010,201392388,47873,52396,2024-10-04 19:32:41,0,0,0,0,0,0
3,2673446010,201392388,47873,27791,2024-10-04 19:32:41,0,0,0,0,0,0
1,2673446010,201392386,47873,8915,2024-10-04 19:32:42,0,0,0,0,0,0
2,2673446010,201392387,47873,31970,2024-10-04 19:32:42,0,0,0,0,0,0
3,2673446010,201392388,47873,52396,2024-10-04 19:32:42,0,0,0,0,0,0
3,2673446010,201392388,47873,27791,2024-10-04 19:32:42,0,0,0,0,0,0
1,2673446010,201392386,47873,8915,2024-10-04 19:32:43,0,0,0,0,0,0
2,2673446010,201392387,47873,31970,2024-10-04 19:32:43,0,0,0,0,0,0
3,2673446010,201392388,47873,52396,2024-10-04 19:32:43,0,0,0,0,0,0
3,2673446010,201392388,47873,27791,2024-10-04 19:32:43,0,0,0,0,0,0
1,2673446010,201392386,47873,8915,2024-10-04 19:32:44,0,0,0,0,0,0
2,2673446010,201392387,47873,31970,2024-10-04 19:32:44,0,0,0,0,0,0
3,2673446010,201392388,47873,52396,2024-10-04 19:32:44,0,0,0,0,0,0
3,2673446010,201392388,47873,27791,2024-10-04 19:32:44,0,0,0,0,0,0
1,2673446010,201392386,47873,8915,2024-10-04 19:32:45,0,0,0,0,0,0
2,2673446010,201392387,47873,31970,2024-10-04 19:32:45,0,0,0,0,0,0
3,2673446010,201392388,47873,15594,2024-10-04 19:32:45,0,104,104,0,1,1
3,2673446010,201392388,47873,52396,2024-10-04 19:32:45,0,0,0,0,0,0
3,2673446010,201392388,47873,27791,2024-10-04 19:32:45,0,0,0,0,0,0
1,2673446010,201392386,47873,8915,2024-10-04 19:32:46,0,0,0,0,0,0
2,2673446010,201392387,47873,31970,2024-10-04 19:32:46,0,0,0,0,0,0
3,2673446010,201392388,47873,15594,2024-10-04 19:32:46,5049,1890,6939,8,11,19
3,2673446010,201392388,47873,52396,2024-10-04 19:32:46,0,0,0,0,0,0
3,2673446010,201392388,47873,27791,2024-10-04 19:32:46,0,0,0,0,0,0
1,2673446010,201392386,47873,8915,2024-10-04 19:32:47,0,0,0,0,0,0
2,2673446010,201392387,47873,31970,2024-10-04 19:32:47,0,0,0,0,0,0
3,2673446010,201392388,47873,15594,2024-10-04 19:32:47,3972,672,4644,5,7,12
3,2673446010,201392388,47873,52396,2024-10-04 19:32:47,0,0,0,0,0,0
3,2673446010,201392388,47873,27791,2024-10-04 19:32:47,0,0,0,0,0,0
1,2673446010,201392386,47873,8915,2024-10-04 19:32:48,0,0,0,0,0,0
2,2673446010,201392387,47873,31970,2024-10-04 19:32:48,0,0,0,0,0,0
3,2673446010,201392388,47873,15594,2024-10-04 19:32:48,0,0,0,0,0,0
3,2673446010,201392388,47873,52396,2024-10-04 19:32:48,0,0,0,0,0,0
3,2673446010,201392388,47873,27791,2024-10-04 19:32:48,0,0,0,0,0,0
1,2673446010,201392386,47873,8915,2024-10-04 19:32:49,0,0,0,0,0,0
2,2673446010,201392387,47873,31970,2024-10-04 19:32:49,0,0,0,0,0,0
3,2673446010,201392388,47873,15594,2024-10-04 19:32:49,0,0,0,0,0,0
3,2673446010,201392388,47873,52396,2024-10-04 19:32:49,0,0,0,0,0,0
3,2673446010,201392388,47873,27791,2024-10-04 19:32:49,0,0,0,0,0,0
1,2673446010,201392386,47873,8915,2024-10-04 19:32:50,0,0,0,0,0,0
2,2673446010,201392387,47873,31970,2024-10-04 19:32:50,0,0,0,0,0,0
1,2673446010,201392386,47873,32903,2024-10-04 19:32:50,60,104,164,1,1,2
3,2673446010,201392388,47873,15594,2024-10-04 19:32:50,0,0,0,0,0,0
3,2673446010,201392388,47873,52396,2024-10-04 19:32:50,0,0,0,0,0,0
3,2673446010,201392388,47873,27791,2024-10-04 19:32:50,0,0,0,0,0,0
1,2673446010,201392386,47873,8915,2024-10-04 19:32:51,0,0,0,0,0,0
2,2673446010,201392387,47873,31970,2024-10-04 19:32:51,0,0,0,0,0,0
1,2673446010,201392386,47873,32903,2024-10-04 19:32:51,0,0,0,0,0,0
3,2673446010,201392388,47873,15594,2024-10-04 19:32:51,0,0,0,0,0,0
3,2673446010,201392388,47873,52396,2024-10-04 19:32:51,0,0,0,0,0,0
3,2673446010,201392388,47873,27791,2024-10-04 19:32:51,0,0,0,0,0,0
2,2673446010,201392387,47873,31970,2024-10-04 19:32:52,0,0,0,0,0,0
1,2673446010,201392386,47873,32903,2024-10-04 19:32:52,9242,2574,11816,15,18,33
3,2673446010,201392388,47873,15594,2024-10-04 19:32:52,0,0,0,0,0,0
3,2673446010,201392388,47873,52396,2024-10-04 19:32:52,0,0,0,0,0,0
3,2673446010,201392388,47873,27791,2024-10-04 19:32:52,0,0,0,0,0,0
2,2673446010,201392387,47873,31970,2024-10-04 19:32:53,0,0,0,0,0,0
1,2673446010,201392386,47873,32903,2024-10-04 19:32:53,0,0,0,0,0,0
2,2673446010,201392387,47873,11484,2024-10-04 19:32:53,3373,813,4186,4,3,7
3,2673446010,201392388,47873,52396,2024-10-04 19:32:53,0,0,0,0,0,0
3,2673446010,201392388,47873,27791,2024-10-04 19:32:53,0,0,0,0,0,0
2,2673446010,201392387,47873,31970,2024-10-04 19:32:54,0,0,0,0,0,0
1,2673446010,201392386,47873,32903,2024-10-04 19:32:54,0,0,0,0,0,0
2,2673446010,201392387,47873,11484,2024-10-04 19:32:54,0,0,0,0,0,0
3,2673446010,201392388,47873,52396,2024-10-04 19:32:54,0,0,0,0,0,0
3,2673446010,201392388,47873,27791,2024-10-04 19:32:54,0,0,0,0,0,0
2,2673446010,201392387,47873,31970,2024-10-04 19:32:55,0,0,0,0,0,0
1,2673446010,201392386,47873,32903,2024-10-04 19:32:55,0,0,0,0,0,0
2,2673446010,201392387,47873,11484,2024-10-04 19:32:55,5789,1649,7438,11,14,25
3,2673446010,201392388,47873,52396,2024-10-04 19:32:55,0,0,0,0,0,0
3,2673446010,201392388,47873,27791,2024-10-04 19:32:55,0,0,0,0,0,0
2,2673446010,201392387,47873,31970,2024-10-04 19:32:56,0,0,0,0,0,0
1,2673446010,201392386,47873,32903,2024-10-04 19:32:56,0,0,0,0,0,0
2,2673446010,201392387,47873,11484,2024-10-04 19:32:56,0,0,0,0,0,0
3,2673446010,201392388,47873,52396,2024-10-04 19:32:56,0,0,0,0,0,0
3,2673446010,201392388,47873,27791,2024-10-04 19:32:56,0,0,0,0,0,0
2,2673446010,201392387,47873,31970,2024-10-04 19:32:57,0,0,0,0,0,0
1,2673446010,201392386,47873,32903,2024-10-04 19:32:57,0,0,0,0,0,0
2,2673446010,201392387,47873,11484,2024-10-04 19:32:57,0,0,0,0,0,0
3,2673446010,201392388,47873,52396,2024-10-04 19:32:57,0,0,0,0,0,0
3,2673446010,201392388,47873,27791,2024-10-04 19:32:57,0,0,0,0,0,0
2,2673446010,201392387,47873,31970,2024-10-04 19:32:58,0,0,0,0,0,0
1,2673446010,201392386,47873,32903,2024-10-04 19:32:58,0,0,0,0,0,0
2,2673446010,201392387,47873,11484,2024-10-04 19:32:58,0,0,0,0,0,0
3,2673446010,201392388,47873,52396,2024-10-04 19:32:58,0,0,0,0,0,0
3,2673446010,201392388,47873,27791,2024-10-04 19:32:58,0,0,0,0,0,0
2,2673446010,201392387,47873,31970,2024-10-04 19:32:59,0,0,0,0,0,0
1,2673446010,201392386,47873,32903,2024-10-04 19:32:59,0,0,0,0,0,0
2,2673446010,201392387,47873,11484,2024-10-04 19:32:59,0,0,0,0,0,0
3,2673446010,201392388,47873,52396,2024-10-04 19:32:59,0,0,0,0,0,0
3,2673446010,201392388,47873,27791,2024-10-04 19:32:59,0,0,0,0,0,0
2,2673446010,201392387,47873,31970,2024-10-04 19:33:00,0,0,0,0,0,0
1,2673446010,201392386,47873,32903,2024-10-04 19:33:00,0,0,0,0,0,0
2,2673446010,201392387,47873,11484,2024-10-04 19:33:00,0,0,0,0,0,0
3,2673446010,201392388,47873,52396,2024-10-04 19:33:00,0,0,0,0,0,0
3,2673446010,201392388,47873,27791,2024-10-04 19:33:00,0,0,0,0,0,0
2,2673446010,201392387,47873,31970,2024-10-04 19:33:01,0,0,0,0,0,0
1,2673446010,201392386,47873,32903,2024-10-04 19:33:01,0,0,0,0,0,0
2,2673446010,201392387,47873,11484,2024-10-04 19:33:01,0,0,0,0,0,0
3,2673446010,201392388,47873,52396,2024-10-04 19:33:01,0,0,0,0,0,0
3,2673446010,201392388,47873,27791,2024-10-04 19:33:01,0,0,0,0,0,0
2,2673446010,201392387,47873,31970,2024-10-04 19:33:02,0,0,0,0,0,0
1,2673446010,201392386,47873,32903,2024-10-04 19:33:02,0,0,0,0,0,0
2,2673446010,201392387,47873,11484,2024-10-04 19:33:02,0,0,0,0,0,0
3,2673446010,201392388,47873,52396,2024-10-04 19:33:02,0,0,0,0,0,0
3,2673446010,201392388,47873,27791,2024-10-04 19:33:02,0,0,0,0,0,0
2,2673446010,201392387,47873,31970,2024-10-04 19:33:03,0,0,0,0,0,0
1,2673446010,201392386,47873,32903,2024-10-04 19:33:03,0,0,0,0,0,0
2,2673446010,201392387,47873,11484,2024-10-04 19:33:03,0,0,0,0,0,0
3,2673446010,201392388,47873,52396,2024-10-04 19:33:03,0,0,0,0,0,0
3,2673446010,201392388,47873,27791,2024-10-04 19:33:03,0,0,0,0,0,0
2,2673446010,201392387,47873,31970,2024-10-04 19:33:04,0,0,0,0,0,0
1,2673446010,201392386,47873,32903,2024-10-04 19:33:04,0,0,0,0,0,0
2,2673446010,201392387,47873,11484,2024-10-04 19:33:04,0,0,0,0,0,0
3,2673446010,201392388,47873,52396,2024-10-04 19:33:04,0,0,0,0,0,0
3,2673446010,201392388,47873,27791,2024-10-04 19:33:04,0,0,0,0,0,0
2,2673446010,201392387,47873,31970,2024-10-04 19:33:05,0,0,0,0,0,0
1,2673446010,201392386,47873,32903,2024-10-04 19:33:05,0,0,0,0,0,0
2,2673446010,201392387,47873,11484,2024-10-04 19:33:05,0,0,0,0,0,0
3,2673446010,201392388,47873,52396,2024-10-04 19:33:05,0,0,0,0,0,0
3,2673446010,201392388,47873,27791,2024-10-04 19:33:05,0,0,0,0,0,0
2,2673446010,201392387,47873,31970,2024-10-04 19:33:06,0,0,0,0,0,0
1,2673446010,201392386,47873,32903,2024-10-04 19:33:06,0,0,0,0,0,0
2,2673446010,201392387,47873,11484,2024-10-04 19:33:06,0,0,0,0,0,0
3,2673446010,201392388,47873,52396,2024-10-04 19:33:06,0,0,0,0,0,0
3,2673446010,201392388,47873,27791,2024-10-04 19:33:06,0,0,0,0,0,0
2,2673446010,201392387,47873,31970,2024-10-04 19:33:07,0,0,0,0,0,0
1,2673446010,201392386,47873,32903,2024-10-04 19:33:07,0,0,0,0,0,0
2,2673446010,201392387,47873,11484,2024-10-04 19:33:07,0,0,0,0,0,0
3,2673446010,201392388,47873,52396,2024-10-04 19:33:07,0,0,0,0,0,0
3,2673446010,201392388,47873,27791,2024-10-04 19:33:07,0,0,0,0,0,0
2,2673446010,201392387,47873,31970,2024-10-04 19:33:08,0,0,0,0,0,0
1,2673446010,201392386,47873,32903,2024-10-04 19:33:08,0,0,0,0,0,0
2,2673446010,201392387,47873,11484,2024-10-04 19:33:08,0,0,0,0,0,0
3,2673446010,201392388,47873,52396,2024-10-04 19:33:08,0,0,0,0,0,0
3,2673446010,201392388,47873,27791,2024-10-04 19:33:08,0,0,0,0,0,0
2,2673446010,201392387,47873,31970,2024-10-04 19:33:09,0,0,0,0,0,0
1,2673446010,201392386,47873,32903,2024-10-04 19:33:09,0,0,0,0,0,0
2,2673446010,201392387,47873,11484,2024-10-04 19:33:09,0,0,0,0,0,0
3,2673446010,201392388,47873,52396,2024-10-04 19:33:09,0,0,0,0,0,0
3,2673446010,201392388,47873,27791,2024-10-04 19:33:09,0,0,0,0,0,0
2,2673446010,201392387,47873,31970,2024-10-04 19:33:10,0,0,0,0,0,0
1,2673446010,201392386,47873,32903,2024-10-04 19:33:10,0,0,0,0,0,0
2,2673446010,201392387,47873,11484,2024-10-04 19:33:10,0,0,0,0,0,0
3,2673446010,201392388,47873,52396,2024-10-04 19:33:10,0,0,0,0,0,0
3,2673446010,201392388,47873,27791,2024-10-04 19:33:10,0,0,0,0,0,0
2,2673446010,201392387,47873,31970,2024-10-04 19:33:11,0,0,0,0,0,0
1,2673446010,201392386,47873,32903,2024-10-04 19:33:11,0,0,0,0,0,0
2,2673446010,201392387,47873,11484,2024-10-04 19:33:11,0,0,0,0,0,0
3,2673446010,201392388,47873,52396,2024-10-04 19:33:11,0,0,0,0,0,0
3,2673446010,201392388,47873,27791,2024-10-04 19:33:11,0,0,0,0,0,0
2,2673446010,201392387,47873,31970,2024-10-04 19:33:12,0,0,0,0,0,0
1,2673446010,201392386,47873,32903,2024-10-04 19:33:12,0,0,0,0,0,0
2,2673446010,201392387,47873,11484,2024-10-04 19:33:12,0,0,0,0,0,0
3,2673446010,201392388,47873,52396,2024-10-04 19:33:12,0,0,0,0,0,0
3,2673446010,201392388,47873,27791,2024-10-04 19:33:12,0,0,0,0,0,0
2,2673446010,201392387,47873,31970,2024-10-04 19:33:13,0,0,0,0,0,0
1,2673446010,201392386,47873,32903,2024-10-04 19:33:13,0,0,0,0,0,0
2,2673446010,201392387,47873,11484,2024-10-04 19:33:13,0,0,0,0,0,0
3,2673446010,201392388,47873,52396,2024-10-04 19:33:13,0,0,0,0,0,0
3,2673446010,201392388,47873,27791,2024-10-04 19:33:13,0,0,0,0,0,0
2,2673446010,201392387,47873,31970,2024-10-04 19:33:14,0,0,0,0,0,0
1,2673446010,201392386,47873,32903,2024-10-04 19:33:14,0,0,0,0,0,0
2,2673446010,201392387,47873,11484,2024-10-04 19:33:14,0,0,0,0,0,0
3,2673446010,201392388,47873,52396,2024-10-04 19:33:14,0,0,0,0,0,0
3,2673446010,201392388,47873,27791,2024-10-04 19:33:14,0,0,0,0,0,0
2,2673446010,201392387,47873,31970,2024-10-04 19:33:15,0,0,0,0,0,0
1,2673446010,201392386,47873,32903,2024-10-04 19:33:15,0,0,0,0,0,0
2,2673446010,201392387,47873,11484,2024-10-04 19:33:15,0,0,0,0,0,0
3,2673446010,201392388,47873,52396,2024-10-04 19:33:15,0,0,0,0,0,0
3,2673446010,201392388,47873,27791,2024-10-04 19:33:15,0,0,0,0,0,0
2,2673446010,201392387,47873,31970,2024-10-04 19:33:16,0,0,0,0,0,0
1,2673446010,201392386,47873,32903,2024-10-04 19:33:16,0,0,0,0,0,0
2,2673446010,201392387,47873,11484,2024-10-04 19:33:16,0,0,0,0,0,0
3,2673446010,201392388,47873,52396,2024-10-04 19:33:16,0,0,0,0,0,0
3,2673446010,201392388,47873,27791,2024-10-04 19:33:16,0,0,0,0,0,0
2,2673446010,201392387,47873,31970,2024-10-04 19:33:17,0,0,0,0,0,0
1,2673446010,201392386,47873,32903,2024-10-04 19:33:17,0,0,0,0,0,0
2,2673446010,201392387,47873,11484,2024-10-04 19:33:17,0,0,0,0,0,0
3,2673446010,201392388,47873,52396,2024-10-04 19:33:17,0,0,0,0,0,0
3,2673446010,201392388,47873,27791,2024-10-04 19:33:17,0,0,0,0,0,0
3,2673446010,201392388,47873,60582,2024-10-04 19:33:18,5049,1898,6947,8,11,19
2,2673446010,201392387,47873,31970,2024-10-04 19:33:18,0,0,0,0,0,0
1,2673446010,201392386,47873,32903,2024-10-04 19:33:18,0,0,0,0,0,0
2,2673446010,201392387,47873,11484,2024-10-04 19:33:18,0,0,0,0,0,0
3,2673446010,201392388,47873,52396,2024-10-04 19:33:18,0,0,0,0,0,0
3,2673446010,201392388,47873,27791,2024-10-04 19:33:18,0,0,0,0,0,0
3,2673446010,201392388,47873,60582,2024-10-04 19:33:19,6090,696,6786,6,7,13
2,2673446010,201392387,47873,31970,2024-10-04 19:33:19,0,0,0,0,0,0
1,2673446010,201392386,47873,32903,2024-10-04 19:33:19,0,0,0,0,0,0
2,2673446010,201392387,47873,11484,2024-10-04 19:33:19,0,0,0,0,0,0
3,2673446010,201392388,47873,52396,2024-10-04 19:33:19,0,0,0,0,0,0
3,2673446010,201392388,47873,27791,2024-10-04 19:33:19,0,0,0,0,0,0
3,2673446010,201392388,47873,60582,2024-10-04 19:33:20,0,0,0,0,0,0
2,2673446010,201392387,47873,31970,2024-10-04 19:33:20,0,0,0,0,0,0
1,2673446010,201392386,47873,32903,2024-10-04 19:33:20,0,0,0,0,0,0
1,2673446010,201392386,47873,11395,2024-10-04 19:33:20,0,104,104,0,1,1
3,2673446010,201392388,47873,52396,2024-10-04 19:33:20,0,0,0,0,0,0
3,2673446010,201392388,47873,27791,2024-10-04 19:33:20,0,0,0,0,0,0
3,2673446010,201392388,47873,60582,2024-10-04 19:33:21,0,0,0,0,0,0
2,2673446010,201392387,47873,31970,2024-10-04 19:33:21,0,0,0,0,0,0
1,2673446010,201392386,47873,11395,2024-10-04 19:33:21,11119,2574,13693,15,18,33
3,2673446010,201392388,47873,52396,2024-10-04 19:33:21,0,0,0,0,0,0
3,2673446010,201392388,47873,27791,2024-10-04 19:33:21,0,0,0,0,0,0
3,2673446010,201392388,47873,60582,2024-10-04 19:33:22,0,0,0,0,0,0
2,2673446010,201392387,47873,31970,2024-10-04 19:33:22,0,0,0,0,0,0
1,2673446010,201392386,47873,11395,2024-10-04 19:33:22,0,0,0,0,0,0
3,2673446010,201392388,47873,52396,2024-10-04 19:33:22,0,0,0,0,0,0
3,2673446010,201392388,47873,27791,2024-10-04 19:33:22,0,0,0,0,0,0
2,2673446010,201392387,47873,36526,2024-10-04 19:33:23,0,104,104,0,1,1
3,2673446010,201392388,47873,60582,2024-10-04 19:33:23,0,0,0,0,0,0
2,2673446010,201392387,47873,31970,2024-10-04 19:33:23,0,0,0,0,0,0
1,2673446010,201392386,47873,11395,2024-10-04 19:33:23,0,0,0,0,0,0
3,2673446010,201392388,47873,52396,2024-10-04 19:33:23,0,0,0,0,0,0
3,2673446010,201392388,47873,27791,2024-10-04 19:33:23,0,0,0,0,0,0
2,2673446010,201392387,47873,36526,2024-10-04 19:33:24,0,0,0,0,0,0
3,2673446010,201392388,47873,60582,2024-10-04 19:33:24,0,0,0,0,0,0
2,2673446010,201392387,47873,31970,2024-10-04 19:33:24,0,0,0,0,0,0
1,2673446010,201392386,47873,11395,2024-10-04 19:33:24,0,0,0,0,0,0
3,2673446010,201392388,47873,52396,2024-10-04 19:33:24,0,0,0,0,0,0
3,2673446010,201392388,47873,27791,2024-10-04 19:33:24,0,0,0,0,0,0
2,2673446010,201392387,47873,36526,2024-10-04 19:33:25,9034,2394,11428,13,16,29
3,2673446010,201392388,47873,60582,2024-10-04 19:33:25,0,0,0,0,0,0
2,2673446010,201392387,47873,31970,2024-10-04 19:33:25,0,0,0,0,0,0
1,2673446010,201392386,47873,11395,2024-10-04 19:33:25,0,0,0,0,0,0
3,2673446010,201392388,47873,52396,2024-10-04 19:33:25,0,0,0,0,0,0
3,2673446010,201392388,47873,27791,2024-10-04 19:33:25,0,0,0,0,0,0
2,2673446010,201392387,47873,36526,2024-10-04 19:33:26,0,0,0,0,0,0
3,2673446010,201392388,47873,60582,2024-10-04 19:33:26,0,0,0,0,0,0
2,2673446010,201392387,47873,31970,2024-10-04 19:33:26,0,0,0,0,0,0
1,2673446010,201392386,47873,11395,2024-10-04 19:33:26,0,0,0,0,0,0
3,2673446010,201392388,47873,52396,2024-10-04 19:33:26,0,0,0,0,0,0
3,2673446010,201392388,47873,27791,2024-10-04 19:33:26,0,0,0,0,0,0
2,2673446010,201392387,47873,36526,2024-10-04 19:33:27,0,0,0,0,0,0
3,2673446010,201392388,47873,60582,2024-10-04 19:33:27,0,0,0,0,0,0
2,2673446010,201392387,47873,31970,2024-10-04 19:33:27,0,0,0,0,0,0
1,2673446010,201392386,47873,11395,2024-10-04 19:33:27,0,0,0,0,0,0
3,2673446010,201392388,47873,52396,2024-10-04 19:33:27,0,0,0,0,0,0
3,2673446010,201392388,47873,27791,2024-10-04 19:33:27,0,0,0,0,0,0
2,2673446010,201392387,47873,36526,2024-10-04 19:33:28,0,0,0,0,0,0
3,2673446010,201392388,47873,60582,2024-10-04 19:33:28,0,0,0,0,0,0
2,2673446010,201392387,47873,31970,2024-10-04 19:33:28,0,0,0,0,0,0
1,2673446010,201392386,47873,11395,2024-10-04 19:33:28,0,0,0,0,0,0
3,2673446010,201392388,47873,52396,2024-10-04 19:33:28,0,0,0,0,0,0
3,2673446010,201392388,47873,27791,2024-10-04 19:33:28,0,0,0,0,0,0
2,2673446010,201392387,47873,36526,2024-10-04 19:33:29,0,0,0,0,0,0
3,2673446010,201392388,47873,60582,2024-10-04 19:33:29,0,0,0,0,0,0
2,2673446010,201392387,47873,31970,2024-10-04 19:33:29,0,0,0,0,0,0
1,2673446010,201392386,47873,11395,2024-10-04 19:33:29,0,0,0,0,0,0
3,2673446010,201392388,47873,52396,2024-10-04 19:33:29,0,0,0,0,0,0
3,2673446010,201392388,47873,27791,2024-10-04 19:33:29,0,0,0,0,0,0
3,2673446010,201392388,47873,60582,2024-10-04 19:33:30,0,0,0,0,0,0
2,2673446010,201392387,47873,31970,2024-10-04 19:33:30,0,0,0,0,0,0
1,2673446010,201392386,47873,11395,2024-10-04 19:33:30,0,0,0,0,0,0
3,2673446010,201392388,47873,52396,2024-10-04 19:33:30,0,0,0,0,0,0
3,2673446010,201392388,47873,27791,2024-10-04 19:33:30,0,0,0,0,0,0
3,2673446010,201392388,47873,60582,2024-10-04 19:33:31,0,0,0,0,0,0
2,2673446010,201392387,47873,31970,2024-10-04 19:33:31,0,0,0,0,0,0
1,2673446010,201392386,47873,11395,2024-10-04 19:33:31,0,0,0,0,0,0
3,2673446010,201392388,47873,52396,2024-10-04 19:33:31,0,0,0,0,0,0
3,2673446010,201392388,47873,27791,2024-10-04 19:33:31,0,0,0,0,0,0
3,2673446010,201392388,47873,60582,2024-10-04 19:33:32,0,0,0,0,0,0
2,2673446010,201392387,47873,31970,2024-10-04 19:33:32,0,0,0,0,0,0
1,2673446010,201392386,47873,11395,2024-10-04 19:33:32,0,0,0,0,0,0
3,2673446010,201392388,47873,52396,2024-10-04 19:33:32,0,0,0,0,0,0
3,2673446010,201392388,47873,27791,2024-10-04 19:33:32,0,0,0,0,0,0
3,2673446010,201392388,47873,60582,2024-10-04 19:33:33,0,0,0,0,0,0
2,2673446010,201392387,47873,31970,2024-10-04 19:33:33,0,0,0,0,0,0
1,2673446010,201392386,47873,11395,2024-10-04 19:33:33,0,0,0,0,0,0
3,2673446010,201392388,47873,52396,2024-10-04 19:33:33,0,0,0,0,0,0
3,2673446010,201392388,47873,27791,2024-10-04 19:33:33,0,0,0,0,0,0
3,2673446010,201392388,47873,60582,2024-10-04 19:33:34,0,0,0,0,0,0
2,2673446010,201392387,47873,31970,2024-10-04 19:33:34,0,0,0,0,0,0
1,2673446010,201392386,47873,11395,2024-10-04 19:33:34,0,0,0,0,0,0
3,2673446010,201392388,47873,52396,2024-10-04 19:33:34,0,0,0,0,0,0
3,2673446010,201392388,47873,27791,2024-10-04 19:33:34,0,0,0,0,0,0
3,2673446010,201392388,47873,60582,2024-10-04 19:33:35,0,0,0,0,0,0
2,2673446010,201392387,47873,31970,2024-10-04 19:33:35,0,0,0,0,0,0
1,2673446010,201392386,47873,11395,2024-10-04 19:33:35,0,0,0,0,0,0
3,2673446010,201392388,47873,52396,2024-10-04 19:33:35,0,0,0,0,0,0
3,2673446010,201392388,47873,27791,2024-10-04 19:33:35,0,0,0,0,0,0
3,2673446010,201392388,47873,60582,2024-10-04 19:33:36,0,0,0,0,0,0
2,2673446010,201392387,47873,31970,2024-10-04 19:33:36,0,0,0,0,0,0
1,2673446010,201392386,47873,11395,2024-10-04 19:33:36,0,0,0,0,0,0
3,2673446010,201392388,47873,52396,2024-10-04 19:33:36,0,0,0,0,0,0
3,2673446010,201392388,47873,27791,2024-10-04 19:33:36,0,0,0,0,0,0
3,2673446010,201392388,47873,60582,2024-10-04 19:33:37,0,0,0,0,0,0
2,2673446010,201392387,47873,31970,2024-10-04 19:33:37,0,0,0,0,0,0
1,2673446010,201392386,47873,11395,2024-10-04 19:33:37,0,0,0,0,0,0
3,2673446010,201392388,47873,52396,2024-10-04 19:33:37,0,0,0,0,0,0
3,2673446010,201392388,47873,27791,2024-10-04 19:33:37,0,0,0,0,0,0
3,2673446010,201392388,47873,60582,2024-10-04 19:33:38,0,0,0,0,0,0
2,2673446010,201392387,47873,31970,2024-10-04 19:33:38,0,0,0,0,0,0
1,2673446010,201392386,47873,11395,2024-10-04 19:33:38,0,0,0,0,0,0
3,2673446010,201392388,47873,52396,2024-10-04 19:33:38,0,0,0,0,0,0
3,2673446010,201392388,47873,27791,2024-10-04 19:33:38,0,0,0,0,0,0
3,2673446010,201392388,47873,60582,2024-10-04 19:33:39,0,0,0,0,0,0
2,2673446010,201392387,47873,31970,2024-10-04 19:33:39,0,0,0,0,0,0
1,2673446010,201392386,47873,11395,2024-10-04 19:33:39,0,0,0,0,0,0
3,2673446010,201392388,47873,52396,2024-10-04 19:33:39,0,0,0,0,0,0
3,2673446010,201392388,47873,27791,2024-10-04 19:33:39,0,0,0,0,0,0
3,2673446010,201392388,47873,60582,2024-10-04 19:33:40,0,0,0,0,0,0
2,2673446010,201392387,47873,31970,2024-10-04 19:33:40,0,0,0,0,0,0
1,2673446010,201392386,47873,11395,2024-10-04 19:33:40,0,0,0,0,0,0
3,2673446010,201392388,47873,52396,2024-10-04 19:33:40,0,0,0,0,0,0
3,2673446010,201392388,47873,27791,2024-10-04 19:33:40,0,0,0,0,0,0
3,2673446010,201392388,47873,60582,2024-10-04 19:33:41,0,0,0,0,0,0
2,2673446010,201392387,47873,31970,2024-10-04 19:33:41,0,0,0,0,0,0
1,2673446010,201392386,47873,11395,2024-10-04 19:33:41,0,0,0,0,0,0
3,2673446010,201392388,47873,52396,2024-10-04 19:33:41,0,0,0,0,0,0
3,2673446010,201392388,47873,27791,2024-10-04 19:33:41,0,0,0,0,0,0
3,2673446010,201392388,47873,60582,2024-10-04 19:33:42,0,0,0,0,0,0
2,2673446010,201392387,47873,31970,2024-10-04 19:33:42,0,0,0,0,0,0
1,2673446010,201392386,47873,11395,2024-10-04 19:33:42,0,0,0,0,0,0
3,2673446010,201392388,47873,52396,2024-10-04 19:33:42,0,0,0,0,0,0
3,2673446010,201392388,47873,27791,2024-10-04 19:33:42,0,0,0,0,0,0
3,2673446010,201392388,47873,60582,2024-10-04 19:33:43,0,0,0,0,0,0
2,2673446010,201392387,47873,31970,2024-10-04 19:33:43,0,0,0,0,0,0
1,2673446010,201392386,47873,11395,2024-10-04 19:33:43,0,0,0,0,0,0
3,2673446010,201392388,47873,52396,2024-10-04 19:33:43,0,0,0,0,0,0
3,2673446010,201392388,47873,27791,2024-10-04 19:33:43,0,0,0,0,0,0
3,2673446010,201392388,47873,60582,2024-10-04 19:33:44,0,0,0,0,0,0
2,2673446010,201392387,47873,31970,2024-10-04 19:33:44,0,0,0,0,0,0
1,2673446010,201392386,47873,11395,2024-10-04 19:33:44,0,0,0,0,0,0
3,2673446010,201392388,47873,52396,2024-10-04 19:33:44,0,0,0,0,0,0
3,2673446010,201392388,47873,27791,2024-10-04 19:33:44,0,0,0,0,0,0
3,2673446010,201392388,47873,60582,2024-10-04 19:33:45,0,0,0,0,0,0
2,2673446010,201392387,47873,31970,2024-10-04 19:33:45,0,0,0,0,0,0
1,2673446010,201392386,47873,11395,2024-10-04 19:33:45,0,0,0,0,0,0
3,2673446010,201392388,47873,52396,2024-10-04 19:33:45,0,0,0,0,0,0
3,2673446010,201392388,47873,27791,2024-10-04 19:33:45,0,0,0,0,0,0
3,2673446010,201392388,47873,60582,2024-10-04 19:33:46,0,0,0,0,0,0
2,2673446010,201392387,47873,31970,2024-10-04 19:33:46,0,0,0,0,0,0
1,2673446010,201392386,47873,11395,2024-10-04 19:33:46,0,0,0,0,0,0
3,2673446010,201392388,47873,52396,2024-10-04 19:33:46,0,0,0,0,0,0
3,2673446010,201392388,47873,27791,2024-10-04 19:33:46,0,0,0,0,0,0
3,2673446010,201392388,47873,60582,2024-10-04 19:33:47,0,0,0,0,0,0
2,2673446010,201392387,47873,31970,2024-10-04 19:33:47,0,0,0,0,0,0
1,2673446010,201392386,47873,11395,2024-10-04 19:33:47,0,0,0,0,0,0
3,2673446010,201392388,47873,52396,2024-10-04 19:33:47,0,0,0,0,0,0
3,2673446010,201392388,47873,27791,2024-10-04 19:33:47,0,0,0,0,0,0
3,2673446010,201392388,47873,60582,2024-10-04 19:33:48,0,0,0,0,0,0
2,2673446010,201392387,47873,31970,2024-10-04 19:33:48,0,0,0,0,0,0
1,2673446010,201392386,47873,11395,2024-10-04 19:33:48,0,0,0,0,0,0
3,2673446010,201392388,47873,52396,2024-10-04 19:33:48,0,0,0,0,0,0
3,2673446010,201392388,47873,27791,2024-10-04 19:33:48,0,0,0,0,0,0
3,2673446010,201392388,47873,60582,2024-10-04 19:33:49,0,0,0,0,0,0
2,2673446010,201392387,47873,31970,2024-10-04 19:33:49,0,0,0,0,0,0
3,2673446010,201392388,47873,59101,2024-10-04 19:33:49,3374,921,4295,4,4,8
1,2673446010,201392386,47873,11395,2024-10-04 19:33:49,0,0,0,0,0,0
3,2673446010,201392388,47873,52396,2024-10-04 19:33:49,0,0,0,0,0,0
3,2673446010,201392388,47873,27791,2024-10-04 19:33:49,0,0,0,0,0,0
3,2673446010,201392388,47873,60582,2024-10-04 19:33:50,0,0,0,0,0,0
2,2673446010,201392387,47873,31970,2024-10-04 19:33:50,0,0,0,0,0,0
3,2673446010,201392388,47873,59101,2024-10-04 19:33:50,7899,1757,9656,12,15,27
1,2673446010,201392386,47873,11395,2024-10-04 19:33:50,0,0,0,0,0,0
3,2673446010,201392388,47873,52396,2024-10-04 19:33:50,0,0,0,0,0,0
3,2673446010,201392388,47873,27791,2024-10-04 19:33:50,0,0,0,0,0,0
3,2673446010,201392388,47873,60582,2024-10-04 19:33:51,0,0,0,0,0,0
2,2673446010,201392387,47873,31970,2024-10-04 19:33:51,0,0,0,0,0,0
3,2673446010,201392388,47873,59101,2024-10-04 19:33:51,0,0,0,0,0,0
1,2673446010,201392386,47873,56985,2024-10-04 19:33:51,112,813,925,2,3,5
3,2673446010,201392388,47873,52396,2024-10-04 19:33:51,0,0,0,0,0,0
3,2673446010,201392388,47873,27791,2024-10-04 19:33:51,0,0,0,0,0,0
2,2673446010,201392387,47873,31970,2024-10-04 19:33:52,0,0,0,0,0,0
3,2673446010,201392388,47873,59101,2024-10-04 19:33:52,0,0,0,0,0,0
1,2673446010,201392386,47873,56985,2024-10-04 19:33:52,9167,1745,10912,15,15,30
3,2673446010,201392388,47873,52396,2024-10-04 19:33:52,0,0,0,0,0,0
3,2673446010,201392388,47873,27791,2024-10-04 19:33:52,0,0,0,0,0,0
2,2673446010,201392387,47873,48286,2024-10-04 19:33:53,0,104,104,0,1,1
2,2673446010,201392387,47873,31970,2024-10-04 19:33:53,0,0,0,0,0,0
3,2673446010,201392388,47873,59101,2024-10-04 19:33:53,0,0,0,0,0,0
1,2673446010,201392386,47873,56985,2024-10-04 19:33:53,0,0,0,0,0,0
3,2673446010,201392388,47873,52396,2024-10-04 19:33:53,0,0,0,0,0,0
3,2673446010,201392388,47873,27791,2024-10-04 19:33:53,0,0,0,0,0,0
2,2673446010,201392387,47873,48286,2024-10-04 19:33:54,8205,1890,10095,11,11,22
2,2673446010,201392387,47873,31970,2024-10-04 19:33:54,0,0,0,0,0,0
3,2673446010,201392388,47873,59101,2024-10-04 19:33:54,0,0,0,0,0,0
1,2673446010,201392386,47873,56985,2024-10-04 19:33:54,0,0,0,0,0,0
3,2673446010,201392388,47873,52396,2024-10-04 19:33:54,0,0,0,0,0,0
3,2673446010,201392388,47873,27791,2024-10-04 19:33:54,0,0,0,0,0,0
2,2673446010,201392387,47873,48286,2024-10-04 19:33:55,2968,696,3664,4,7,11
3,2673446010,201392388,47873,59101,2024-10-04 19:33:55,0,0,0,0,0,0
1,2673446010,201392386,47873,56985,2024-10-04 19:33:55,0,0,0,0,0,0
3,2673446010,201392388,47873,52396,2024-10-04 19:33:55,0,0,0,0,0,0
3,2673446010,201392388,47873,27791,2024-10-04 19:33:55,0,0,0,0,0,0
2,2673446010,201392387,47873,48286,2024-10-04 19:33:56,0,0,0,0,0,0
3,2673446010,201392388,47873,59101,2024-10-04 19:33:56,0,0,0,0,0,0
1,2673446010,201392386,47873,56985,2024-10-04 19:33:56,0,0,0,0,0,0
3,2673446010,201392388,47873,52396,2024-10-04 19:33:56,0,0,0,0,0,0
3,2673446010,201392388,47873,27791,2024-10-04 19:33:56,0,0,0,0,0,0
2,2673446010,201392387,47873,48286,2024-10-04 19:33:57,0,0,0,0,0,0
3,2673446010,201392388,47873,59101,2024-10-04 19:33:57,0,0,0,0,0,0
1,2673446010,201392386,47873,56985,2024-10-04 19:33:57,0,0,0,0,0,0
3,2673446010,201392388,47873,52396,2024-10-04 19:33:57,0,0,0,0,0,0
3,2673446010,201392388,47873,27791,2024-10-04 19:33:57,0,0,0,0,0,0
2,2673446010,201392387,47873,48286,2024-10-04 19:33:58,0,0,0,0,0,0
3,2673446010,201392388,47873,59101,2024-10-04 19:33:58,0,0,0,0,0,0
1,2673446010,201392386,47873,56985,2024-10-04 19:33:58,0,0,0,0,0,0
3,2673446010,201392388,47873,52396,2024-10-04 19:33:58,0,0,0,0,0,0
3,2673446010,201392388,47873,27791,2024-10-04 19:33:58,0,0,0,0,0,0
2,2673446010,201392387,47873,48286,2024-10-04 19:33:59,0,0,0,0,0,0
3,2673446010,201392388,47873,59101,2024-10-04 19:33:59,0,0,0,0,0,0
3,2673446010,201392388,47873,52396,2024-10-04 19:33:59,0,0,0,0,0,0
3,2673446010,201392388,47873,27791,2024-10-04 19:33:59,0,0,0,0,0,0
2,2673446010,201392387,47873,48286,2024-10-04 19:34:00,0,0,0,0,0,0
3,2673446010,201392388,47873,59101,2024-10-04 19:34:00,0,0,0,0,0,0
3,2673446010,201392388,47873,52396,2024-10-04 19:34:00,0,0,0,0,0,0
3,2673446010,201392388,47873,27791,2024-10-04 19:34:00,0,0,0,0,0,0
2,2673446010,201392387,47873,48286,2024-10-04 19:34:01,0,0,0,0,0,0
3,2673446010,201392388,47873,59101,2024-10-04 19:34:01,0,0,0,0,0,0
3,2673446010,201392388,47873,52396,2024-10-04 19:34:01,0,0,0,0,0,0
3,2673446010,201392388,47873,27791,2024-10-04 19:34:01,0,0,0,0,0,0
2,2673446010,201392387,47873,48286,2024-10-04 19:34:02,0,0,0,0,0,0
3,2673446010,201392388,47873,59101,2024-10-04 19:34:02,0,0,0,0,0,0
3,2673446010,201392388,47873,52396,2024-10-04 19:34:02,0,0,0,0,0,0
3,2673446010,201392388,47873,27791,2024-10-04 19:34:02,0,0,0,0,0,0
2,2673446010,201392387,47873,48286,2024-10-04 19:34:03,0,0,0,0,0,0
3,2673446010,201392388,47873,59101,2024-10-04 19:34:03,0,0,0,0,0,0
3,2673446010,201392388,47873,52396,2024-10-04 19:34:03,0,0,0,0,0,0
3,2673446010,201392388,47873,27791,2024-10-04 19:34:03,0,0,0,0,0,0
2,2673446010,201392387,47873,48286,2024-10-04 19:34:04,0,0,0,0,0,0
3,2673446010,201392388,47873,59101,2024-10-04 19:34:04,0,0,0,0,0,0
3,2673446010,201392388,47873,52396,2024-10-04 19:34:04,0,0,0,0,0,0
3,2673446010,201392388,47873,27791,2024-10-04 19:34:04,0,0,0,0,0,0
2,2673446010,201392387,47873,48286,2024-10-04 19:34:05,0,0,0,0,0,0
3,2673446010,201392388,47873,59101,2024-10-04 19:34:05,0,0,0,0,0,0
3,2673446010,201392388,47873,52396,2024-10-04 19:34:05,0,0,0,0,0,0
3,2673446010,201392388,47873,27791,2024-10-04 19:34:05,0,0,0,0,0,0
2,2673446010,201392387,47873,48286,2024-10-04 19:34:06,0,0,0,0,0,0
3,2673446010,201392388,47873,59101,2024-10-04 19:34:06,0,0,0,0,0,0
3,2673446010,201392388,47873,52396,2024-10-04 19:34:06,0,0,0,0,0,0
3,2673446010,201392388,47873,27791,2024-10-04 19:34:06,0,0,0,0,0,0
2,2673446010,201392387,47873,48286,2024-10-04 19:34:07,0,0,0,0,0,0
3,2673446010,201392388,47873,59101,2024-10-04 19:34:07,0,0,0,0,0,0
3,2673446010,201392388,47873,52396,2024-10-04 19:34:07,0,0,0,0,0,0
3,2673446010,201392388,47873,27791,2024-10-04 19:34:07,0,0,0,0,0,0
2,2673446010,201392387,47873,48286,2024-10-04 19:34:08,0,0,0,0,0,0
3,2673446010,201392388,47873,59101,2024-10-04 19:34:08,0,0,0,0,0,0
3,2673446010,201392388,47873,52396,2024-10-04 19:34:08,0,0,0,0,0,0
3,2673446010,201392388,47873,27791,2024-10-04 19:34:08,0,0,0,0,0,0
2,2673446010,201392387,47873,48286,2024-10-04 19:34:09,0,0,0,0,0,0
3,2673446010,201392388,47873,59101,2024-10-04 19:34:09,0,0,0,0,0,0
3,2673446010,201392388,47873,52396,2024-10-04 19:34:09,0,0,0,0,0,0
3,2673446010,201392388,47873,27791,2024-10-04 19:34:09,0,0,0,0,0,0
2,2673446010,201392387,47873,48286,2024-10-04 19:34:10,0,0,0,0,0,0
3,2673446010,201392388,47873,59101,2024-10-04 19:34:10,0,0,0,0,0,0
3,2673446010,201392388,47873,52396,2024-10-04 19:34:10,0,0,0,0,0,0
3,2673446010,201392388,47873,27791,2024-10-04 19:34:10,0,0,0,0,0,0
2,2673446010,201392387,47873,48286,2024-10-04 19:34:11,0,0,0,0,0,0
3,2673446010,201392388,47873,59101,2024-10-04 19:34:11,0,0,0,0,0,0
3,2673446010,201392388,47873,52396,2024-10-04 19:34:11,0,0,0,0,0,0
3,2673446010,201392388,47873,27791,2024-10-04 19:34:11,0,0,0,0,0,0
2,2673446010,201392387,47873,48286,2024-10-04 19:34:12,0,0,0,0,0,0
3,2673446010,201392388,47873,59101,2024-10-04 19:34:12,0,0,0,0,0,0
3,2673446010,201392388,47873,52396,2024-10-04 19:34:12,0,0,0,0,0,0
3,2673446010,201392388,47873,27791,2024-10-04 19:34:12,0,0,0,0,0,0
2,2673446010,201392387,47873,48286,2024-10-04 19:34:13,0,0,0,0,0,0
3,2673446010,201392388,47873,59101,2024-10-04 19:34:13,0,0,0,0,0,0
3,2673446010,201392388,47873,52396,2024-10-04 19:34:13,0,0,0,0,0,0
3,2673446010,201392388,47873,27791,2024-10-04 19:34:13,0,0,0,0,0,0
2,2673446010,201392387,47873,48286,2024-10-04 19:34:14,0,0,0,0,0,0
3,2673446010,201392388,47873,59101,2024-10-04 19:34:14,0,0,0,0,0,0
3,2673446010,201392388,47873,52396,2024-10-04 19:34:14,0,0,0,0,0,0
3,2673446010,201392388,47873,27791,2024-10-04 19:34:14,0,0,0,0,0,0
2,2673446010,201392387,47873,48286,2024-10-04 19:34:15,0,0,0,0,0,0
3,2673446010,201392388,47873,59101,2024-10-04 19:34:15,0,0,0,0,0,0
3,2673446010,201392388,47873,52396,2024-10-04 19:34:15,0,0,0,0,0,0
3,2673446010,201392388,47873,27791,2024-10-04 19:34:15,0,0,0,0,0,0
2,2673446010,201392387,47873,48286,2024-10-04 19:34:16,0,0,0,0,0,0
3,2673446010,201392388,47873,59101,2024-10-04 19:34:16,0,0,0,0,0,0
3,2673446010,201392388,47873,52396,2024-10-04 19:34:16,0,0,0,0,0,0
3,2673446010,201392388,47873,27791,2024-10-04 19:34:16,0,0,0,0,0,0
2,2673446010,201392387,47873,48286,2024-10-04 19:34:17,0,0,0,0,0,0
3,2673446010,201392388,47873,59101,2024-10-04 19:34:17,0,0,0,0,0,0
3,2673446010,201392388,47873,52396,2024-10-04 19:34:17,0,0,0,0,0,0
3,2673446010,201392388,47873,27791,2024-10-04 19:34:17,0,0,0,0,0,0
2,2673446010,201392387,47873,48286,2024-10-04 19:34:18,0,0,0,0,0,0
3,2673446010,201392388,47873,59101,2024-10-04 19:34:18,0,0,0,0,0,0
3,2673446010,201392388,47873,52396,2024-10-04 19:34:18,0,0,0,0,0,0
3,2673446010,201392388,47873,27791,2024-10-04 19:34:18,0,0,0,0,0,0
2,2673446010,201392387,47873,48286,2024-10-04 19:34:19,0,0,0,0,0,0
3,2673446010,201392388,47873,59101,2024-10-04 19:34:19,0,0,0,0,0,0
3,2673446010,201392388,47873,52396,2024-10-04 19:34:19,0,0,0,0,0,0
3,2673446010,201392388,47873,27791,2024-10-04 19:34:19,0,0,0,0,0,0
2,2673446010,201392387,47873,48286,2024-10-04 19:34:20,0,0,0,0,0,0
3,2673446010,201392388,47873,59101,2024-10-04 19:34:20,0,0,0,0,0,0
3,2673446010,201392388,47873,34963,2024-10-04 19:34:20,0,104,104,0,1,1
3,2673446010,201392388,47873,52396,2024-10-04 19:34:20,0,0,0,0,0,0
3,2673446010,201392388,47873,27791,2024-10-04 19:34:20,0,0,0,0,0,0
2,2673446010,201392387,47873,48286,2024-10-04 19:34:21,0,0,0,0,0,0
3,2673446010,201392388,47873,59101,2024-10-04 19:34:21,0,0,0,0,0,0
3,2673446010,201392388,47873,34963,2024-10-04 19:34:21,9540,1902,11442,11,11,22
3,2673446010,201392388,47873,52396,2024-10-04 19:34:21,0,0,0,0,0,0
3,2673446010,201392388,47873,27791,2024-10-04 19:34:21,0,0,0,0,0,0
1,2673446010,201392386,47873,18591,2024-10-04 19:34:22,3374,813,4187,4,3,7
3,2673446010,201392388,47873,59101,2024-10-04 19:34:22,0,0,0,0,0,0
3,2673446010,201392388,47873,34963,2024-10-04 19:34:22,1600,672,2272,4,7,11
3,2673446010,201392388,47873,52396,2024-10-04 19:34:22,0,0,0,0,0,0
3,2673446010,201392388,47873,27791,2024-10-04 19:34:22,0,0,0,0,0,0
1,2673446010,201392386,47873,18591,2024-10-04 19:34:23,5696,1565,7261,10,13,23
3,2673446010,201392388,47873,34963,2024-10-04 19:34:23,0,0,0,0,0,0
3,2673446010,201392388,47873,52396,2024-10-04 19:34:23,0,0,0,0,0,0
3,2673446010,201392388,47873,27791,2024-10-04 19:34:23,0,0,0,0,0,0
1,2673446010,201392386,47873,18591,2024-10-04 19:34:24,0,0,0,0,0,0
2,2673446010,201392387,47873,52450,2024-10-04 19:34:24,9120,2582,11702,14,18,32
3,2673446010,201392388,47873,34963,2024-10-04 19:34:24,0,0,0,0,0,0
3,2673446010,201392388,47873,52396,2024-10-04 19:34:24,0,0,0,0,0,0
3,2673446010,201392388,47873,27791,2024-10-04 19:34:24,0,0,0,0,0,0
1,2673446010,201392386,47873,18591,2024-10-04 19:34:25,0,0,0,0,0,0
2,2673446010,201392387,47873,52450,2024-10-04 19:34:25,0,0,0,0,0,0
3,2673446010,201392388,47873,34963,2024-10-04 19:34:25,0,0,0,0,0,0
3,2673446010,201392388,47873,52396,2024-10-04 19:34:25,0,0,0,0,0,0
3,2673446010,201392388,47873,27791,2024-10-04 19:34:25,0,0,0,0,0,0
1,2673446010,201392386,47873,18591,2024-10-04 19:34:26,0,0,0,0,0,0
2,2673446010,201392387,47873,52450,2024-10-04 19:34:26,0,0,0,0,0,0
3,2673446010,201392388,47873,34963,2024-10-04 19:34:26,0,0,0,0,0,0
3,2673446010,201392388,47873,52396,2024-10-04 19:34:26,0,0,0,0,0,0
3,2673446010,201392388,47873,27791,2024-10-04 19:34:26,0,0,0,0,0,0
1,2673446010,201392386,47873,18591,2024-10-04 19:34:27,0,0,0,0,0,0
2,2673446010,201392387,47873,52450,2024-10-04 19:34:27,0,0,0,0,0,0
3,2673446010,201392388,47873,34963,2024-10-04 19:34:27,0,0,0,0,0,0
3,2673446010,201392388,47873,52396,2024-10-04 19:34:27,0,0,0,0,0,0
3,2673446010,201392388,47873,27791,2024-10-04 19:34:27,0,0,0,0,0,0
1,2673446010,201392386,47873,18591,2024-10-04 19:34:28,0,0,0,0,0,0
2,2673446010,201392387,47873,52450,2024-10-04 19:34:28,0,0,0,0,0,0
3,2673446010,201392388,47873,34963,2024-10-04 19:34:28,0,0,0,0,0,0
3,2673446010,201392388,47873,52396,2024-10-04 19:34:28,0,0,0,0,0,0
3,2673446010,201392388,47873,27791,2024-10-04 19:34:28,0,0,0,0,0,0
1,2673446010,201392386,47873,18591,2024-10-04 19:34:29,0,0,0,0,0,0
2,2673446010,201392387,47873,52450,2024-10-04 19:34:29,0,0,0,0,0,0
3,2673446010,201392388,47873,34963,2024-10-04 19:34:29,0,0,0,0,0,0
3,2673446010,201392388,47873,52396,2024-10-04 19:34:29,0,0,0,0,0,0
3,2673446010,201392388,47873,27791,2024-10-04 19:34:29,0,0,0,0,0,0
1,2673446010,201392386,47873,18591,2024-10-04 19:34:30,0,0,0,0,0,0
3,2673446010,201392388,47873,34963,2024-10-04 19:34:30,0,0,0,0,0,0
3,2673446010,201392388,47873,52396,2024-10-04 19:34:30,0,0,0,0,0,0
3,2673446010,201392388,47873,27791,2024-10-04 19:34:30,0,0,0,0,0,0
1,2673446010,201392386,47873,18591,2024-10-04 19:34:31,0,0,0,0,0,0
3,2673446010,201392388,47873,34963,2024-10-04 19:34:31,0,0,0,0,0,0
3,2673446010,201392388,47873,52396,2024-10-04 19:34:31,0,0,0,0,0,0
3,2673446010,201392388,47873,27791,2024-10-04 19:34:31,0,0,0,0,0,0
3,2673446010,201392388,47873,34963,2024-10-04 19:34:32,0,0,0,0,0,0
3,2673446010,201392388,47873,52396,2024-10-04 19:34:32,0,0,0,0,0,0
3,2673446010,201392388,47873,27791,2024-10-04 19:34:32,0,0,0,0,0,0
3,2673446010,201392388,47873,34963,2024-10-04 19:34:33,0,0,0,0,0,0
3,2673446010,201392388,47873,52396,2024-10-04 19:34:33,0,0,0,0,0,0
3,2673446010,201392388,47873,27791,2024-10-04 19:34:33,0,0,0,0,0,0
3,2673446010,201392388,47873,34963,2024-10-04 19:34:34,0,0,0,0,0,0
3,2673446010,201392388,47873,52396,2024-10-04 19:34:34,0,0,0,0,0,0
3,2673446010,201392388,47873,27791,2024-10-04 19:34:34,0,0,0,0,0,0
3,2673446010,201392388,47873,34963,2024-10-04 19:34:35,0,0,0,0,0,0
3,2673446010,201392388,47873,52396,2024-10-04 19:34:35,0,0,0,0,0,0
3,2673446010,201392388,47873,27791,2024-10-04 19:34:35,0,0,0,0,0,0
3,2673446010,201392388,47873,34963,2024-10-04 19:34:36,0,0,0,0,0,0
3,2673446010,201392388,47873,52396,2024-10-04 19:34:36,0,0,0,0,0,0
3,2673446010,201392388,47873,27791,2024-10-04 19:34:36,0,0,0,0,0,0
3,2673446010,201392388,47873,34963,2024-10-04 19:34:37,0,0,0,0,0,0
3,2673446010,201392388,47873,52396,2024-10-04 19:34:37,0,0,0,0,0,0
3,2673446010,201392388,47873,27791,2024-10-04 19:34:37,0,0,0,0,0,0
3,2673446010,201392388,47873,34963,2024-10-04 19:34:38,0,0,0,0,0,0
3,2673446010,201392388,47873,52396,2024-10-04 19:34:38,0,0,0,0,0,0
3,2673446010,201392388,47873,27791,2024-10-04 19:34:38,0,0,0,0,0,0
3,2673446010,201392388,47873,34963,2024-10-04 19:34:39,0,0,0,0,0,0
3,2673446010,201392388,47873,52396,2024-10-04 19:34:39,0,0,0,0,0,0
3,2673446010,201392388,47873,27791,2024-10-04 19:34:39,0,0,0,0,0,0
3,2673446010,201392388,47873,34963,2024-10-04 19:34:40,0,0,0,0,0,0
3,2673446010,201392388,47873,52396,2024-10-04 19:34:40,0,0,0,0,0,0
3,2673446010,201392388,47873,27791,2024-10-04 19:34:40,0,0,0,0,0,0
3,2673446010,201392388,47873,34963,2024-10-04 19:34:41,0,0,0,0,0,0
3,2673446010,201392388,47873,52396,2024-10-04 19:34:41,0,0,0,0,0,0
3,2673446010,201392388,47873,27791,2024-10-04 19:34:41,0,0,0,0,0,0
3,2673446010,201392388,47873,34963,2024-10-04 19:34:42,0,0,0,0,0,0
3,2673446010,201392388,47873,52396,2024-10-04 19:34:42,0,0,0,0,0,0
3,2673446010,201392388,47873,27791,2024-10-04 19:34:42,0,0,0,0,0,0
3,2673446010,201392388,47873,34963,2024-10-04 19:34:43,0,0,0,0,0,0
3,2673446010,201392388,47873,52396,2024-10-04 19:34:43,0,0,0,0,0,0
3,2673446010,201392388,47873,27791,2024-10-04 19:34:43,0,0,0,0,0,0
3,2673446010,201392388,47873,34963,2024-10-04 19:34:44,0,0,0,0,0,0
3,2673446010,201392388,47873,52396,2024-10-04 19:34:44,0,0,0,0,0,0
3,2673446010,201392388,47873,27791,2024-10-04 19:34:44,0,0,0,0,0,0
3,2673446010,201392388,47873,34963,2024-10-04 19:34:45,0,0,0,0,0,0
3,2673446010,201392388,47873,52396,2024-10-04 19:34:45,0,0,0,0,0,0
3,2673446010,201392388,47873,27791,2024-10-04 19:34:45,0,0,0,0,0,0
3,2673446010,201392388,47873,34963,2024-10-04 19:34:46,0,0,0,0,0,0
3,2673446010,201392388,47873,52396,2024-10-04 19:34:46,0,0,0,0,0,0
3,2673446010,201392388,47873,27791,2024-10-04 19:34:46,0,0,0,0,0,0
3,2673446010,201392388,47873,34963,2024-10-04 19:34:47,0,0,0,0,0,0
3,2673446010,201392388,47873,52396,2024-10-04 19:34:47,0,0,0,0,0,0
3,2673446010,201392388,47873,27791,2024-10-04 19:34:47,0,0,0,0,0,0
3,2673446010,201392388,47873,34963,2024-10-04 19:34:48,0,0,0,0,0,0
3,2673446010,201392388,47873,52396,2024-10-04 19:34:48,0,0,0,0,0,0
3,2673446010,201392388,47873,27791,2024-10-04 19:34:48,0,0,0,0,0,0
3,2673446010,201392388,47873,34963,2024-10-04 19:34:49,0,0,0,0,0,0
3,2673446010,201392388,47873,52396,2024-10-04 19:34:49,0,0,0,0,0,0
3,2673446010,201392388,47873,27791,2024-10-04 19:34:49,0,0,0,0,0,0
3,2673446010,201392388,47873,34963,2024-10-04 19:34:50,0,0,0,0,0,0
3,2673446010,201392388,47873,52396,2024-10-04 19:34:50,0,0,0,0,0,0
3,2673446010,201392388,47873,27791,2024-10-04 19:34:50,0,0,0,0,0,0
3,2673446010,201392388,47873,34963,2024-10-04 19:34:51,0,0,0,0,0,0
3,2673446010,201392388,47873,52396,2024-10-04 19:34:51,0,0,0,0,0,0
3,2673446010,201392388,47873,27791,2024-10-04 19:34:51,0,0,0,0,0,0
3,2673446010,201392388,47873,13457,2024-10-04 19:34:52,4846,1771,6617,6,10,16
3,2673446010,201392388,47873,34963,2024-10-04 19:34:52,0,0,0,0,0,0
3,2673446010,201392388,47873,52396,2024-10-04 19:34:52,0,0,0,0,0,0
3,2673446010,201392388,47873,27791,2024-10-04 19:34:52,0,0,0,0,0,0
1,2673446010,201392386,47873,35557,2024-10-04 19:34:53,3373,921,4294,4,4,8
3,2673446010,201392388,47873,13457,2024-10-04 19:34:53,4233,691,4924,8,7,15
3,2673446010,201392388,47873,34963,2024-10-04 19:34:53,0,0,0,0,0,0
3,2673446010,201392388,47873,52396,2024-10-04 19:34:53,0,0,0,0,0,0
3,2673446010,201392388,47873,27791,2024-10-04 19:34:53,0,0,0,0,0,0
1,2673446010,201392386,47873,35557,2024-10-04 19:34:54,5818,1541,7359,11,13,24
3,2673446010,201392388,47873,13457,2024-10-04 19:34:54,0,0,0,0,0,0
2,2673446010,201392387,47873,22165,2024-10-04 19:34:54,60,104,164,1,1,2
3,2673446010,201392388,47873,52396,2024-10-04 19:34:54,0,0,0,0,0,0
3,2673446010,201392388,47873,27791,2024-10-04 19:34:54,0,0,0,0,0,0
1,2673446010,201392386,47873,35557,2024-10-04 19:34:55,0,0,0,0,0,0
3,2673446010,201392388,47873,13457,2024-10-04 19:34:55,0,0,0,0,0,0
2,2673446010,201392387,47873,22165,2024-10-04 19:34:55,9236,2478,11714,16,17,33
3,2673446010,201392388,47873,52396,2024-10-04 19:34:55,0,0,0,0,0,0
3,2673446010,201392388,47873,27791,2024-10-04 19:34:55,0,0,0,0,0,0
1,2673446010,201392386,47873,35557,2024-10-04 19:34:56,0,0,0,0,0,0
3,2673446010,201392388,47873,13457,2024-10-04 19:34:56,0,0,0,0,0,0
2,2673446010,201392387,47873,22165,2024-10-04 19:34:56,0,0,0,0,0,0
3,2673446010,201392388,47873,52396,2024-10-04 19:34:56,0,0,0,0,0,0
3,2673446010,201392388,47873,27791,2024-10-04 19:34:56,0,0,0,0,0,0
1,2673446010,201392386,47873,35557,2024-10-04 19:34:57,0,0,0,0,0,0
3,2673446010,201392388,47873,13457,2024-10-04 19:34:57,0,0,0,0,0,0
2,2673446010,201392387,47873,22165,2024-10-04 19:34:57,0,0,0,0,0,0
3,2673446010,201392388,47873,52396,2024-10-04 19:34:57,0,0,0,0,0,0
3,2673446010,201392388,47873,27791,2024-10-04 19:34:57,0,0,0,0,0,0
1,2673446010,201392386,47873,35557,2024-10-04 19:34:58,0,0,0,0,0,0
3,2673446010,201392388,47873,13457,2024-10-04 19:34:58,0,0,0,0,0,0
2,2673446010,201392387,47873,22165,2024-10-04 19:34:58,0,0,0,0,0,0
3,2673446010,201392388,47873,52396,2024-10-04 19:34:58,0,0,0,0,0,0
3,2673446010,201392388,47873,27791,2024-10-04 19:34:58,0,0,0,0,0,0
1,2673446010,201392386,47873,35557,2024-10-04 19:34:59,0,0,0,0,0,0
3,2673446010,201392388,47873,13457,2024-10-04 19:34:59,0,0,0,0,0,0
2,2673446010,201392387,47873,22165,2024-10-04 19:34:59,0,0,0,0,0,0
3,2673446010,201392388,47873,52396,2024-10-04 19:34:59,0,0,0,0,0,0
3,2673446010,201392388,47873,27791,2024-10-04 19:34:59,0,0,0,0,0,0
1,2673446010,201392386,47873,35557,2024-10-04 19:35:00,0,0,0,0,0,0
3,2673446010,201392388,47873,13457,2024-10-04 19:35:00,0,0,0,0,0,0
2,2673446010,201392387,47873,22165,2024-10-04 19:35:00,0,0,0,0,0,0
3,2673446010,201392388,47873,52396,2024-10-04 19:35:00,0,0,0,0,0,0
3,2673446010,201392388,47873,27791,2024-10-04 19:35:00,0,0,0,0,0,0
1,2673446010,201392386,47873,35557,2024-10-04 19:35:01,0,0,0,0,0,0
3,2673446010,201392388,47873,13457,2024-10-04 19:35:01,0,0,0,0,0,0
3,2673446010,201392388,47873,52396,2024-10-04 19:35:01,0,0,0,0,0,0
3,2673446010,201392388,47873,27791,2024-10-04 19:35:01,0,0,0,0,0,0
1,2673446010,201392386,47873,35557,2024-10-04 19:35:02,0,0,0,0,0,0
3,2673446010,201392388,47873,13457,2024-10-04 19:35:02,0,0,0,0,0,0
3,2673446010,201392388,47873,52396,2024-10-04 19:35:02,0,0,0,0,0,0
3,2673446010,201392388,47873,27791,2024-10-04 19:35:02,0,0,0,0,0,0
3,2673446010,201392388,47873,13457,2024-10-04 19:35:03,0,0,0,0,0,0
3,2673446010,201392388,47873,52396,2024-10-04 19:35:03,0,0,0,0,0,0
3,2673446010,201392388,47873,27791,2024-10-04 19:35:03,0,0,0,0,0,0
3,2673446010,201392388,47873,13457,2024-10-04 19:35:04,0,0,0,0,0,0
3,2673446010,201392388,47873,52396,2024-10-04 19:35:04,0,0,0,0,0,0
3,2673446010,201392388,47873,27791,2024-10-04 19:35:04,0,0,0,0,0,0
3,2673446010,201392388,47873,13457,2024-10-04 19:35:05,0,0,0,0,0,0
3,2673446010,201392388,47873,52396,2024-10-04 19:35:05,0,0,0,0,0,0
3,2673446010,201392388,47873,27791,2024-10-04 19:35:05,0,0,0,0,0,0
3,2673446010,201392388,47873,13457,2024-10-04 19:35:06,0,0,0,0,0,0
3,2673446010,201392388,47873,52396,2024-10-04 19:35:06,0,0,0,0,0,0
3,2673446010,201392388,47873,27791,2024-10-04 19:35:06,0,0,0,0,0,0
3,2673446010,201392388,47873,13457,2024-10-04 19:35:07,0,0,0,0,0,0
3,2673446010,201392388,47873,52396,2024-10-04 19:35:07,0,0,0,0,0,0
3,2673446010,201392388,47873,27791,2024-10-04 19:35:07,0,0,0,0,0,0
3,2673446010,201392388,47873,13457,2024-10-04 19:35:08,0,0,0,0,0,0
3,2673446010,201392388,47873,52396,2024-10-04 19:35:08,0,0,0,0,0,0
3,2673446010,201392388,47873,27791,2024-10-04 19:35:08,0,0,0,0,0,0
3,2673446010,201392388,47873,13457,2024-10-04 19:35:09,0,0,0,0,0,0
3,2673446010,201392388,47873,52396,2024-10-04 19:35:09,0,0,0,0,0,0
3,2673446010,201392388,47873,27791,2024-10-04 19:35:09,0,0,0,0,0,0
3,2673446010,201392388,47873,13457,2024-10-04 19:35:10,0,0,0,0,0,0
3,2673446010,201392388,47873,52396,2024-10-04 19:35:10,0,0,0,0,0,0
3,2673446010,201392388,47873,27791,2024-10-04 19:35:10,0,0,0,0,0,0
3,2673446010,201392388,47873,13457,2024-10-04 19:35:11,0,0,0,0,0,0
3,2673446010,201392388,47873,52396,2024-10-04 19:35:11,0,0,0,0,0,0
3,2673446010,201392388,47873,27791,2024-10-04 19:35:11,0,0,0,0,0,0
3,2673446010,201392388,47873,13457,2024-10-04 19:35:12,0,0,0,0,0,0
3,2673446010,201392388,47873,52396,2024-10-04 19:35:12,0,0,0,0,0,0
3,2673446010,201392388,47873,27791,2024-10-04 19:35:12,0,0,0,0,0,0
3,2673446010,201392388,47873,13457,2024-10-04 19:35:13,0,0,0,0,0,0
3,2673446010,201392388,47873,52396,2024-10-04 19:35:13,0,0,0,0,0,0
3,2673446010,201392388,47873,27791,2024-10-04 19:35:13,0,0,0,0,0,0
3,2673446010,201392388,47873,13457,2024-10-04 19:35:14,0,0,0,0,0,0
3,2673446010,201392388,47873,52396,2024-10-04 19:35:14,0,0,0,0,0,0
3,2673446010,201392388,47873,27791,2024-10-04 19:35:14,0,0,0,0,0,0
3,2673446010,201392388,47873,13457,2024-10-04 19:35:15,0,0,0,0,0,0
3,2673446010,201392388,47873,52396,2024-10-04 19:35:15,0,0,0,0,0,0
3,2673446010,201392388,47873,27791,2024-10-04 19:35:15,0,0,0,0,0,0
3,2673446010,201392388,47873,13457,2024-10-04 19:35:16,0,0,0,0,0,0
3,2673446010,201392388,47873,52396,2024-10-04 19:35:16,0,0,0,0,0,0
3,2673446010,201392388,47873,27791,2024-10-04 19:35:16,0,0,0,0,0,0
3,2673446010,201392388,47873,13457,2024-10-04 19:35:17,0,0,0,0,0,0
3,2673446010,201392388,47873,52396,2024-10-04 19:35:17,0,0,0,0,0,0
3,2673446010,201392388,47873,27791,2024-10-04 19:35:17,0,0,0,0,0,0
3,2673446010,201392388,47873,13457,2024-10-04 19:35:18,0,0,0,0,0,0
3,2673446010,201392388,47873,52396,2024-10-04 19:35:18,0,0,0,0,0,0
3,2673446010,201392388,47873,27791,2024-10-04 19:35:18,0,0,0,0,0,0
3,2673446010,201392388,47873,13457,2024-10-04 19:35:19,0,0,0,0,0,0
3,2673446010,201392388,47873,52396,2024-10-04 19:35:19,0,0,0,0,0,0
3,2673446010,201392388,47873,27791,2024-10-04 19:35:19,0,0,0,0,0,0
3,2673446010,201392388,47873,13457,2024-10-04 19:35:20,0,0,0,0,0,0
3,2673446010,201392388,47873,52396,2024-10-04 19:35:20,0,0,0,0,0,0
3,2673446010,201392388,47873,27791,2024-10-04 19:35:20,0,0,0,0,0,0
3,2673446010,201392388,47873,13457,2024-10-04 19:35:21,0,0,0,0,0,0
3,2673446010,201392388,47873,52396,2024-10-04 19:35:21,0,0,0,0,0,0
3,2673446010,201392388,47873,27791,2024-10-04 19:35:21,0,0,0,0,0,0
3,2673446010,201392388,47873,7373,2024-10-04 19:35:22,0,104,104,0,1,1
3,2673446010,201392388,47873,13457,2024-10-04 19:35:22,0,0,0,0,0,0
3,2673446010,201392388,47873,52396,2024-10-04 19:35:22,0,0,0,0,0,0
3,2673446010,201392388,47873,27791,2024-10-04 19:35:22,0,0,0,0,0,0
3,2673446010,201392388,47873,7373,2024-10-04 19:35:23,11146,2490,13636,16,17,33
3,2673446010,201392388,47873,13457,2024-10-04 19:35:23,0,0,0,0,0,0
1,2673446010,201392386,47873,4759,2024-10-04 19:35:23,0,104,104,0,1,1
3,2673446010,201392388,47873,52396,2024-10-04 19:35:23,0,0,0,0,0,0
3,2673446010,201392388,47873,27791,2024-10-04 19:35:23,0,0,0,0,0,0
3,2673446010,201392388,47873,7373,2024-10-04 19:35:24,0,0,0,0,0,0
3,2673446010,201392388,47873,13457,2024-10-04 19:35:24,0,0,0,0,0,0
1,2673446010,201392386,47873,4759,2024-10-04 19:35:24,7082,1794,8876,9,10,19
3,2673446010,201392388,47873,52396,2024-10-04 19:35:24,0,0,0,0,0,0
3,2673446010,201392388,47873,27791,2024-10-04 19:35:24,0,0,0,0,0,0
3,2673446010,201392388,47873,7373,2024-10-04 19:35:25,0,0,0,0,0,0
1,2673446010,201392386,47873,4759,2024-10-04 19:35:25,4053,780,4833,6,8,14
2,2673446010,201392387,47873,35486,2024-10-04 19:35:25,60,104,164,1,1,2
3,2673446010,201392388,47873,52396,2024-10-04 19:35:25,0,0,0,0,0,0
3,2673446010,201392388,47873,27791,2024-10-04 19:35:25,0,0,0,0,0,0
3,2673446010,201392388,47873,7373,2024-10-04 19:35:26,0,0,0,0,0,0
1,2673446010,201392386,47873,4759,2024-10-04 19:35:26,0,0,0,0,0,0
2,2673446010,201392387,47873,35486,2024-10-04 19:35:26,7138,2442,9580,14,17,31
3,2673446010,201392388,47873,52396,2024-10-04 19:35:26,0,0,0,0,0,0
3,2673446010,201392388,47873,27791,2024-10-04 19:35:26,0,0,0,0,0,0
3,2673446010,201392388,47873,7373,2024-10-04 19:35:27,0,0,0,0,0,0
1,2673446010,201392386,47873,4759,2024-10-04 19:35:27,0,0,0,0,0,0
2,2673446010,201392387,47873,35486,2024-10-04 19:35:27,0,0,0,0,0,0
3,2673446010,201392388,47873,52396,2024-10-04 19:35:27,0,0,0,0,0,0
3,2673446010,201392388,47873,27791,2024-10-04 19:35:27,0,0,0,0,0,0
3,2673446010,201392388,47873,7373,2024-10-04 19:35:28,0,0,0,0,0,0
1,2673446010,201392386,47873,4759,2024-10-04 19:35:28,0,0,0,0,0,0
2,2673446010,201392387,47873,35486,2024-10-04 19:35:28,0,0,0,0,0,0
3,2673446010,201392388,47873,52396,2024-10-04 19:35:28,0,0,0,0,0,0
3,2673446010,201392388,47873,27791,2024-10-04 19:35:28,0,0,0,0,0,0
3,2673446010,201392388,47873,7373,2024-10-04 19:35:29,0,0,0,0,0,0
1,2673446010,201392386,47873,4759,2024-10-04 19:35:29,0,0,0,0,0,0
2,2673446010,201392387,47873,35486,2024-10-04 19:35:29,0,0,0,0,0,0
3,2673446010,201392388,47873,52396,2024-10-04 19:35:29,0,0,0,0,0,0
3,2673446010,201392388,47873,27791,2024-10-04 19:35:29,0,0,0,0,0,0
3,2673446010,201392388,47873,7373,2024-10-04 19:35:30,0,0,0,0,0,0
1,2673446010,201392386,47873,4759,2024-10-04 19:35:30,0,0,0,0,0,0
2,2673446010,201392387,47873,35486,2024-10-04 19:35:30,0,0,0,0,0,0
3,2673446010,201392388,47873,52396,2024-10-04 19:35:30,0,0,0,0,0,0
3,2673446010,201392388,47873,27791,2024-10-04 19:35:30,0,0,0,0,0,0
3,2673446010,201392388,47873,7373,2024-10-04 19:35:31,0,0,0,0,0,0
1,2673446010,201392386,47873,4759,2024-10-04 19:35:31,0,0,0,0,0,0
2,2673446010,201392387,47873,35486,2024-10-04 19:35:31,0,0,0,0,0,0
3,2673446010,201392388,47873,52396,2024-10-04 19:35:31,0,0,0,0,0,0
3,2673446010,201392388,47873,27791,2024-10-04 19:35:31,0,0,0,0,0,0
3,2673446010,201392388,47873,7373,2024-10-04 19:35:32,0,0,0,0,0,0
1,2673446010,201392386,47873,4759,2024-10-04 19:35:32,0,0,0,0,0,0
3,2673446010,201392388,47873,52396,2024-10-04 19:35:32,0,0,0,0,0,0
3,2673446010,201392388,47873,27791,2024-10-04 19:35:32,0,0,0,0,0,0
3,2673446010,201392388,47873,7373,2024-10-04 19:35:33,0,0,0,0,0,0
3,2673446010,201392388,47873,52396,2024-10-04 19:35:33,0,0,0,0,0,0
3,2673446010,201392388,47873,27791,2024-10-04 19:35:33,0,0,0,0,0,0
3,2673446010,201392388,47873,7373,2024-10-04 19:35:34,0,0,0,0,0,0
3,2673446010,201392388,47873,52396,2024-10-04 19:35:34,0,0,0,0,0,0
3,2673446010,201392388,47873,27791,2024-10-04 19:35:34,0,0,0,0,0,0
3,2673446010,201392388,47873,7373,2024-10-04 19:35:35,0,0,0,0,0,0
3,2673446010,201392388,47873,52396,2024-10-04 19:35:35,0,0,0,0,0,0
3,2673446010,201392388,47873,27791,2024-10-04 19:35:35,0,0,0,0,0,0
3,2673446010,201392388,47873,7373,2024-10-04 19:35:36,0,0,0,0,0,0
3,2673446010,201392388,47873,52396,2024-10-04 19:35:36,0,0,0,0,0,0
3,2673446010,201392388,47873,27791,2024-10-04 19:35:36,0,0,0,0,0,0
3,2673446010,201392388,47873,7373,2024-10-04 19:35:37,0,0,0,0,0,0
3,2673446010,201392388,47873,52396,2024-10-04 19:35:37,0,0,0,0,0,0
3,2673446010,201392388,47873,27791,2024-10-04 19:35:37,0,0,0,0,0,0
3,2673446010,201392388,47873,7373,2024-10-04 19:35:38,0,0,0,0,0,0
3,2673446010,201392388,47873,52396,2024-10-04 19:35:38,0,0,0,0,0,0
3,2673446010,201392388,47873,27791,2024-10-04 19:35:38,0,0,0,0,0,0
3,2673446010,201392388,47873,7373,2024-10-04 19:35:39,0,0,0,0,0,0
3,2673446010,201392388,47873,52396,2024-10-04 19:35:39,0,0,0,0,0,0
3,2673446010,201392388,47873,27791,2024-10-04 19:35:39,0,0,0,0,0,0
3,2673446010,201392388,47873,7373,2024-10-04 19:35:40,0,0,0,0,0,0
3,2673446010,201392388,47873,52396,2024-10-04 19:35:40,0,0,0,0,0,0
3,2673446010,201392388,47873,27791,2024-10-04 19:35:40,0,0,0,0,0,0
3,2673446010,201392388,47873,7373,2024-10-04 19:35:41,0,0,0,0,0,0
3,2673446010,201392388,47873,52396,2024-10-04 19:35:41,0,0,0,0,0,0
3,2673446010,201392388,47873,27791,2024-10-04 19:35:41,0,0,0,0,0,0
3,2673446010,201392388,47873,7373,2024-10-04 19:35:42,0,0,0,0,0,0
3,2673446010,201392388,47873,52396,2024-10-04 19:35:42,0,0,0,0,0,0
3,2673446010,201392388,47873,27791,2024-10-04 19:35:42,0,0,0,0,0,0
3,2673446010,201392388,47873,7373,2024-10-04 19:35:43,0,0,0,0,0,0
3,2673446010,201392388,47873,52396,2024-10-04 19:35:43,0,0,0,0,0,0
3,2673446010,201392388,47873,27791,2024-10-04 19:35:43,0,0,0,0,0,0
3,2673446010,201392388,47873,7373,2024-10-04 19:35:44,0,0,0,0,0,0
3,2673446010,201392388,47873,52396,2024-10-04 19:35:44,0,0,0,0,0,0
3,2673446010,201392388,47873,27791,2024-10-04 19:35:44,0,0,0,0,0,0
3,2673446010,201392388,47873,7373,2024-10-04 19:35:45,0,0,0,0,0,0
3,2673446010,201392388,47873,52396,2024-10-04 19:35:45,0,0,0,0,0,0
3,2673446010,201392388,47873,27791,2024-10-04 19:35:45,0,0,0,0,0,0
3,2673446010,201392388,47873,7373,2024-10-04 19:35:46,0,0,0,0,0,0
3,2673446010,201392388,47873,52396,2024-10-04 19:35:46,0,0,0,0,0,0
3,2673446010,201392388,47873,27791,2024-10-04 19:35:46,0,0,0,0,0,0
3,2673446010,201392388,47873,7373,2024-10-04 19:35:47,0,0,0,0,0,0
3,2673446010,201392388,47873,52396,2024-10-04 19:35:47,0,0,0,0,0,0
3,2673446010,201392388,47873,27791,2024-10-04 19:35:47,0,0,0,0,0,0
3,2673446010,201392388,47873,7373,2024-10-04 19:35:48,0,0,0,0,0,0
3,2673446010,201392388,47873,52396,2024-10-04 19:35:48,0,0,0,0,0,0
3,2673446010,201392388,47873,27791,2024-10-04 19:35:48,0,0,0,0,0,0
3,2673446010,201392388,47873,7373,2024-10-04 19:35:49,0,0,0,0,0,0
3,2673446010,201392388,47873,52396,2024-10-04 19:35:49,0,0,0,0,0,0
3,2673446010,201392388,47873,27791,2024-10-04 19:35:49,0,0,0,0,0,0
3,2673446010,201392388,47873,7373,2024-10-04 19:35:50,0,0,0,0,0,0
3,2673446010,201392388,47873,52396,2024-10-04 19:35:50,0,0,0,0,0,0
3,2673446010,201392388,47873,27791,2024-10-04 19:35:50,0,0,0,0,0,0
3,2673446010,201392388,47873,7373,2024-10-04 19:35:51,0,0,0,0,0,0
3,2673446010,201392388,47873,52396,2024-10-04 19:35:51,0,0,0,0,0,0
3,2673446010,201392388,47873,27791,2024-10-04 19:35:51,0,0,0,0,0,0
3,2673446010,201392388,47873,7373,2024-10-04 19:35:52,0,0,0,0,0,0
3,2673446010,201392388,47873,52396,2024-10-04 19:35:52,0,0,0,0,0,0
3,2673446010,201392388,47873,27791,2024-10-04 19:35:52,0,0,0,0,0,0
3,2673446010,201392388,47873,7373,2024-10-04 19:35:53,0,0,0,0,0,0
3,2673446010,201392388,47873,52396,2024-10-04 19:35:53,0,0,0,0,0,0
3,2673446010,201392388,47873,27791,2024-10-04 19:35:53,0,0,0,0,0,0
3,2673446010,201392388,47873,7373,2024-10-04 19:35:54,0,0,0,0,0,0
3,2673446010,201392388,47873,52417,2024-10-04 19:35:54,60,813,873,1,3,4
3,2673446010,201392388,47873,52396,2024-10-04 19:35:54,0,0,0,0,0,0
3,2673446010,201392388,47873,27791,2024-10-04 19:35:54,0,0,0,0,0,0
3,2673446010,201392388,47873,7373,2024-10-04 19:35:55,0,0,0,0,0,0
3,2673446010,201392388,47873,52417,2024-10-04 19:35:55,0,0,0,0,0,0
3,2673446010,201392388,47873,52396,2024-10-04 19:35:55,0,0,0,0,0,0
3,2673446010,201392388,47873,27791,2024-10-04 19:35:55,0,0,0,0,0,0
3,2673446010,201392388,47873,52417,2024-10-04 19:35:56,8975,1565,10540,12,13,25
1,2673446010,201392386,47873,45272,2024-10-04 19:35:56,9052,2378,11430,13,16,29
3,2673446010,201392388,47873,52396,2024-10-04 19:35:56,0,0,0,0,0,0
3,2673446010,201392388,47873,27791,2024-10-04 19:35:56,0,0,0,0,0,0
2,2673446010,201392387,47873,63643,2024-10-04 19:35:56,4793,921,5714,5,4,9
3,2673446010,201392388,47873,52417,2024-10-04 19:35:57,0,0,0,0,0,0
1,2673446010,201392386,47873,45272,2024-10-04 19:35:57,0,0,0,0,0,0
3,2673446010,201392388,47873,52396,2024-10-04 19:35:57,0,0,0,0,0,0
3,2673446010,201392388,47873,27791,2024-10-04 19:35:57,0,0,0,0,0,0
2,2673446010,201392387,47873,63643,2024-10-04 19:35:57,0,0,0,0,0,0
3,2673446010,201392388,47873,52417,2024-10-04 19:35:58,0,0,0,0,0,0
1,2673446010,201392386,47873,45272,2024-10-04 19:35:58,0,0,0,0,0,0
3,2673446010,201392388,47873,27791,2024-10-04 19:35:58,0,0,0,0,0,0
2,2673446010,201392387,47873,63643,2024-10-04 19:35:58,6356,1757,8113,10,15,25
3,2673446010,201392388,47873,52417,2024-10-04 19:35:59,0,0,0,0,0,0
1,2673446010,201392386,47873,45272,2024-10-04 19:35:59,0,0,0,0,0,0
3,2673446010,201392388,47873,27791,2024-10-04 19:35:59,0,0,0,0,0,0
2,2673446010,201392387,47873,63643,2024-10-04 19:35:59,0,0,0,0,0,0
3,2673446010,201392388,47873,52417,2024-10-04 19:36:00,0,0,0,0,0,0
1,2673446010,201392386,47873,45272,2024-10-04 19:36:00,0,0,0,0,0,0
3,2673446010,201392388,47873,27791,2024-10-04 19:36:00,0,0,0,0,0,0
2,2673446010,201392387,47873,63643,2024-10-04 19:36:00,0,0,0,0,0,0
3,2673446010,201392388,47873,52417,2024-10-04 19:36:01,0,0,0,0,0,0
1,2673446010,201392386,47873,45272,2024-10-04 19:36:01,0,0,0,0,0,0
3,2673446010,201392388,47873,27791,2024-10-04 19:36:01,0,0,0,0,0,0
2,2673446010,201392387,47873,63643,2024-10-04 19:36:01,0,0,0,0,0,0
3,2673446010,201392388,47873,52417,2024-10-04 19:36:02,0,0,0,0,0,0
1,2673446010,201392386,47873,45272,2024-10-04 19:36:02,0,0,0,0,0,0
3,2673446010,201392388,47873,27791,2024-10-04 19:36:02,0,0,0,0,0,0
2,2673446010,201392387,47873,63643,2024-10-04 19:36:02,0,0,0,0,0,0
3,2673446010,201392388,47873,52417,2024-10-04 19:36:03,0,0,0,0,0,0
1,2673446010,201392386,47873,45272,2024-10-04 19:36:03,0,0,0,0,0,0
3,2673446010,201392388,47873,27791,2024-10-04 19:36:03,0,0,0,0,0,0
2,2673446010,201392387,47873,63643,2024-10-04 19:36:03,0,0,0,0,0,0
3,2673446010,201392388,47873,52417,2024-10-04 19:36:04,0,0,0,0,0,0
3,2673446010,201392388,47873,27791,2024-10-04 19:36:04,0,0,0,0,0,0
3,2673446010,201392388,47873,52417,2024-10-04 19:36:05,0,0,0,0,0,0
3,2673446010,201392388,47873,27791,2024-10-04 19:36:05,0,0,0,0,0,0
3,2673446010,201392388,47873,27791,2024-10-04 19:36:06,0,0,0,0,0,0
3,2673446010,201392388,47873,27791,2024-10-04 19:36:07,0,0,0,0,0,0
3,2673446010,201392388,47873,27791,2024-10-04 19:36:08,0,0,0,0,0,0
3,2673446010,201392388,47873,27791,2024-10-04 19:36:09,0,0,0,0,0,0
3,2673446010,201392388,47873,27791,2024-10-04 19:36:10,0,0,0,0,0,0
3,2673446010,201392388,47873,27791,2024-10-04 19:36:11,0,0,0,0,0,0
3,2673446010,201392388,47873,27791,2024-10-04 19:36:12,0,0,0,0,0,0
3,2673446010,201392388,47873,27791,2024-10-04 19:36:13,0,0,0,0,0,0
3,2673446010,201392388,47873,27791,2024-10-04 19:36:14,0,0,0,0,0,0
3,2673446010,201392388,47873,27791,2024-10-04 19:36:15,0,0,0,0,0,0
3,2673446010,201392388,47873,27791,2024-10-04 19:36:16,0,0,0,0,0,0
3,2673446010,201392388,47873,27791,2024-10-04 19:36:17,0,0,0,0,0,0
3,2673446010,201392388,47873,27791,2024-10-04 19:36:18,0,0,0,0,0,0
3,2673446010,201392388,47873,27791,2024-10-04 19:36:19,0,0,0,0,0,0
3,2673446010,201392388,47873,27791,2024-10-04 19:36:20,0,0,0,0,0,0
3,2673446010,201392388,47873,27791,2024-10-04 19:36:21,0,0,0,0,0,0
3,2673446010,201392388,47873,27791,2024-10-04 19:36:22,0,0,0,0,0,0
3,2673446010,201392388,47873,27791,2024-10-04 19:36:23,0,0,0,0,0,0
3,2673446010,201392388,47873,27791,2024-10-04 19:36:24,0,0,0,0,0,0
3,2673446010,201392388,47873,61146,2024-10-04 19:36:25,0,104,104,0,1,1
1,2673446010,201392386,47873,46310,2024-10-04 19:36:25,0,104,104,0,1,1
3,2673446010,201392388,47873,27791,2024-10-04 19:36:25,0,0,0,0,0,0
3,2673446010,201392388,47873,61146,2024-10-04 19:36:26,0,0,0,0,0,0
1,2673446010,201392386,47873,46310,2024-10-04 19:36:26,0,0,0,0,0,0
3,2673446010,201392388,47873,27791,2024-10-04 19:36:26,0,0,0,0,0,0
3,2673446010,201392388,47873,61146,2024-10-04 19:36:27,11176,2490,13666,15,17,32
1,2673446010,201392386,47873,46310,2024-10-04 19:36:27,11358,2670,14028,18,19,37
3,2673446010,201392388,47873,27791,2024-10-04 19:36:27,0,0,0,0,0,0
3,2673446010,201392388,47873,61146,2024-10-04 19:36:28,0,0,0,0,0,0
1,2673446010,201392386,47873,46310,2024-10-04 19:36:28,0,0,0,0,0,0
3,2673446010,201392388,47873,27791,2024-10-04 19:36:28,0,0,0,0,0,0
2,2673446010,201392387,47873,2182,2024-10-04 19:36:29,0,104,104,0,1,1
3,2673446010,201392388,47873,61146,2024-10-04 19:36:29,0,0,0,0,0,0
1,2673446010,201392386,47873,46310,2024-10-04 19:36:29,0,0,0,0,0,0
3,2673446010,201392388,47873,27791,2024-10-04 19:36:29,0,0,0,0,0,0
2,2673446010,201392387,47873,2182,2024-10-04 19:36:30,9236,2574,11810,16,18,34
3,2673446010,201392388,47873,61146,2024-10-04 19:36:30,0,0,0,0,0,0
1,2673446010,201392386,47873,46310,2024-10-04 19:36:30,0,0,0,0,0,0
3,2673446010,201392388,47873,27791,2024-10-04 19:36:30,0,0,0,0,0,0
2,2673446010,201392387,47873,2182,2024-10-04 19:36:31,0,0,0,0,0,0
3,2673446010,201392388,47873,61146,2024-10-04 19:36:31,0,0,0,0,0,0
1,2673446010,201392386,47873,46310,2024-10-04 19:36:31,0,0,0,0,0,0
3,2673446010,201392388,47873,27791,2024-10-04 19:36:31,0,0,0,0,0,0
2,2673446010,201392387,47873,2182,2024-10-04 19:36:32,0,0,0,0,0,0
3,2673446010,201392388,47873,61146,2024-10-04 19:36:32,0,0,0,0,0,0
1,2673446010,201392386,47873,46310,2024-10-04 19:36:32,0,0,0,0,0,0
3,2673446010,201392388,47873,27791,2024-10-04 19:36:32,0,0,0,0,0,0
2,2673446010,201392387,47873,2182,2024-10-04 19:36:33,0,0,0,0,0,0
3,2673446010,201392388,47873,61146,2024-10-04 19:36:33,0,0,0,0,0,0
1,2673446010,201392386,47873,46310,2024-10-04 19:36:33,0,0,0,0,0,0
3,2673446010,201392388,47873,27791,2024-10-04 19:36:33,0,0,0,0,0,0
2,2673446010,201392387,47873,2182,2024-10-04 19:36:34,0,0,0,0,0,0
3,2673446010,201392388,47873,61146,2024-10-04 19:36:34,0,0,0,0,0,0
1,2673446010,201392386,47873,46310,2024-10-04 19:36:34,0,0,0,0,0,0
3,2673446010,201392388,47873,27791,2024-10-04 19:36:34,0,0,0,0,0,0
2,2673446010,201392387,47873,2182,2024-10-04 19:36:35,0,0,0,0,0,0
3,2673446010,201392388,47873,61146,2024-10-04 19:36:35,0,0,0,0,0,0
1,2673446010,201392386,47873,46310,2024-10-04 19:36:35,0,0,0,0,0,0
3,2673446010,201392388,47873,27791,2024-10-04 19:36:35,0,0,0,0,0,0
3,2673446010,201392388,47873,61146,2024-10-04 19:36:36,0,0,0,0,0,0
1,2673446010,201392386,47873,46310,2024-10-04 19:36:36,0,0,0,0,0,0
3,2673446010,201392388,47873,27791,2024-10-04 19:36:36,0,0,0,0,0,0
3,2673446010,201392388,47873,61146,2024-10-04 19:36:37,0,0,0,0,0,0
1,2673446010,201392386,47873,46310,2024-10-04 19:36:37,0,0,0,0,0,0
3,2673446010,201392388,47873,27791,2024-10-04 19:36:37,0,0,0,0,0,0
3,2673446010,201392388,47873,61146,2024-10-04 19:36:38,0,0,0,0,0,0
1,2673446010,201392386,47873,46310,2024-10-04 19:36:38,0,0,0,0,0,0
3,2673446010,201392388,47873,27791,2024-10-04 19:36:38,0,0,0,0,0,0
3,2673446010,201392388,47873,61146,2024-10-04 19:36:39,0,0,0,0,0,0
1,2673446010,201392386,47873,46310,2024-10-04 19:36:39,0,0,0,0,0,0
3,2673446010,201392388,47873,27791,2024-10-04 19:36:39,0,0,0,0,0,0
3,2673446010,201392388,47873,61146,2024-10-04 19:36:40,0,0,0,0,0,0
1,2673446010,201392386,47873,46310,2024-10-04 19:36:40,0,0,0,0,0,0
3,2673446010,201392388,47873,27791,2024-10-04 19:36:40,0,0,0,0,0,0
3,2673446010,201392388,47873,61146,2024-10-04 19:36:41,0,0,0,0,0,0
1,2673446010,201392386,47873,46310,2024-10-04 19:36:41,0,0,0,0,0,0
3,2673446010,201392388,47873,27791,2024-10-04 19:36:41,0,0,0,0,0,0
3,2673446010,201392388,47873,61146,2024-10-04 19:36:42,0,0,0,0,0,0
1,2673446010,201392386,47873,46310,2024-10-04 19:36:42,0,0,0,0,0,0
3,2673446010,201392388,47873,27791,2024-10-04 19:36:42,0,0,0,0,0,0
3,2673446010,201392388,47873,61146,2024-10-04 19:36:43,0,0,0,0,0,0
1,2673446010,201392386,47873,46310,2024-10-04 19:36:43,0,0,0,0,0,0
3,2673446010,201392388,47873,27791,2024-10-04 19:36:43,0,0,0,0,0,0
3,2673446010,201392388,47873,61146,2024-10-04 19:36:44,0,0,0,0,0,0
1,2673446010,201392386,47873,46310,2024-10-04 19:36:44,0,0,0,0,0,0
3,2673446010,201392388,47873,27791,2024-10-04 19:36:44,0,0,0,0,0,0
3,2673446010,201392388,47873,61146,2024-10-04 19:36:45,0,0,0,0,0,0
1,2673446010,201392386,47873,46310,2024-10-04 19:36:45,0,0,0,0,0,0
3,2673446010,201392388,47873,27791,2024-10-04 19:36:45,0,0,0,0,0,0
3,2673446010,201392388,47873,61146,2024-10-04 19:36:46,0,0,0,0,0,0
1,2673446010,201392386,47873,46310,2024-10-04 19:36:46,0,0,0,0,0,0
3,2673446010,201392388,47873,27791,2024-10-04 19:36:46,0,0,0,0,0,0
3,2673446010,201392388,47873,61146,2024-10-04 19:36:47,0,0,0,0,0,0
1,2673446010,201392386,47873,46310,2024-10-04 19:36:47,0,0,0,0,0,0
3,2673446010,201392388,47873,27791,2024-10-04 19:36:47,0,0,0,0,0,0
3,2673446010,201392388,47873,61146,2024-10-04 19:36:48,0,0,0,0,0,0
1,2673446010,201392386,47873,46310,2024-10-04 19:36:48,0,0,0,0,0,0
3,2673446010,201392388,47873,27791,2024-10-04 19:36:48,0,0,0,0,0,0
3,2673446010,201392388,47873,61146,2024-10-04 19:36:49,0,0,0,0,0,0
1,2673446010,201392386,47873,46310,2024-10-04 19:36:49,0,0,0,0,0,0
3,2673446010,201392388,47873,27791,2024-10-04 19:36:49,0,0,0,0,0,0
3,2673446010,201392388,47873,61146,2024-10-04 19:36:50,0,0,0,0,0,0
1,2673446010,201392386,47873,46310,2024-10-04 19:36:50,0,0,0,0,0,0
3,2673446010,201392388,47873,27791,2024-10-04 19:36:50,0,0,0,0,0,0
3,2673446010,201392388,47873,61146,2024-10-04 19:36:51,0,0,0,0,0,0
1,2673446010,201392386,47873,46310,2024-10-04 19:36:51,0,0,0,0,0,0
3,2673446010,201392388,47873,27791,2024-10-04 19:36:51,0,0,0,0,0,0
3,2673446010,201392388,47873,61146,2024-10-04 19:36:52,0,0,0,0,0,0
1,2673446010,201392386,47873,46310,2024-10-04 19:36:52,0,0,0,0,0,0
3,2673446010,201392388,47873,27791,2024-10-04 19:36:52,0,0,0,0,0,0
3,2673446010,201392388,47873,61146,2024-10-04 19:36:53,0,0,0,0,0,0
1,2673446010,201392386,47873,46310,2024-10-04 19:36:53,0,0,0,0,0,0
3,2673446010,201392388,47873,27791,2024-10-04 19:36:53,0,0,0,0,0,0
3,2673446010,201392388,47873,61146,2024-10-04 19:36:54,0,0,0,0,0,0
1,2673446010,201392386,47873,46310,2024-10-04 19:36:54,0,0,0,0,0,0
3,2673446010,201392388,47873,27791,2024-10-04 19:36:54,0,0,0,0,0,0
1,2673446010,201392386,47873,46796,2024-10-04 19:36:55,0,104,104,0,1,1
3,2673446010,201392388,47873,61146,2024-10-04 19:36:55,0,0,0,0,0,0
1,2673446010,201392386,47873,46310,2024-10-04 19:36:55,0,0,0,0,0,0
3,2673446010,201392388,47873,27791,2024-10-04 19:36:55,0,0,0,0,0,0
1,2673446010,201392386,47873,46796,2024-10-04 19:36:56,9226,2478,11704,15,17,32
1,2673446010,201392386,47873,46310,2024-10-04 19:36:56,0,0,0,0,0,0
3,2673446010,201392388,47873,47273,2024-10-04 19:36:56,9277,2678,11955,16,19,35
3,2673446010,201392388,47873,27791,2024-10-04 19:36:56,0,0,0,0,0,0
1,2673446010,201392386,47873,46796,2024-10-04 19:36:57,0,0,0,0,0,0
1,2673446010,201392386,47873,46310,2024-10-04 19:36:57,0,0,0,0,0,0
3,2673446010,201392388,47873,47273,2024-10-04 19:36:57,0,0,0,0,0,0
3,2673446010,201392388,47873,27791,2024-10-04 19:36:57,0,0,0,0,0,0
1,2673446010,201392386,47873,46796,2024-10-04 19:36:58,0,0,0,0,0,0
2,2673446010,201392387,47873,51436,2024-10-04 19:36:58,0,104,104,0,1,1
3,2673446010,201392388,47873,47273,2024-10-04 19:36:58,0,0,0,0,0,0
3,2673446010,201392388,47873,27791,2024-10-04 19:36:58,0,0,0,0,0,0
1,2673446010,201392386,47873,46796,2024-10-04 19:36:59,0,0,0,0,0,0
2,2673446010,201392387,47873,51436,2024-10-04 19:36:59,0,0,0,0,0,0
3,2673446010,201392388,47873,47273,2024-10-04 19:36:59,0,0,0,0,0,0
3,2673446010,201392388,47873,27791,2024-10-04 19:36:59,0,0,0,0,0,0
1,2673446010,201392386,47873,46796,2024-10-04 19:37:00,0,0,0,0,0,0
2,2673446010,201392387,47873,51436,2024-10-04 19:37:00,7236,2442,9678,16,17,33
3,2673446010,201392388,47873,47273,2024-10-04 19:37:00,0,0,0,0,0,0
3,2673446010,201392388,47873,27791,2024-10-04 19:37:00,0,0,0,0,0,0
1,2673446010,201392386,47873,46796,2024-10-04 19:37:01,0,0,0,0,0,0
2,2673446010,201392387,47873,51436,2024-10-04 19:37:01,0,0,0,0,0,0
3,2673446010,201392388,47873,47273,2024-10-04 19:37:01,0,0,0,0,0,0
3,2673446010,201392388,47873,27791,2024-10-04 19:37:01,0,0,0,0,0,0
1,2673446010,201392386,47873,46796,2024-10-04 19:37:02,0,0,0,0,0,0
2,2673446010,201392387,47873,51436,2024-10-04 19:37:02,0,0,0,0,0,0
3,2673446010,201392388,47873,47273,2024-10-04 19:37:02,0,0,0,0,0,0
3,2673446010,201392388,47873,27791,2024-10-04 19:37:02,0,0,0,0,0,0
1,2673446010,201392386,47873,46796,2024-10-04 19:37:03,0,0,0,0,0,0
2,2673446010,201392387,47873,51436,2024-10-04 19:37:03,0,0,0,0,0,0
3,2673446010,201392388,47873,47273,2024-10-04 19:37:03,0,0,0,0,0,0
3,2673446010,201392388,47873,27791,2024-10-04 19:37:03,0,0,0,0,0,0
1,2673446010,201392386,47873,46796,2024-10-04 19:37:04,0,0,0,0,0,0
2,2673446010,201392387,47873,51436,2024-10-04 19:37:04,0,0,0,0,0,0
3,2673446010,201392388,47873,47273,2024-10-04 19:37:04,0,0,0,0,0,0
3,2673446010,201392388,47873,27791,2024-10-04 19:37:04,0,0,0,0,0,0
1,2673446010,201392386,47873,46796,2024-10-04 19:37:05,0,0,0,0,0,0
3,2673446010,201392388,47873,47273,2024-10-04 19:37:05,0,0,0,0,0,0
3,2673446010,201392388,47873,27791,2024-10-04 19:37:05,0,0,0,0,0,0
1,2673446010,201392386,47873,46796,2024-10-04 19:37:06,0,0,0,0,0,0
3,2673446010,201392388,47873,47273,2024-10-04 19:37:06,0,0,0,0,0,0
3,2673446010,201392388,47873,27791,2024-10-04 19:37:06,0,0,0,0,0,0
1,2673446010,201392386,47873,46796,2024-10-04 19:37:07,0,0,0,0,0,0
3,2673446010,201392388,47873,47273,2024-10-04 19:37:07,0,0,0,0,0,0
3,2673446010,201392388,47873,27791,2024-10-04 19:37:07,0,0,0,0,0,0
1,2673446010,201392386,47873,46796,2024-10-04 19:37:08,0,0,0,0,0,0
3,2673446010,201392388,47873,27791,2024-10-04 19:37:08,0,0,0,0,0,0
1,2673446010,201392386,47873,46796,2024-10-04 19:37:09,0,0,0,0,0,0
3,2673446010,201392388,47873,27791,2024-10-04 19:37:09,0,0,0,0,0,0
1,2673446010,201392386,47873,46796,2024-10-04 19:37:10,0,0,0,0,0,0
3,2673446010,201392388,47873,27791,2024-10-04 19:37:10,0,0,0,0,0,0
1,2673446010,201392386,47873,46796,2024-10-04 19:37:11,0,0,0,0,0,0
3,2673446010,201392388,47873,27791,2024-10-04 19:37:11,0,0,0,0,0,0
1,2673446010,201392386,47873,46796,2024-10-04 19:37:12,0,0,0,0,0,0
3,2673446010,201392388,47873,27791,2024-10-04 19:37:12,0,0,0,0,0,0
1,2673446010,201392386,47873,46796,2024-10-04 19:37:13,0,0,0,0,0,0
3,2673446010,201392388,47873,27791,2024-10-04 19:37:13,0,0,0,0,0,0
1,2673446010,201392386,47873,46796,2024-10-04 19:37:14,0,0,0,0,0,0
3,2673446010,201392388,47873,27791,2024-10-04 19:37:14,0,0,0,0,0,0
1,2673446010,201392386,47873,46796,2024-10-04 19:37:15,0,0,0,0,0,0
3,2673446010,201392388,47873,27791,2024-10-04 19:37:15,0,0,0,0,0,0
1,2673446010,201392386,47873,46796,2024-10-04 19:37:16,0,0,0,0,0,0
3,2673446010,201392388,47873,27791,2024-10-04 19:37:16,0,0,0,0,0,0
1,2673446010,201392386,47873,46796,2024-10-04 19:37:17,0,0,0,0,0,0
3,2673446010,201392388,47873,27791,2024-10-04 19:37:17,0,0,0,0,0,0
1,2673446010,201392386,47873,46796,2024-10-04 19:37:18,0,0,0,0,0,0
3,2673446010,201392388,47873,27791,2024-10-04 19:37:18,0,0,0,0,0,0
1,2673446010,201392386,47873,46796,2024-10-04 19:37:19,0,0,0,0,0,0
3,2673446010,201392388,47873,27791,2024-10-04 19:37:19,0,0,0,0,0,0
1,2673446010,201392386,47873,46796,2024-10-04 19:37:20,0,0,0,0,0,0
3,2673446010,201392388,47873,27791,2024-10-04 19:37:20,0,0,0,0,0,0
1,2673446010,201392386,47873,46796,2024-10-04 19:37:21,0,0,0,0,0,0
3,2673446010,201392388,47873,27791,2024-10-04 19:37:21,0,0,0,0,0,0
1,2673446010,201392386,47873,46796,2024-10-04 19:37:22,0,0,0,0,0,0
3,2673446010,201392388,47873,27791,2024-10-04 19:37:22,0,0,0,0,0,0
1,2673446010,201392386,47873,46796,2024-10-04 19:37:23,0,0,0,0,0,0
3,2673446010,201392388,47873,27791,2024-10-04 19:37:23,0,0,0,0,0,0
1,2673446010,201392386,47873,46796,2024-10-04 19:37:24,0,0,0,0,0,0
3,2673446010,201392388,47873,27791,2024-10-04 19:37:24,0,0,0,0,0,0
1,2673446010,201392386,47873,46796,2024-10-04 19:37:25,0,0,0,0,0,0
3,2673446010,201392388,47873,30894,2024-10-04 19:37:25,0,104,104,0,1,1
3,2673446010,201392388,47873,27791,2024-10-04 19:37:25,0,0,0,0,0,0
1,2673446010,201392386,47873,46796,2024-10-04 19:37:26,0,0,0,0,0,0
1,2673446010,201392386,47873,4774,2024-10-04 19:37:26,6208,2186,8394,11,14,25
3,2673446010,201392388,47873,30894,2024-10-04 19:37:26,5040,1794,6834,8,10,18
3,2673446010,201392388,47873,27791,2024-10-04 19:37:26,0,0,0,0,0,0
1,2673446010,201392386,47873,4774,2024-10-04 19:37:27,3020,588,3608,5,6,11
3,2673446010,201392388,47873,30894,2024-10-04 19:37:27,6112,876,6988,7,9,16
3,2673446010,201392388,47873,27791,2024-10-04 19:37:27,0,0,0,0,0,0
1,2673446010,201392386,47873,4774,2024-10-04 19:37:28,0,0,0,0,0,0
3,2673446010,201392388,47873,30894,2024-10-04 19:37:28,0,0,0,0,0,0
3,2673446010,201392388,47873,27791,2024-10-04 19:37:28,0,0,0,0,0,0
1,2673446010,201392386,47873,4774,2024-10-04 19:37:29,0,0,0,0,0,0
2,2673446010,201392387,47873,46289,2024-10-04 19:37:29,3374,813,4187,4,3,7
3,2673446010,201392388,47873,30894,2024-10-04 19:37:29,0,0,0,0,0,0
3,2673446010,201392388,47873,27791,2024-10-04 19:37:29,0,0,0,0,0,0
1,2673446010,201392386,47873,4774,2024-10-04 19:37:30,0,0,0,0,0,0
2,2673446010,201392387,47873,46289,2024-10-04 19:37:30,8006,1865,9871,14,16,30
3,2673446010,201392388,47873,30894,2024-10-04 19:37:30,0,0,0,0,0,0
3,2673446010,201392388,47873,27791,2024-10-04 19:37:30,0,0,0,0,0,0
1,2673446010,201392386,47873,4774,2024-10-04 19:37:31,0,0,0,0,0,0
2,2673446010,201392387,47873,46289,2024-10-04 19:37:31,0,0,0,0,0,0
3,2673446010,201392388,47873,30894,2024-10-04 19:37:31,0,0,0,0,0,0
3,2673446010,201392388,47873,27791,2024-10-04 19:37:31,0,0,0,0,0,0
1,2673446010,201392386,47873,4774,2024-10-04 19:37:32,0,0,0,0,0,0
2,2673446010,201392387,47873,46289,2024-10-04 19:37:32,0,0,0,0,0,0
3,2673446010,201392388,47873,30894,2024-10-04 19:37:32,0,0,0,0,0,0
3,2673446010,201392388,47873,27791,2024-10-04 19:37:32,0,0,0,0,0,0
1,2673446010,201392386,47873,4774,2024-10-04 19:37:33,0,0,0,0,0,0
2,2673446010,201392387,47873,46289,2024-10-04 19:37:33,0,0,0,0,0,0
3,2673446010,201392388,47873,30894,2024-10-04 19:37:33,0,0,0,0,0,0
3,2673446010,201392388,47873,27791,2024-10-04 19:37:33,0,0,0,0,0,0
1,2673446010,201392386,47873,4774,2024-10-04 19:37:34,0,0,0,0,0,0
2,2673446010,201392387,47873,46289,2024-10-04 19:37:34,0,0,0,0,0,0
3,2673446010,201392388,47873,30894,2024-10-04 19:37:34,0,0,0,0,0,0
3,2673446010,201392388,47873,27791,2024-10-04 19:37:34,0,0,0,0,0,0
1,2673446010,201392386,47873,4774,2024-10-04 19:37:35,0,0,0,0,0,0
2,2673446010,201392387,47873,46289,2024-10-04 19:37:35,0,0,0,0,0,0
3,2673446010,201392388,47873,27791,2024-10-04 19:37:35,0,0,0,0,0,0
1,2673446010,201392386,47873,4774,2024-10-04 19:37:36,0,0,0,0,0,0
2,2673446010,201392387,47873,46289,2024-10-04 19:37:36,0,0,0,0,0,0
3,2673446010,201392388,47873,27791,2024-10-04 19:37:36,0,0,0,0,0,0
1,2673446010,201392386,47873,4774,2024-10-04 19:37:37,0,0,0,0,0,0
2,2673446010,201392387,47873,46289,2024-10-04 19:37:37,0,0,0,0,0,0
3,2673446010,201392388,47873,27791,2024-10-04 19:37:37,0,0,0,0,0,0
1,2673446010,201392386,47873,4774,2024-10-04 19:37:38,0,0,0,0,0,0
3,2673446010,201392388,47873,27791,2024-10-04 19:37:38,0,0,0,0,0,0
1,2673446010,201392386,47873,4774,2024-10-04 19:37:39,0,0,0,0,0,0
3,2673446010,201392388,47873,27791,2024-10-04 19:37:39,0,0,0,0,0,0
1,2673446010,201392386,47873,4774,2024-10-04 19:37:40,0,0,0,0,0,0
3,2673446010,201392388,47873,27791,2024-10-04 19:37:40,0,0,0,0,0,0
1,2673446010,201392386,47873,4774,2024-10-04 19:37:41,0,0,0,0,0,0
3,2673446010,201392388,47873,27791,2024-10-04 19:37:41,0,0,0,0,0,0
1,2673446010,201392386,47873,4774,2024-10-04 19:37:42,0,0,0,0,0,0
3,2673446010,201392388,47873,27791,2024-10-04 19:37:42,0,0,0,0,0,0
1,2673446010,201392386,47873,4774,2024-10-04 19:37:43,0,0,0,0,0,0
3,2673446010,201392388,47873,27791,2024-10-04 19:37:43,0,0,0,0,0,0
1,2673446010,201392386,47873,4774,2024-10-04 19:37:44,0,0,0,0,0,0
3,2673446010,201392388,47873,27791,2024-10-04 19:37:44,0,0,0,0,0,0
1,2673446010,201392386,47873,4774,2024-10-04 19:37:45,0,0,0,0,0,0
3,2673446010,201392388,47873,27791,2024-10-04 19:37:45,0,0,0,0,0,0
1,2673446010,201392386,47873,4774,2024-10-04 19:37:46,0,0,0,0,0,0
3,2673446010,201392388,47873,27791,2024-10-04 19:37:46,0,0,0,0,0,0
1,2673446010,201392386,47873,4774,2024-10-04 19:37:47,0,0,0,0,0,0
3,2673446010,201392388,47873,27791,2024-10-04 19:37:47,0,0,0,0,0,0
1,2673446010,201392386,47873,4774,2024-10-04 19:37:48,0,0,0,0,0,0
3,2673446010,201392388,47873,27791,2024-10-04 19:37:48,0,0,0,0,0,0
1,2673446010,201392386,47873,4774,2024-10-04 19:37:49,0,0,0,0,0,0
3,2673446010,201392388,47873,27791,2024-10-04 19:37:49,0,0,0,0,0,0
1,2673446010,201392386,47873,4774,2024-10-04 19:37:50,0,0,0,0,0,0
3,2673446010,201392388,47873,27791,2024-10-04 19:37:50,0,0,0,0,0,0
1,2673446010,201392386,47873,4774,2024-10-04 19:37:51,0,0,0,0,0,0
3,2673446010,201392388,47873,27791,2024-10-04 19:37:51,0,0,0,0,0,0
1,2673446010,201392386,47873,4774,2024-10-04 19:37:52,0,0,0,0,0,0
3,2673446010,201392388,47873,27791,2024-10-04 19:37:52,0,0,0,0,0,0
1,2673446010,201392386,47873,4774,2024-10-04 19:37:53,0,0,0,0,0,0
3,2673446010,201392388,47873,27791,2024-10-04 19:37:53,0,0,0,0,0,0
1,2673446010,201392386,47873,4774,2024-10-04 19:37:54,0,0,0,0,0,0
3,2673446010,201392388,47873,27791,2024-10-04 19:37:54,0,0,0,0,0,0
1,2673446010,201392386,47873,4774,2024-10-04 19:37:55,0,0,0,0,0,0
3,2673446010,201392388,47873,27791,2024-10-04 19:37:55,0,0,0,0,0,0
1,2673446010,201392386,47873,4774,2024-10-04 19:37:56,0,0,0,0,0,0
3,2673446010,201392388,47873,27791,2024-10-04 19:37:56,0,0,0,0,0,0
1,2673446010,201392386,47873,4774,2024-10-04 19:37:57,0,0,0,0,0,0
3,2673446010,201392388,47873,29829,2024-10-04 19:37:57,3374,921,4295,4,4,8
3,2673446010,201392388,47873,27791,2024-10-04 19:37:57,0,0,0,0,0,0
1,2673446010,201392386,47873,4774,2024-10-04 19:37:58,0,0,0,0,0,0
3,2673446010,201392388,47873,29829,2024-10-04 19:37:58,7916,2045,9961,13,18,31
1,2673446010,201392386,47873,46799,2024-10-04 19:37:58,0,104,104,0,1,1
3,2673446010,201392388,47873,27791,2024-10-04 19:37:58,0,0,0,0,0,0
1,2673446010,201392386,47873,4774,2024-10-04 19:37:59,0,0,0,0,0,0
3,2673446010,201392388,47873,29829,2024-10-04 19:37:59,0,0,0,0,0,0
1,2673446010,201392386,47873,46799,2024-10-04 19:37:59,11019,2106,13125,12,13,25
3,2673446010,201392388,47873,27791,2024-10-04 19:37:59,0,0,0,0,0,0
3,2673446010,201392388,47873,29829,2024-10-04 19:38:00,0,0,0,0,0,0
1,2673446010,201392386,47873,46799,2024-10-04 19:38:00,128,480,608,2,5,7
3,2673446010,201392388,47873,27791,2024-10-04 19:38:00,0,0,0,0,0,0
2,2673446010,201392387,47873,63113,2024-10-04 19:38:01,4794,921,5715,5,4,9
3,2673446010,201392388,47873,29829,2024-10-04 19:38:01,0,0,0,0,0,0
1,2673446010,201392386,47873,46799,2024-10-04 19:38:01,0,0,0,0,0,0
3,2673446010,201392388,47873,27791,2024-10-04 19:38:01,0,0,0,0,0,0
2,2673446010,201392387,47873,63113,2024-10-04 19:38:02,6428,1853,8281,10,16,26
3,2673446010,201392388,47873,29829,2024-10-04 19:38:02,0,0,0,0,0,0
1,2673446010,201392386,47873,46799,2024-10-04 19:38:02,0,0,0,0,0,0
3,2673446010,201392388,47873,27791,2024-10-04 19:38:02,0,0,0,0,0,0
2,2673446010,201392387,47873,63113,2024-10-04 19:38:03,0,0,0,0,0,0
3,2673446010,201392388,47873,29829,2024-10-04 19:38:03,0,0,0,0,0,0
1,2673446010,201392386,47873,46799,2024-10-04 19:38:03,0,0,0,0,0,0
3,2673446010,201392388,47873,27791,2024-10-04 19:38:03,0,0,0,0,0,0
2,2673446010,201392387,47873,63113,2024-10-04 19:38:04,0,0,0,0,0,0
3,2673446010,201392388,47873,29829,2024-10-04 19:38:04,0,0,0,0,0,0
1,2673446010,201392386,47873,46799,2024-10-04 19:38:04,0,0,0,0,0,0
3,2673446010,201392388,47873,27791,2024-10-04 19:38:04,0,0,0,0,0,0
2,2673446010,201392387,47873,63113,2024-10-04 19:38:05,0,0,0,0,0,0
3,2673446010,201392388,47873,29829,2024-10-04 19:38:05,0,0,0,0,0,0
1,2673446010,201392386,47873,46799,2024-10-04 19:38:05,0,0,0,0,0,0
3,2673446010,201392388,47873,27791,2024-10-04 19:38:05,0,0,0,0,0,0
2,2673446010,201392387,47873,63113,2024-10-04 19:38:06,0,0,0,0,0,0
3,2673446010,201392388,47873,29829,2024-10-04 19:38:06,0,0,0,0,0,0
1,2673446010,201392386,47873,46799,2024-10-04 19:38:06,0,0,0,0,0,0
3,2673446010,201392388,47873,27791,2024-10-04 19:38:06,0,0,0,0,0,0
2,2673446010,201392387,47873,63113,2024-10-04 19:38:07,0,0,0,0,0,0
3,2673446010,201392388,47873,29829,2024-10-04 19:38:07,0,0,0,0,0,0
1,2673446010,201392386,47873,46799,2024-10-04 19:38:07,0,0,0,0,0,0
3,2673446010,201392388,47873,27791,2024-10-04 19:38:07,0,0,0,0,0,0
3,2673446010,201392388,47873,29829,2024-10-04 19:38:08,0,0,0,0,0,0
1,2673446010,201392386,47873,46799,2024-10-04 19:38:08,0,0,0,0,0,0
3,2673446010,201392388,47873,27791,2024-10-04 19:38:08,0,0,0,0,0,0
3,2673446010,201392388,47873,29829,2024-10-04 19:38:09,0,0,0,0,0,0
1,2673446010,201392386,47873,46799,2024-10-04 19:38:09,0,0,0,0,0,0
3,2673446010,201392388,47873,27791,2024-10-04 19:38:09,0,0,0,0,0,0
3,2673446010,201392388,47873,29829,2024-10-04 19:38:10,0,0,0,0,0,0
3,2673446010,201392388,47873,27791,2024-10-04 19:38:10,0,0,0,0,0,0
3,2673446010,201392388,47873,29829,2024-10-04 19:38:11,0,0,0,0,0,0
3,2673446010,201392388,47873,27791,2024-10-04 19:38:11,0,0,0,0,0,0
3,2673446010,201392388,47873,29829,2024-10-04 19:38:12,0,0,0,0,0,0
3,2673446010,201392388,47873,27791,2024-10-04 19:38:12,0,0,0,0,0,0
3,2673446010,201392388,47873,29829,2024-10-04 19:38:13,0,0,0,0,0,0
3,2673446010,201392388,47873,27791,2024-10-04 19:38:13,0,0,0,0,0,0
3,2673446010,201392388,47873,29829,2024-10-04 19:38:14,0,0,0,0,0,0
3,2673446010,201392388,47873,27791,2024-10-04 19:38:14,0,0,0,0,0,0
3,2673446010,201392388,47873,29829,2024-10-04 19:38:15,0,0,0,0,0,0
3,2673446010,201392388,47873,27791,2024-10-04 19:38:15,0,0,0,0,0,0
3,2673446010,201392388,47873,29829,2024-10-04 19:38:16,0,0,0,0,0,0
3,2673446010,201392388,47873,27791,2024-10-04 19:38:16,0,0,0,0,0,0
3,2673446010,201392388,47873,29829,2024-10-04 19:38:17,0,0,0,0,0,0
3,2673446010,201392388,47873,27791,2024-10-04 19:38:17,0,0,0,0,0,0
3,2673446010,201392388,47873,29829,2024-10-04 19:38:18,0,0,0,0,0,0
3,2673446010,201392388,47873,27791,2024-10-04 19:38:18,0,0,0,0,0,0
3,2673446010,201392388,47873,29829,2024-10-04 19:38:19,0,0,0,0,0,0
3,2673446010,201392388,47873,27791,2024-10-04 19:38:19,0,0,0,0,0,0
3,2673446010,201392388,47873,29829,2024-10-04 19:38:20,0,0,0,0,0,0
3,2673446010,201392388,47873,27791,2024-10-04 19:38:20,0,0,0,0,0,0
3,2673446010,201392388,47873,29829,2024-10-04 19:38:21,0,0,0,0,0,0
3,2673446010,201392388,47873,27791,2024-10-04 19:38:21,0,0,0,0,0,0
3,2673446010,201392388,47873,29829,2024-10-04 19:38:22,0,0,0,0,0,0
3,2673446010,201392388,47873,27791,2024-10-04 19:38:22,0,0,0,0,0,0
3,2673446010,201392388,47873,29829,2024-10-04 19:38:23,0,0,0,0,0,0
3,2673446010,201392388,47873,27791,2024-10-04 19:38:23,0,0,0,0,0,0
3,2673446010,201392388,47873,29829,2024-10-04 19:38:24,0,0,0,0,0,0
3,2673446010,201392388,47873,27791,2024-10-04 19:38:24,0,0,0,0,0,0
3,2673446010,201392388,47873,29829,2024-10-04 19:38:25,0,0,0,0,0,0
3,2673446010,201392388,47873,27791,2024-10-04 19:38:25,0,0,0,0,0,0
3,2673446010,201392388,47873,29829,2024-10-04 19:38:26,0,0,0,0,0,0
3,2673446010,201392388,47873,27791,2024-10-04 19:38:26,0,0,0,0,0,0
3,2673446010,201392388,47873,29829,2024-10-04 19:38:27,0,0,0,0,0,0
3,2673446010,201392388,47873,27791,2024-10-04 19:38:27,0,0,0,0,0,0
3,2673446010,201392388,47873,29829,2024-10-04 19:38:28,0,0,0,0,0,0
3,2673446010,201392388,47873,27791,2024-10-04 19:38:28,0,0,0,0,0,0
1,2673446010,201392386,47873,52941,2024-10-04 19:38:29,4793,921,5714,5,4,9
3,2673446010,201392388,47873,29829,2024-10-04 19:38:29,0,0,0,0,0,0
3,2673446010,201392388,47873,26839,2024-10-04 19:38:29,11110,2690,13800,14,19,33
3,2673446010,201392388,47873,27791,2024-10-04 19:38:29,0,0,0,0,0,0
1,2673446010,201392386,47873,52941,2024-10-04 19:38:30,6317,1673,7990,9,14,23
3,2673446010,201392388,47873,26839,2024-10-04 19:38:30,0,0,0,0,0,0
3,2673446010,201392388,47873,27791,2024-10-04 19:38:30,0,0,0,0,0,0
2,2673446010,201392387,47873,14996,2024-10-04 19:38:31,0,104,104,0,1,1
1,2673446010,201392386,47873,52941,2024-10-04 19:38:31,0,0,0,0,0,0
3,2673446010,201392388,47873,26839,2024-10-04 19:38:31,0,0,0,0,0,0
3,2673446010,201392388,47873,27791,2024-10-04 19:38:31,0,0,0,0,0,0
2,2673446010,201392387,47873,14996,2024-10-04 19:38:32,9130,2562,11692,13,18,31
1,2673446010,201392386,47873,52941,2024-10-04 19:38:32,0,0,0,0,0,0
3,2673446010,201392388,47873,26839,2024-10-04 19:38:32,0,0,0,0,0,0
3,2673446010,201392388,47873,27791,2024-10-04 19:38:32,0,0,0,0,0,0
2,2673446010,201392387,47873,14996,2024-10-04 19:38:33,0,0,0,0,0,0
1,2673446010,201392386,47873,52941,2024-10-04 19:38:33,0,0,0,0,0,0
3,2673446010,201392388,47873,26839,2024-10-04 19:38:33,0,0,0,0,0,0
3,2673446010,201392388,47873,27791,2024-10-04 19:38:33,0,0,0,0,0,0
2,2673446010,201392387,47873,14996,2024-10-04 19:38:34,0,0,0,0,0,0
1,2673446010,201392386,47873,52941,2024-10-04 19:38:34,0,0,0,0,0,0
3,2673446010,201392388,47873,26839,2024-10-04 19:38:34,0,0,0,0,0,0
3,2673446010,201392388,47873,27791,2024-10-04 19:38:34,0,0,0,0,0,0
2,2673446010,201392387,47873,14996,2024-10-04 19:38:35,0,0,0,0,0,0
1,2673446010,201392386,47873,52941,2024-10-04 19:38:35,0,0,0,0,0,0
3,2673446010,201392388,47873,26839,2024-10-04 19:38:35,0,0,0,0,0,0
3,2673446010,201392388,47873,27791,2024-10-04 19:38:35,0,0,0,0,0,0
2,2673446010,201392387,47873,14996,2024-10-04 19:38:36,0,0,0,0,0,0
1,2673446010,201392386,47873,52941,2024-10-04 19:38:36,0,0,0,0,0,0
3,2673446010,201392388,47873,26839,2024-10-04 19:38:36,0,0,0,0,0,0
3,2673446010,201392388,47873,27791,2024-10-04 19:38:36,0,0,0,0,0,0
2,2673446010,201392387,47873,14996,2024-10-04 19:38:37,0,0,0,0,0,0
1,2673446010,201392386,47873,52941,2024-10-04 19:38:37,0,0,0,0,0,0
3,2673446010,201392388,47873,26839,2024-10-04 19:38:37,0,0,0,0,0,0
3,2673446010,201392388,47873,27791,2024-10-04 19:38:37,0,0,0,0,0,0
1,2673446010,201392386,47873,52941,2024-10-04 19:38:38,0,0,0,0,0,0
3,2673446010,201392388,47873,26839,2024-10-04 19:38:38,0,0,0,0,0,0
3,2673446010,201392388,47873,27791,2024-10-04 19:38:38,0,0,0,0,0,0
1,2673446010,201392386,47873,52941,2024-10-04 19:38:39,0,0,0,0,0,0
3,2673446010,201392388,47873,26839,2024-10-04 19:38:39,0,0,0,0,0,0
3,2673446010,201392388,47873,27791,2024-10-04 19:38:39,0,0,0,0,0,0
3,2673446010,201392388,47873,26839,2024-10-04 19:38:40,0,0,0,0,0,0
3,2673446010,201392388,47873,27791,2024-10-04 19:38:40,0,0,0,0,0,0
3,2673446010,201392388,47873,26839,2024-10-04 19:38:41,0,0,0,0,0,0
3,2673446010,201392388,47873,27791,2024-10-04 19:38:41,0,0,0,0,0,0
3,2673446010,201392388,47873,26839,2024-10-04 19:38:42,0,0,0,0,0,0
3,2673446010,201392388,47873,27791,2024-10-04 19:38:42,0,0,0,0,0,0
3,2673446010,201392388,47873,26839,2024-10-04 19:38:43,0,0,0,0,0,0
3,2673446010,201392388,47873,27791,2024-10-04 19:38:43,0,0,0,0,0,0
3,2673446010,201392388,47873,26839,2024-10-04 19:38:44,0,0,0,0,0,0
3,2673446010,201392388,47873,27791,2024-10-04 19:38:44,0,0,0,0,0,0
3,2673446010,201392388,47873,26839,2024-10-04 19:38:45,0,0,0,0,0,0
3,2673446010,201392388,47873,27791,2024-10-04 19:38:45,0,0,0,0,0,0
3,2673446010,201392388,47873,26839,2024-10-04 19:38:46,0,0,0,0,0,0
3,2673446010,201392388,47873,27791,2024-10-04 19:38:46,0,0,0,0,0,0
3,2673446010,201392388,47873,26839,2024-10-04 19:38:47,0,0,0,0,0,0
3,2673446010,201392388,47873,27791,2024-10-04 19:38:47,0,0,0,0,0,0
3,2673446010,201392388,47873,26839,2024-10-04 19:38:48,0,0,0,0,0,0
3,2673446010,201392388,47873,27791,2024-10-04 19:38:48,0,0,0,0,0,0
3,2673446010,201392388,47873,26839,2024-10-04 19:38:49,0,0,0,0,0,0
3,2673446010,201392388,47873,27791,2024-10-04 19:38:49,0,0,0,0,0,0
3,2673446010,201392388,47873,26839,2024-10-04 19:38:50,0,0,0,0,0,0
3,2673446010,201392388,47873,27791,2024-10-04 19:38:50,0,0,0,0,0,0
3,2673446010,201392388,47873,26839,2024-10-04 19:38:51,0,0,0,0,0,0
3,2673446010,201392388,47873,27791,2024-10-04 19:38:51,0,0,0,0,0,0
3,2673446010,201392388,47873,26839,2024-10-04 19:38:52,0,0,0,0,0,0
3,2673446010,201392388,47873,27791,2024-10-04 19:38:52,0,0,0,0,0,0
3,2673446010,201392388,47873,26839,2024-10-04 19:38:53,0,0,0,0,0,0
3,2673446010,201392388,47873,27791,2024-10-04 19:38:53,0,0,0,0,0,0
3,2673446010,201392388,47873,26839,2024-10-04 19:38:54,0,0,0,0,0,0
3,2673446010,201392388,47873,27791,2024-10-04 19:38:54,0,0,0,0,0,0
3,2673446010,201392388,47873,26839,2024-10-04 19:38:55,0,0,0,0,0,0
3,2673446010,201392388,47873,27791,2024-10-04 19:38:55,0,0,0,0,0,0
3,2673446010,201392388,47873,26839,2024-10-04 19:38:56,0,0,0,0,0,0
3,2673446010,201392388,47873,27791,2024-10-04 19:38:56,0,0,0,0,0,0
3,2673446010,201392388,47873,26839,2024-10-04 19:38:57,0,0,0,0,0,0
3,2673446010,201392388,47873,27791,2024-10-04 19:38:57,0,0,0,0,0,0
3,2673446010,201392388,47873,26839,2024-10-04 19:38:58,0,0,0,0,0,0
3,2673446010,201392388,47873,27791,2024-10-04 19:38:58,0,0,0,0,0,0
3,2673446010,201392388,47873,57534,2024-10-04 19:38:59,0,104,104,0,1,1
3,2673446010,201392388,47873,26839,2024-10-04 19:38:59,0,0,0,0,0,0
3,2673446010,201392388,47873,27791,2024-10-04 19:38:59,0,0,0,0,0,0
1,2673446010,201392386,47873,51423,2024-10-04 19:39:00,11199,2594,13793,16,18,34
3,2673446010,201392388,47873,57534,2024-10-04 19:39:00,9567,1998,11565,12,12,24
3,2673446010,201392388,47873,27791,2024-10-04 19:39:00,0,0,0,0,0,0
1,2673446010,201392386,47873,51423,2024-10-04 19:39:01,0,0,0,0,0,0
3,2673446010,201392388,47873,57534,2024-10-04 19:39:01,1600,672,2272,4,7,11
3,2673446010,201392388,47873,27791,2024-10-04 19:39:01,0,0,0,0,0,0
1,2673446010,201392386,47873,51423,2024-10-04 19:39:02,0,0,0,0,0,0
3,2673446010,201392388,47873,57534,2024-10-04 19:39:02,0,0,0,0,0,0
3,2673446010,201392388,47873,27791,2024-10-04 19:39:02,0,0,0,0,0,0
1,2673446010,201392386,47873,51423,2024-10-04 19:39:03,0,0,0,0,0,0
3,2673446010,201392388,47873,57534,2024-10-04 19:39:03,0,0,0,0,0,0
3,2673446010,201392388,47873,27791,2024-10-04 19:39:03,0,0,0,0,0,0
2,2673446010,201392387,47873,10951,2024-10-04 19:39:03,9168,2582,11750,15,18,33
1,2673446010,201392386,47873,51423,2024-10-04 19:39:04,0,0,0,0,0,0
3,2673446010,201392388,47873,57534,2024-10-04 19:39:04,0,0,0,0,0,0
3,2673446010,201392388,47873,27791,2024-10-04 19:39:04,0,0,0,0,0,0
2,2673446010,201392387,47873,10951,2024-10-04 19:39:04,0,0,0,0,0,0
1,2673446010,201392386,47873,51423,2024-10-04 19:39:05,0,0,0,0,0,0
3,2673446010,201392388,47873,57534,2024-10-04 19:39:05,0,0,0,0,0,0
3,2673446010,201392388,47873,27791,2024-10-04 19:39:05,0,0,0,0,0,0
2,2673446010,201392387,47873,10951,2024-10-04 19:39:05,0,0,0,0,0,0
1,2673446010,201392386,47873,51423,2024-10-04 19:39:06,0,0,0,0,0,0
3,2673446010,201392388,47873,57534,2024-10-04 19:39:06,0,0,0,0,0,0
3,2673446010,201392388,47873,27791,2024-10-04 19:39:06,0,0,0,0,0,0
2,2673446010,201392387,47873,10951,2024-10-04 19:39:06,0,0,0,0,0,0
1,2673446010,201392386,47873,51423,2024-10-04 19:39:07,0,0,0,0,0,0
3,2673446010,201392388,47873,57534,2024-10-04 19:39:07,0,0,0,0,0,0
3,2673446010,201392388,47873,27791,2024-10-04 19:39:07,0,0,0,0,0,0
2,2673446010,201392387,47873,10951,2024-10-04 19:39:07,0,0,0,0,0,0
1,2673446010,201392386,47873,51423,2024-10-04 19:39:08,0,0,0,0,0,0
3,2673446010,201392388,47873,57534,2024-10-04 19:39:08,0,0,0,0,0,0
3,2673446010,201392388,47873,27791,2024-10-04 19:39:08,0,0,0,0,0,0
2,2673446010,201392387,47873,10951,2024-10-04 19:39:08,0,0,0,0,0,0
1,2673446010,201392386,47873,51423,2024-10-04 19:39:09,0,0,0,0,0,0
3,2673446010,201392388,47873,57534,2024-10-04 19:39:09,0,0,0,0,0,0
3,2673446010,201392388,47873,27791,2024-10-04 19:39:09,0,0,0,0,0,0
1,2673446010,201392386,47873,51423,2024-10-04 19:39:10,0,0,0,0,0,0
3,2673446010,201392388,47873,57534,2024-10-04 19:39:10,0,0,0,0,0,0
3,2673446010,201392388,47873,27791,2024-10-04 19:39:10,0,0,0,0,0,0
1,2673446010,201392386,47873,51423,2024-10-04 19:39:11,0,0,0,0,0,0
3,2673446010,201392388,47873,57534,2024-10-04 19:39:11,0,0,0,0,0,0
3,2673446010,201392388,47873,27791,2024-10-04 19:39:11,0,0,0,0,0,0
1,2673446010,201392386,47873,51423,2024-10-04 19:39:12,0,0,0,0,0,0
3,2673446010,201392388,47873,57534,2024-10-04 19:39:12,0,0,0,0,0,0
3,2673446010,201392388,47873,27791,2024-10-04 19:39:12,0,0,0,0,0,0
1,2673446010,201392386,47873,51423,2024-10-04 19:39:13,0,0,0,0,0,0
3,2673446010,201392388,47873,57534,2024-10-04 19:39:13,0,0,0,0,0,0
3,2673446010,201392388,47873,27791,2024-10-04 19:39:13,0,0,0,0,0,0
1,2673446010,201392386,47873,51423,2024-10-04 19:39:14,0,0,0,0,0,0
3,2673446010,201392388,47873,57534,2024-10-04 19:39:14,0,0,0,0,0,0
3,2673446010,201392388,47873,27791,2024-10-04 19:39:14,0,0,0,0,0,0
1,2673446010,201392386,47873,51423,2024-10-04 19:39:15,0,0,0,0,0,0
3,2673446010,201392388,47873,57534,2024-10-04 19:39:15,0,0,0,0,0,0
3,2673446010,201392388,47873,27791,2024-10-04 19:39:15,0,0,0,0,0,0
1,2673446010,201392386,47873,51423,2024-10-04 19:39:16,0,0,0,0,0,0
3,2673446010,201392388,47873,57534,2024-10-04 19:39:16,0,0,0,0,0,0
3,2673446010,201392388,47873,27791,2024-10-04 19:39:16,0,0,0,0,0,0
1,2673446010,201392386,47873,51423,2024-10-04 19:39:17,0,0,0,0,0,0
3,2673446010,201392388,47873,57534,2024-10-04 19:39:17,0,0,0,0,0,0
3,2673446010,201392388,47873,27791,2024-10-04 19:39:17,0,0,0,0,0,0
1,2673446010,201392386,47873,51423,2024-10-04 19:39:18,0,0,0,0,0,0
3,2673446010,201392388,47873,57534,2024-10-04 19:39:18,0,0,0,0,0,0
3,2673446010,201392388,47873,27791,2024-10-04 19:39:18,0,0,0,0,0,0
1,2673446010,201392386,47873,51423,2024-10-04 19:39:19,0,0,0,0,0,0
3,2673446010,201392388,47873,57534,2024-10-04 19:39:19,0,0,0,0,0,0
3,2673446010,201392388,47873,27791,2024-10-04 19:39:19,0,0,0,0,0,0
1,2673446010,201392386,47873,51423,2024-10-04 19:39:20,0,0,0,0,0,0
3,2673446010,201392388,47873,57534,2024-10-04 19:39:20,0,0,0,0,0,0
3,2673446010,201392388,47873,27791,2024-10-04 19:39:20,0,0,0,0,0,0
1,2673446010,201392386,47873,51423,2024-10-04 19:39:21,0,0,0,0,0,0
3,2673446010,201392388,47873,57534,2024-10-04 19:39:21,0,0,0,0,0,0
3,2673446010,201392388,47873,27791,2024-10-04 19:39:21,0,0,0,0,0,0
1,2673446010,201392386,47873,51423,2024-10-04 19:39:22,0,0,0,0,0,0
3,2673446010,201392388,47873,57534,2024-10-04 19:39:22,0,0,0,0,0,0
3,2673446010,201392388,47873,27791,2024-10-04 19:39:22,0,0,0,0,0,0
1,2673446010,201392386,47873,51423,2024-10-04 19:39:23,0,0,0,0,0,0
3,2673446010,201392388,47873,57534,2024-10-04 19:39:23,0,0,0,0,0,0
3,2673446010,201392388,47873,27791,2024-10-04 19:39:23,0,0,0,0,0,0
1,2673446010,201392386,47873,51423,2024-10-04 19:39:24,0,0,0,0,0,0
3,2673446010,201392388,47873,57534,2024-10-04 19:39:24,0,0,0,0,0,0
3,2673446010,201392388,47873,27791,2024-10-04 19:39:24,0,0,0,0,0,0
1,2673446010,201392386,47873,51423,2024-10-04 19:39:25,0,0,0,0,0,0
3,2673446010,201392388,47873,57534,2024-10-04 19:39:25,0,0,0,0,0,0
3,2673446010,201392388,47873,27791,2024-10-04 19:39:25,0,0,0,0,0,0
1,2673446010,201392386,47873,51423,2024-10-04 19:39:26,0,0,0,0,0,0
3,2673446010,201392388,47873,57534,2024-10-04 19:39:26,0,0,0,0,0,0
3,2673446010,201392388,47873,27791,2024-10-04 19:39:26,0,0,0,0,0,0
1,2673446010,201392386,47873,51423,2024-10-04 19:39:27,0,0,0,0,0,0
3,2673446010,201392388,47873,57534,2024-10-04 19:39:27,0,0,0,0,0,0
3,2673446010,201392388,47873,27791,2024-10-04 19:39:27,0,0,0,0,0,0
1,2673446010,201392386,47873,51423,2024-10-04 19:39:28,0,0,0,0,0,0
3,2673446010,201392388,47873,57534,2024-10-04 19:39:28,0,0,0,0,0,0
3,2673446010,201392388,47873,27791,2024-10-04 19:39:28,0,0,0,0,0,0
1,2673446010,201392386,47873,51423,2024-10-04 19:39:29,0,0,0,0,0,0
3,2673446010,201392388,47873,57534,2024-10-04 19:39:29,0,0,0,0,0,0
3,2673446010,201392388,47873,27791,2024-10-04 19:39:29,0,0,0,0,0,0
1,2673446010,201392386,47873,51423,2024-10-04 19:39:30,0,0,0,0,0,0
1,2673446010,201392386,47873,21694,2024-10-04 19:39:30,60,104,164,1,1,2
3,2673446010,201392388,47873,33466,2024-10-04 19:39:30,9253,2558,11811,16,18,34
3,2673446010,201392388,47873,27791,2024-10-04 19:39:30,0,0,0,0,0,0
1,2673446010,201392386,47873,21694,2024-10-04 19:39:31,9279,2454,11733,16,17,33
3,2673446010,201392388,47873,33466,2024-10-04 19:39:31,0,0,0,0,0,0
3,2673446010,201392388,47873,27791,2024-10-04 19:39:31,0,0,0,0,0,0
1,2673446010,201392386,47873,21694,2024-10-04 19:39:32,0,0,0,0,0,0
3,2673446010,201392388,47873,33466,2024-10-04 19:39:32,0,0,0,0,0,0
3,2673446010,201392388,47873,27791,2024-10-04 19:39:32,0,0,0,0,0,0
1,2673446010,201392386,47873,21694,2024-10-04 19:39:33,0,0,0,0,0,0
3,2673446010,201392388,47873,33466,2024-10-04 19:39:33,0,0,0,0,0,0
3,2673446010,201392388,47873,27791,2024-10-04 19:39:33,0,0,0,0,0,0
2,2673446010,201392387,47873,21143,2024-10-04 19:39:33,0,104,104,0,1,1
1,2673446010,201392386,47873,21694,2024-10-04 19:39:34,0,0,0,0,0,0
3,2673446010,201392388,47873,33466,2024-10-04 19:39:34,0,0,0,0,0,0
3,2673446010,201392388,47873,27791,2024-10-04 19:39:34,0,0,0,0,0,0
2,2673446010,201392387,47873,21143,2024-10-04 19:39:34,0,0,0,0,0,0
1,2673446010,201392386,47873,21694,2024-10-04 19:39:35,0,0,0,0,0,0
3,2673446010,201392388,47873,33466,2024-10-04 19:39:35,0,0,0,0,0,0
3,2673446010,201392388,47873,27791,2024-10-04 19:39:35,0,0,0,0,0,0
2,2673446010,201392387,47873,21143,2024-10-04 19:39:35,9295,2562,11857,17,18,35
1,2673446010,201392386,47873,21694,2024-10-04 19:39:36,0,0,0,0,0,0
3,2673446010,201392388,47873,33466,2024-10-04 19:39:36,0,0,0,0,0,0
3,2673446010,201392388,47873,27791,2024-10-04 19:39:36,0,0,0,0,0,0
2,2673446010,201392387,47873,21143,2024-10-04 19:39:36,0,0,0,0,0,0
1,2673446010,201392386,47873,21694,2024-10-04 19:39:37,0,0,0,0,0,0
3,2673446010,201392388,47873,33466,2024-10-04 19:39:37,0,0,0,0,0,0
3,2673446010,201392388,47873,27791,2024-10-04 19:39:37,0,0,0,0,0,0
2,2673446010,201392387,47873,21143,2024-10-04 19:39:37,0,0,0,0,0,0
1,2673446010,201392386,47873,21694,2024-10-04 19:39:38,0,0,0,0,0,0
3,2673446010,201392388,47873,33466,2024-10-04 19:39:38,0,0,0,0,0,0
3,2673446010,201392388,47873,27791,2024-10-04 19:39:38,0,0,0,0,0,0
2,2673446010,201392387,47873,21143,2024-10-04 19:39:38,0,0,0,0,0,0
1,2673446010,201392386,47873,21694,2024-10-04 19:39:39,0,0,0,0,0,0
3,2673446010,201392388,47873,33466,2024-10-04 19:39:39,0,0,0,0,0,0
3,2673446010,201392388,47873,27791,2024-10-04 19:39:39,0,0,0,0,0,0
2,2673446010,201392387,47873,21143,2024-10-04 19:39:39,0,0,0,0,0,0
1,2673446010,201392386,47873,21694,2024-10-04 19:39:40,0,0,0,0,0,0
3,2673446010,201392388,47873,33466,2024-10-04 19:39:40,0,0,0,0,0,0
3,2673446010,201392388,47873,27791,2024-10-04 19:39:40,0,0,0,0,0,0
1,2673446010,201392386,47873,21694,2024-10-04 19:39:41,0,0,0,0,0,0
3,2673446010,201392388,47873,33466,2024-10-04 19:39:41,0,0,0,0,0,0
3,2673446010,201392388,47873,27791,2024-10-04 19:39:41,0,0,0,0,0,0
1,2673446010,201392386,47873,21694,2024-10-04 19:39:42,0,0,0,0,0,0
3,2673446010,201392388,47873,33466,2024-10-04 19:39:42,0,0,0,0,0,0
3,2673446010,201392388,47873,27791,2024-10-04 19:39:42,0,0,0,0,0,0
3,2673446010,201392388,47873,33466,2024-10-04 19:39:43,0,0,0,0,0,0
3,2673446010,201392388,47873,27791,2024-10-04 19:39:43,0,0,0,0,0,0
3,2673446010,201392388,47873,33466,2024-10-04 19:39:44,0,0,0,0,0,0
3,2673446010,201392388,47873,27791,2024-10-04 19:39:44,0,0,0,0,0,0
3,2673446010,201392388,47873,33466,2024-10-04 19:39:45,0,0,0,0,0,0
3,2673446010,201392388,47873,27791,2024-10-04 19:39:45,0,0,0,0,0,0
3,2673446010,201392388,47873,33466,2024-10-04 19:39:46,0,0,0,0,0,0
3,2673446010,201392388,47873,27791,2024-10-04 19:39:46,0,0,0,0,0,0
3,2673446010,201392388,47873,33466,2024-10-04 19:39:47,0,0,0,0,0,0
3,2673446010,201392388,47873,27791,2024-10-04 19:39:47,0,0,0,0,0,0
3,2673446010,201392388,47873,33466,2024-10-04 19:39:48,0,0,0,0,0,0
3,2673446010,201392388,47873,27791,2024-10-04 19:39:48,0,0,0,0,0,0
3,2673446010,201392388,47873,33466,2024-10-04 19:39:49,0,0,0,0,0,0
3,2673446010,201392388,47873,27791,2024-10-04 19:39:49,0,0,0,0,0,0
3,2673446010,201392388,47873,33466,2024-10-04 19:39:50,0,0,0,0,0,0
3,2673446010,201392388,47873,27791,2024-10-04 19:39:50,0,0,0,0,0,0
3,2673446010,201392388,47873,33466,2024-10-04 19:39:51,0,0,0,0,0,0
3,2673446010,201392388,47873,27791,2024-10-04 19:39:51,0,0,0,0,0,0
3,2673446010,201392388,47873,33466,2024-10-04 19:39:52,0,0,0,0,0,0
3,2673446010,201392388,47873,27791,2024-10-04 19:39:52,0,0,0,0,0,0
3,2673446010,201392388,47873,33466,2024-10-04 19:39:53,0,0,0,0,0,0
3,2673446010,201392388,47873,27791,2024-10-04 19:39:53,0,0,0,0,0,0
3,2673446010,201392388,47873,33466,2024-10-04 19:39:54,0,0,0,0,0,0
3,2673446010,201392388,47873,27791,2024-10-04 19:39:54,0,0,0,0,0,0
3,2673446010,201392388,47873,33466,2024-10-04 19:39:55,0,0,0,0,0,0
3,2673446010,201392388,47873,27791,2024-10-04 19:39:55,0,0,0,0,0,0
3,2673446010,201392388,47873,33466,2024-10-04 19:39:56,0,0,0,0,0,0
3,2673446010,201392388,47873,27791,2024-10-04 19:39:56,0,0,0,0,0,0
3,2673446010,201392388,47873,33466,2024-10-04 19:39:57,0,0,0,0,0,0
3,2673446010,201392388,47873,27791,2024-10-04 19:39:57,0,0,0,0,0,0
3,2673446010,201392388,47873,33466,2024-10-04 19:39:58,0,0,0,0,0,0
3,2673446010,201392388,47873,27791,2024-10-04 19:39:58,0,0,0,0,0,0
3,2673446010,201392388,47873,33466,2024-10-04 19:39:59,0,0,0,0,0,0
3,2673446010,201392388,47873,27791,2024-10-04 19:39:59,0,0,0,0,0,0
1,2673446010,201392386,47873,65172,2024-10-04 19:40:00,60,200,260,1,2,3
3,2673446010,201392388,47873,55508,2024-10-04 19:40:00,112,813,925,2,3,5
3,2673446010,201392388,47873,33466,2024-10-04 19:40:00,0,0,0,0,0,0
3,2673446010,201392388,47873,27791,2024-10-04 19:40:00,0,0,0,0,0,0
1,2673446010,201392386,47873,65172,2024-10-04 19:40:01,11021,2394,13415,13,16,29
3,2673446010,201392388,47873,55508,2024-10-04 19:40:01,9107,1853,10960,14,16,30
3,2673446010,201392388,47873,33466,2024-10-04 19:40:01,0,0,0,0,0,0
3,2673446010,201392388,47873,27791,2024-10-04 19:40:01,0,0,0,0,0,0
1,2673446010,201392386,47873,65172,2024-10-04 19:40:02,0,0,0,0,0,0
3,2673446010,201392388,47873,55508,2024-10-04 19:40:02,0,0,0,0,0,0
3,2673446010,201392388,47873,33466,2024-10-04 19:40:02,0,0,0,0,0,0
3,2673446010,201392388,47873,27791,2024-10-04 19:40:02,0,0,0,0,0,0
1,2673446010,201392386,47873,65172,2024-10-04 19:40:03,0,0,0,0,0,0
3,2673446010,201392388,47873,55508,2024-10-04 19:40:03,0,0,0,0,0,0
3,2673446010,201392388,47873,33466,2024-10-04 19:40:03,0,0,0,0,0,0
3,2673446010,201392388,47873,27791,2024-10-04 19:40:03,0,0,0,0,0,0
1,2673446010,201392386,47873,65172,2024-10-04 19:40:04,0,0,0,0,0,0
3,2673446010,201392388,47873,55508,2024-10-04 19:40:04,0,0,0,0,0,0
3,2673446010,201392388,47873,33466,2024-10-04 19:40:04,0,0,0,0,0,0
3,2673446010,201392388,47873,27791,2024-10-04 19:40:04,0,0,0,0,0,0
1,2673446010,201392386,47873,65172,2024-10-04 19:40:05,0,0,0,0,0,0
2,2673446010,201392387,47873,38561,2024-10-04 19:40:05,4794,921,5715,5,4,9
3,2673446010,201392388,47873,55508,2024-10-04 19:40:05,0,0,0,0,0,0
3,2673446010,201392388,47873,33466,2024-10-04 19:40:05,0,0,0,0,0,0
3,2673446010,201392388,47873,27791,2024-10-04 19:40:05,0,0,0,0,0,0
1,2673446010,201392386,47873,65172,2024-10-04 19:40:06,0,0,0,0,0,0
2,2673446010,201392387,47873,38561,2024-10-04 19:40:06,0,0,0,0,0,0
3,2673446010,201392388,47873,55508,2024-10-04 19:40:06,0,0,0,0,0,0
3,2673446010,201392388,47873,33466,2024-10-04 19:40:06,0,0,0,0,0,0
3,2673446010,201392388,47873,27791,2024-10-04 19:40:06,0,0,0,0,0,0
1,2673446010,201392386,47873,65172,2024-10-04 19:40:07,0,0,0,0,0,0
2,2673446010,201392387,47873,38561,2024-10-04 19:40:07,6379,1685,8064,11,14,25
3,2673446010,201392388,47873,55508,2024-10-04 19:40:07,0,0,0,0,0,0
3,2673446010,201392388,47873,33466,2024-10-04 19:40:07,0,0,0,0,0,0
3,2673446010,201392388,47873,27791,2024-10-04 19:40:07,0,0,0,0,0,0
1,2673446010,201392386,47873,65172,2024-10-04 19:40:08,0,0,0,0,0,0
2,2673446010,201392387,47873,38561,2024-10-04 19:40:08,0,0,0,0,0,0
3,2673446010,201392388,47873,55508,2024-10-04 19:40:08,0,0,0,0,0,0
3,2673446010,201392388,47873,33466,2024-10-04 19:40:08,0,0,0,0,0,0
3,2673446010,201392388,47873,27791,2024-10-04 19:40:08,0,0,0,0,0,0
1,2673446010,201392386,47873,65172,2024-10-04 19:40:09,0,0,0,0,0,0
2,2673446010,201392387,47873,38561,2024-10-04 19:40:09,0,0,0,0,0,0
3,2673446010,201392388,47873,55508,2024-10-04 19:40:09,0,0,0,0,0,0
3,2673446010,201392388,47873,33466,2024-10-04 19:40:09,0,0,0,0,0,0
3,2673446010,201392388,47873,27791,2024-10-04 19:40:09,0,0,0,0,0,0
2,2673446010,201392387,47873,38561,2024-10-04 19:40:10,0,0,0,0,0,0
3,2673446010,201392388,47873,55508,2024-10-04 19:40:10,0,0,0,0,0,0
3,2673446010,201392388,47873,33466,2024-10-04 19:40:10,0,0,0,0,0,0
3,2673446010,201392388,47873,27791,2024-10-04 19:40:10,0,0,0,0,0,0
2,2673446010,201392387,47873,38561,2024-10-04 19:40:11,0,0,0,0,0,0
3,2673446010,201392388,47873,55508,2024-10-04 19:40:11,0,0,0,0,0,0
3,2673446010,201392388,47873,33466,2024-10-04 19:40:11,0,0,0,0,0,0
3,2673446010,201392388,47873,27791,2024-10-04 19:40:11,0,0,0,0,0,0
2,2673446010,201392387,47873,38561,2024-10-04 19:40:12,0,0,0,0,0,0
3,2673446010,201392388,47873,55508,2024-10-04 19:40:12,0,0,0,0,0,0
3,2673446010,201392388,47873,33466,2024-10-04 19:40:12,0,0,0,0,0,0
3,2673446010,201392388,47873,27791,2024-10-04 19:40:12,0,0,0,0,0,0
2,2673446010,201392387,47873,38561,2024-10-04 19:40:13,0,0,0,0,0,0
3,2673446010,201392388,47873,55508,2024-10-04 19:40:13,0,0,0,0,0,0
3,2673446010,201392388,47873,33466,2024-10-04 19:40:13,0,0,0,0,0,0
3,2673446010,201392388,47873,27791,2024-10-04 19:40:13,0,0,0,0,0,0
2,2673446010,201392387,47873,38561,2024-10-04 19:40:14,0,0,0,0,0,0
3,2673446010,201392388,47873,55508,2024-10-04 19:40:14,0,0,0,0,0,0
3,2673446010,201392388,47873,33466,2024-10-04 19:40:14,0,0,0,0,0,0
3,2673446010,201392388,47873,27791,2024-10-04 19:40:14,0,0,0,0,0,0
2,2673446010,201392387,47873,38561,2024-10-04 19:40:15,0,0,0,0,0,0
3,2673446010,201392388,47873,55508,2024-10-04 19:40:15,0,0,0,0,0,0
3,2673446010,201392388,47873,33466,2024-10-04 19:40:15,0,0,0,0,0,0
3,2673446010,201392388,47873,27791,2024-10-04 19:40:15,0,0,0,0,0,0
2,2673446010,201392387,47873,38561,2024-10-04 19:40:16,0,0,0,0,0,0
3,2673446010,201392388,47873,55508,2024-10-04 19:40:16,0,0,0,0,0,0
3,2673446010,201392388,47873,33466,2024-10-04 19:40:16,0,0,0,0,0,0
3,2673446010,201392388,47873,27791,2024-10-04 19:40:16,0,0,0,0,0,0
2,2673446010,201392387,47873,38561,2024-10-04 19:40:17,0,0,0,0,0,0
3,2673446010,201392388,47873,55508,2024-10-04 19:40:17,0,0,0,0,0,0
3,2673446010,201392388,47873,33466,2024-10-04 19:40:17,0,0,0,0,0,0
3,2673446010,201392388,47873,27791,2024-10-04 19:40:17,0,0,0,0,0,0
2,2673446010,201392387,47873,38561,2024-10-04 19:40:18,0,0,0,0,0,0
3,2673446010,201392388,47873,55508,2024-10-04 19:40:18,0,0,0,0,0,0
3,2673446010,201392388,47873,33466,2024-10-04 19:40:18,0,0,0,0,0,0
3,2673446010,201392388,47873,27791,2024-10-04 19:40:18,0,0,0,0,0,0
2,2673446010,201392387,47873,38561,2024-10-04 19:40:19,0,0,0,0,0,0
3,2673446010,201392388,47873,55508,2024-10-04 19:40:19,0,0,0,0,0,0
3,2673446010,201392388,47873,33466,2024-10-04 19:40:19,0,0,0,0,0,0
3,2673446010,201392388,47873,27791,2024-10-04 19:40:19,0,0,0,0,0,0
2,2673446010,201392387,47873,38561,2024-10-04 19:40:20,0,0,0,0,0,0
3,2673446010,201392388,47873,55508,2024-10-04 19:40:20,0,0,0,0,0,0
3,2673446010,201392388,47873,33466,2024-10-04 19:40:20,0,0,0,0,0,0
3,2673446010,201392388,47873,27791,2024-10-04 19:40:20,0,0,0,0,0,0
2,2673446010,201392387,47873,38561,2024-10-04 19:40:21,0,0,0,0,0,0
3,2673446010,201392388,47873,55508,2024-10-04 19:40:21,0,0,0,0,0,0
3,2673446010,201392388,47873,33466,2024-10-04 19:40:21,0,0,0,0,0,0
3,2673446010,201392388,47873,27791,2024-10-04 19:40:21,0,0,0,0,0,0
2,2673446010,201392387,47873,38561,2024-10-04 19:40:22,0,0,0,0,0,0
3,2673446010,201392388,47873,55508,2024-10-04 19:40:22,0,0,0,0,0,0
3,2673446010,201392388,47873,33466,2024-10-04 19:40:22,0,0,0,0,0,0
3,2673446010,201392388,47873,27791,2024-10-04 19:40:22,0,0,0,0,0,0
2,2673446010,201392387,47873,38561,2024-10-04 19:40:23,0,0,0,0,0,0
3,2673446010,201392388,47873,55508,2024-10-04 19:40:23,0,0,0,0,0,0
3,2673446010,201392388,47873,33466,2024-10-04 19:40:23,0,0,0,0,0,0
3,2673446010,201392388,47873,27791,2024-10-04 19:40:23,0,0,0,0,0,0
2,2673446010,201392387,47873,38561,2024-10-04 19:40:24,0,0,0,0,0,0
3,2673446010,201392388,47873,55508,2024-10-04 19:40:24,0,0,0,0,0,0
3,2673446010,201392388,47873,33466,2024-10-04 19:40:24,0,0,0,0,0,0
3,2673446010,201392388,47873,27791,2024-10-04 19:40:24,0,0,0,0,0,0
2,2673446010,201392387,47873,38561,2024-10-04 19:40:25,0,0,0,0,0,0
3,2673446010,201392388,47873,55508,2024-10-04 19:40:25,0,0,0,0,0,0
3,2673446010,201392388,47873,33466,2024-10-04 19:40:25,0,0,0,0,0,0
3,2673446010,201392388,47873,27791,2024-10-04 19:40:25,0,0,0,0,0,0
2,2673446010,201392387,47873,38561,2024-10-04 19:40:26,0,0,0,0,0,0
3,2673446010,201392388,47873,55508,2024-10-04 19:40:26,0,0,0,0,0,0
3,2673446010,201392388,47873,33466,2024-10-04 19:40:26,0,0,0,0,0,0
3,2673446010,201392388,47873,27791,2024-10-04 19:40:26,0,0,0,0,0,0
2,2673446010,201392387,47873,38561,2024-10-04 19:40:27,0,0,0,0,0,0
3,2673446010,201392388,47873,55508,2024-10-04 19:40:27,0,0,0,0,0,0
3,2673446010,201392388,47873,33466,2024-10-04 19:40:27,0,0,0,0,0,0
3,2673446010,201392388,47873,27791,2024-10-04 19:40:27,0,0,0,0,0,0
2,2673446010,201392387,47873,38561,2024-10-04 19:40:28,0,0,0,0,0,0
3,2673446010,201392388,47873,55508,2024-10-04 19:40:28,0,0,0,0,0,0
3,2673446010,201392388,47873,33466,2024-10-04 19:40:28,0,0,0,0,0,0
3,2673446010,201392388,47873,27791,2024-10-04 19:40:28,0,0,0,0,0,0
2,2673446010,201392387,47873,38561,2024-10-04 19:40:29,0,0,0,0,0,0
3,2673446010,201392388,47873,55508,2024-10-04 19:40:29,0,0,0,0,0,0
3,2673446010,201392388,47873,33466,2024-10-04 19:40:29,0,0,0,0,0,0
3,2673446010,201392388,47873,27791,2024-10-04 19:40:29,0,0,0,0,0,0
3,2673446010,201392388,47873,31375,2024-10-04 19:40:30,60,104,164,1,1,2
2,2673446010,201392387,47873,38561,2024-10-04 19:40:30,0,0,0,0,0,0
3,2673446010,201392388,47873,55508,2024-10-04 19:40:30,0,0,0,0,0,0
3,2673446010,201392388,47873,33466,2024-10-04 19:40:30,0,0,0,0,0,0
3,2673446010,201392388,47873,27791,2024-10-04 19:40:30,0,0,0,0,0,0
3,2673446010,201392388,47873,31375,2024-10-04 19:40:31,9216,2478,11694,16,17,33
1,2673446010,201392386,47873,9881,2024-10-04 19:40:31,0,104,104,0,1,1
3,2673446010,201392388,47873,55508,2024-10-04 19:40:31,0,0,0,0,0,0
3,2673446010,201392388,47873,33466,2024-10-04 19:40:31,0,0,0,0,0,0
3,2673446010,201392388,47873,27791,2024-10-04 19:40:31,0,0,0,0,0,0
3,2673446010,201392388,47873,31375,2024-10-04 19:40:32,0,0,0,0,0,0
1,2673446010,201392386,47873,9881,2024-10-04 19:40:32,11128,2010,13138,14,12,26
3,2673446010,201392388,47873,55508,2024-10-04 19:40:32,0,0,0,0,0,0
3,2673446010,201392388,47873,33466,2024-10-04 19:40:32,0,0,0,0,0,0
3,2673446010,201392388,47873,27791,2024-10-04 19:40:32,0,0,0,0,0,0
3,2673446010,201392388,47873,31375,2024-10-04 19:40:33,0,0,0,0,0,0
1,2673446010,201392386,47873,9881,2024-10-04 19:40:33,128,480,608,2,5,7
3,2673446010,201392388,47873,33466,2024-10-04 19:40:33,0,0,0,0,0,0
3,2673446010,201392388,47873,27791,2024-10-04 19:40:33,0,0,0,0,0,0
3,2673446010,201392388,47873,31375,2024-10-04 19:40:34,0,0,0,0,0,0
1,2673446010,201392386,47873,9881,2024-10-04 19:40:34,0,0,0,0,0,0
3,2673446010,201392388,47873,33466,2024-10-04 19:40:34,0,0,0,0,0,0
3,2673446010,201392388,47873,27791,2024-10-04 19:40:34,0,0,0,0,0,0
3,2673446010,201392388,47873,31375,2024-10-04 19:40:35,0,0,0,0,0,0
1,2673446010,201392386,47873,9881,2024-10-04 19:40:35,0,0,0,0,0,0
3,2673446010,201392388,47873,33466,2024-10-04 19:40:35,0,0,0,0,0,0
3,2673446010,201392388,47873,27791,2024-10-04 19:40:35,0,0,0,0,0,0
3,2673446010,201392388,47873,31375,2024-10-04 19:40:36,0,0,0,0,0,0
1,2673446010,201392386,47873,9881,2024-10-04 19:40:36,0,0,0,0,0,0
3,2673446010,201392388,47873,33466,2024-10-04 19:40:36,0,0,0,0,0,0
3,2673446010,201392388,47873,27791,2024-10-04 19:40:36,0,0,0,0,0,0
3,2673446010,201392388,47873,31375,2024-10-04 19:40:37,0,0,0,0,0,0
1,2673446010,201392386,47873,9881,2024-10-04 19:40:37,0,0,0,0,0,0
2,2673446010,201392387,47873,29899,2024-10-04 19:40:37,7260,2546,9806,17,18,35
3,2673446010,201392388,47873,33466,2024-10-04 19:40:37,0,0,0,0,0,0
3,2673446010,201392388,47873,27791,2024-10-04 19:40:37,0,0,0,0,0,0
3,2673446010,201392388,47873,31375,2024-10-04 19:40:38,0,0,0,0,0,0
1,2673446010,201392386,47873,9881,2024-10-04 19:40:38,0,0,0,0,0,0
2,2673446010,201392387,47873,29899,2024-10-04 19:40:38,0,0,0,0,0,0
3,2673446010,201392388,47873,33466,2024-10-04 19:40:38,0,0,0,0,0,0
3,2673446010,201392388,47873,27791,2024-10-04 19:40:38,0,0,0,0,0,0
3,2673446010,201392388,47873,31375,2024-10-04 19:40:39,0,0,0,0,0,0
1,2673446010,201392386,47873,9881,2024-10-04 19:40:39,0,0,0,0,0,0
2,2673446010,201392387,47873,29899,2024-10-04 19:40:39,0,0,0,0,0,0
3,2673446010,201392388,47873,33466,2024-10-04 19:40:39,0,0,0,0,0,0
3,2673446010,201392388,47873,27791,2024-10-04 19:40:39,0,0,0,0,0,0
3,2673446010,201392388,47873,31375,2024-10-04 19:40:40,0,0,0,0,0,0
1,2673446010,201392386,47873,9881,2024-10-04 19:40:40,0,0,0,0,0,0
2,2673446010,201392387,47873,29899,2024-10-04 19:40:40,0,0,0,0,0,0
3,2673446010,201392388,47873,33466,2024-10-04 19:40:40,0,0,0,0,0,0
3,2673446010,201392388,47873,27791,2024-10-04 19:40:40,0,0,0,0,0,0
3,2673446010,201392388,47873,31375,2024-10-04 19:40:41,0,0,0,0,0,0
2,2673446010,201392387,47873,29899,2024-10-04 19:40:41,0,0,0,0,0,0
3,2673446010,201392388,47873,33466,2024-10-04 19:40:41,0,0,0,0,0,0
3,2673446010,201392388,47873,27791,2024-10-04 19:40:41,0,0,0,0,0,0
3,2673446010,201392388,47873,31375,2024-10-04 19:40:42,0,0,0,0,0,0
2,2673446010,201392387,47873,29899,2024-10-04 19:40:42,0,0,0,0,0,0
3,2673446010,201392388,47873,33466,2024-10-04 19:40:42,0,0,0,0,0,0
3,2673446010,201392388,47873,27791,2024-10-04 19:40:42,0,0,0,0,0,0
3,2673446010,201392388,47873,31375,2024-10-04 19:40:43,0,0,0,0,0,0
2,2673446010,201392387,47873,29899,2024-10-04 19:40:43,0,0,0,0,0,0
3,2673446010,201392388,47873,33466,2024-10-04 19:40:43,0,0,0,0,0,0
3,2673446010,201392388,47873,27791,2024-10-04 19:40:43,0,0,0,0,0,0
3,2673446010,201392388,47873,31375,2024-10-04 19:40:44,0,0,0,0,0,0
2,2673446010,201392387,47873,29899,2024-10-04 19:40:44,0,0,0,0,0,0
3,2673446010,201392388,47873,33466,2024-10-04 19:40:44,0,0,0,0,0,0
3,2673446010,201392388,47873,27791,2024-10-04 19:40:44,0,0,0,0,0,0
3,2673446010,201392388,47873,31375,2024-10-04 19:40:45,0,0,0,0,0,0
2,2673446010,201392387,47873,29899,2024-10-04 19:40:45,0,0,0,0,0,0
3,2673446010,201392388,47873,33466,2024-10-04 19:40:45,0,0,0,0,0,0
3,2673446010,201392388,47873,27791,2024-10-04 19:40:45,0,0,0,0,0,0
3,2673446010,201392388,47873,31375,2024-10-04 19:40:46,0,0,0,0,0,0
2,2673446010,201392387,47873,29899,2024-10-04 19:40:46,0,0,0,0,0,0
3,2673446010,201392388,47873,33466,2024-10-04 19:40:46,0,0,0,0,0,0
3,2673446010,201392388,47873,27791,2024-10-04 19:40:46,0,0,0,0,0,0
3,2673446010,201392388,47873,31375,2024-10-04 19:40:47,0,0,0,0,0,0
2,2673446010,201392387,47873,29899,2024-10-04 19:40:47,0,0,0,0,0,0
3,2673446010,201392388,47873,33466,2024-10-04 19:40:47,0,0,0,0,0,0
3,2673446010,201392388,47873,27791,2024-10-04 19:40:47,0,0,0,0,0,0
3,2673446010,201392388,47873,31375,2024-10-04 19:40:48,0,0,0,0,0,0
2,2673446010,201392387,47873,29899,2024-10-04 19:40:48,0,0,0,0,0,0
3,2673446010,201392388,47873,33466,2024-10-04 19:40:48,0,0,0,0,0,0
3,2673446010,201392388,47873,27791,2024-10-04 19:40:48,0,0,0,0,0,0
3,2673446010,201392388,47873,31375,2024-10-04 19:40:49,0,0,0,0,0,0
2,2673446010,201392387,47873,29899,2024-10-04 19:40:49,0,0,0,0,0,0
3,2673446010,201392388,47873,33466,2024-10-04 19:40:49,0,0,0,0,0,0
3,2673446010,201392388,47873,27791,2024-10-04 19:40:49,0,0,0,0,0,0
3,2673446010,201392388,47873,31375,2024-10-04 19:40:50,0,0,0,0,0,0
2,2673446010,201392387,47873,29899,2024-10-04 19:40:50,0,0,0,0,0,0
3,2673446010,201392388,47873,33466,2024-10-04 19:40:50,0,0,0,0,0,0
3,2673446010,201392388,47873,27791,2024-10-04 19:40:50,0,0,0,0,0,0
3,2673446010,201392388,47873,31375,2024-10-04 19:40:51,0,0,0,0,0,0
2,2673446010,201392387,47873,29899,2024-10-04 19:40:51,0,0,0,0,0,0
3,2673446010,201392388,47873,33466,2024-10-04 19:40:51,0,0,0,0,0,0
3,2673446010,201392388,47873,27791,2024-10-04 19:40:51,0,0,0,0,0,0
3,2673446010,201392388,47873,31375,2024-10-04 19:40:52,0,0,0,0,0,0
2,2673446010,201392387,47873,29899,2024-10-04 19:40:52,0,0,0,0,0,0
3,2673446010,201392388,47873,33466,2024-10-04 19:40:52,0,0,0,0,0,0
3,2673446010,201392388,47873,27791,2024-10-04 19:40:52,0,0,0,0,0,0
3,2673446010,201392388,47873,31375,2024-10-04 19:40:53,0,0,0,0,0,0
2,2673446010,201392387,47873,29899,2024-10-04 19:40:53,0,0,0,0,0,0
3,2673446010,201392388,47873,33466,2024-10-04 19:40:53,0,0,0,0,0,0
3,2673446010,201392388,47873,27791,2024-10-04 19:40:53,0,0,0,0,0,0
3,2673446010,201392388,47873,31375,2024-10-04 19:40:54,0,0,0,0,0,0
2,2673446010,201392387,47873,29899,2024-10-04 19:40:54,0,0,0,0,0,0
3,2673446010,201392388,47873,33466,2024-10-04 19:40:54,0,0,0,0,0,0
3,2673446010,201392388,47873,27791,2024-10-04 19:40:54,0,0,0,0,0,0
3,2673446010,201392388,47873,31375,2024-10-04 19:40:55,0,0,0,0,0,0
2,2673446010,201392387,47873,29899,2024-10-04 19:40:55,0,0,0,0,0,0
3,2673446010,201392388,47873,33466,2024-10-04 19:40:55,0,0,0,0,0,0
3,2673446010,201392388,47873,27791,2024-10-04 19:40:55,0,0,0,0,0,0
3,2673446010,201392388,47873,31375,2024-10-04 19:40:56,0,0,0,0,0,0
2,2673446010,201392387,47873,29899,2024-10-04 19:40:56,0,0,0,0,0,0
3,2673446010,201392388,47873,33466,2024-10-04 19:40:56,0,0,0,0,0,0
3,2673446010,201392388,47873,27791,2024-10-04 19:40:56,0,0,0,0,0,0
3,2673446010,201392388,47873,31375,2024-10-04 19:40:57,0,0,0,0,0,0
2,2673446010,201392387,47873,29899,2024-10-04 19:40:57,0,0,0,0,0,0
3,2673446010,201392388,47873,33466,2024-10-04 19:40:57,0,0,0,0,0,0
3,2673446010,201392388,47873,27791,2024-10-04 19:40:57,0,0,0,0,0,0
3,2673446010,201392388,47873,31375,2024-10-04 19:40:58,0,0,0,0,0,0
2,2673446010,201392387,47873,29899,2024-10-04 19:40:58,0,0,0,0,0,0
3,2673446010,201392388,47873,33466,2024-10-04 19:40:58,0,0,0,0,0,0
3,2673446010,201392388,47873,27791,2024-10-04 19:40:58,0,0,0,0,0,0
3,2673446010,201392388,47873,31375,2024-10-04 19:40:59,0,0,0,0,0,0
2,2673446010,201392387,47873,29899,2024-10-04 19:40:59,0,0,0,0,0,0
3,2673446010,201392388,47873,33466,2024-10-04 19:40:59,0,0,0,0,0,0
3,2673446010,201392388,47873,27791,2024-10-04 19:40:59,0,0,0,0,0,0
3,2673446010,201392388,47873,31375,2024-10-04 19:41:00,0,0,0,0,0,0
2,2673446010,201392387,47873,29899,2024-10-04 19:41:00,0,0,0,0,0,0
3,2673446010,201392388,47873,33466,2024-10-04 19:41:00,0,0,0,0,0,0
3,2673446010,201392388,47873,27791,2024-10-04 19:41:00,0,0,0,0,0,0
3,2673446010,201392388,47873,28800,2024-10-04 19:41:01,4793,921,5714,5,4,9
3,2673446010,201392388,47873,31375,2024-10-04 19:41:01,0,0,0,0,0,0
2,2673446010,201392387,47873,29899,2024-10-04 19:41:01,0,0,0,0,0,0
3,2673446010,201392388,47873,33466,2024-10-04 19:41:01,0,0,0,0,0,0
3,2673446010,201392388,47873,27791,2024-10-04 19:41:01,0,0,0,0,0,0
3,2673446010,201392388,47873,28800,2024-10-04 19:41:02,6449,1757,8206,11,15,26
3,2673446010,201392388,47873,31375,2024-10-04 19:41:02,0,0,0,0,0,0
2,2673446010,201392387,47873,29899,2024-10-04 19:41:02,0,0,0,0,0,0
3,2673446010,201392388,47873,33466,2024-10-04 19:41:02,0,0,0,0,0,0
3,2673446010,201392388,47873,27791,2024-10-04 19:41:02,0,0,0,0,0,0
3,2673446010,201392388,47873,28800,2024-10-04 19:41:03,0,0,0,0,0,0
3,2673446010,201392388,47873,31375,2024-10-04 19:41:03,0,0,0,0,0,0
1,2673446010,201392386,47873,34990,2024-10-04 19:41:03,3375,813,4188,4,3,7
3,2673446010,201392388,47873,33466,2024-10-04 19:41:03,0,0,0,0,0,0
3,2673446010,201392388,47873,27791,2024-10-04 19:41:03,0,0,0,0,0,0
3,2673446010,201392388,47873,28800,2024-10-04 19:41:04,0,0,0,0,0,0
1,2673446010,201392386,47873,34990,2024-10-04 19:41:04,7801,1781,9582,11,15,26
3,2673446010,201392388,47873,33466,2024-10-04 19:41:04,0,0,0,0,0,0
3,2673446010,201392388,47873,27791,2024-10-04 19:41:04,0,0,0,0,0,0
3,2673446010,201392388,47873,28800,2024-10-04 19:41:05,0,0,0,0,0,0
2,2673446010,201392387,47873,11444,2024-10-04 19:41:05,0,104,104,0,1,1
1,2673446010,201392386,47873,34990,2024-10-04 19:41:05,0,0,0,0,0,0
3,2673446010,201392388,47873,33466,2024-10-04 19:41:05,0,0,0,0,0,0
3,2673446010,201392388,47873,27791,2024-10-04 19:41:05,0,0,0,0,0,0
3,2673446010,201392388,47873,28800,2024-10-04 19:41:06,0,0,0,0,0,0
2,2673446010,201392387,47873,11444,2024-10-04 19:41:06,0,0,0,0,0,0
1,2673446010,201392386,47873,34990,2024-10-04 19:41:06,0,0,0,0,0,0
3,2673446010,201392388,47873,33466,2024-10-04 19:41:06,0,0,0,0,0,0
3,2673446010,201392388,47873,27791,2024-10-04 19:41:06,0,0,0,0,0,0
3,2673446010,201392388,47873,28800,2024-10-04 19:41:07,0,0,0,0,0,0
2,2673446010,201392387,47873,11444,2024-10-04 19:41:07,9276,2478,11754,17,17,34
1,2673446010,201392386,47873,34990,2024-10-04 19:41:07,0,0,0,0,0,0
3,2673446010,201392388,47873,33466,2024-10-04 19:41:07,0,0,0,0,0,0
3,2673446010,201392388,47873,27791,2024-10-04 19:41:07,0,0,0,0,0,0
3,2673446010,201392388,47873,28800,2024-10-04 19:41:08,0,0,0,0,0,0
2,2673446010,201392387,47873,11444,2024-10-04 19:41:08,0,0,0,0,0,0
1,2673446010,201392386,47873,34990,2024-10-04 19:41:08,0,0,0,0,0,0
3,2673446010,201392388,47873,33466,2024-10-04 19:41:08,0,0,0,0,0,0
3,2673446010,201392388,47873,27791,2024-10-04 19:41:08,0,0,0,0,0,0
3,2673446010,201392388,47873,28800,2024-10-04 19:41:09,0,0,0,0,0,0
2,2673446010,201392387,47873,11444,2024-10-04 19:41:09,0,0,0,0,0,0
1,2673446010,201392386,47873,34990,2024-10-04 19:41:09,0,0,0,0,0,0
3,2673446010,201392388,47873,33466,2024-10-04 19:41:09,0,0,0,0,0,0
3,2673446010,201392388,47873,27791,2024-10-04 19:41:09,0,0,0,0,0,0
3,2673446010,201392388,47873,28800,2024-10-04 19:41:10,0,0,0,0,0,0
2,2673446010,201392387,47873,11444,2024-10-04 19:41:10,0,0,0,0,0,0
1,2673446010,201392386,47873,34990,2024-10-04 19:41:10,0,0,0,0,0,0
3,2673446010,201392388,47873,33466,2024-10-04 19:41:10,0,0,0,0,0,0
3,2673446010,201392388,47873,27791,2024-10-04 19:41:10,0,0,0,0,0,0
3,2673446010,201392388,47873,28800,2024-10-04 19:41:11,0,0,0,0,0,0
2,2673446010,201392387,47873,11444,2024-10-04 19:41:11,0,0,0,0,0,0
3,2673446010,201392388,47873,33466,2024-10-04 19:41:11,0,0,0,0,0,0
3,2673446010,201392388,47873,27791,2024-10-04 19:41:11,0,0,0,0,0,0
3,2673446010,201392388,47873,28800,2024-10-04 19:41:12,0,0,0,0,0,0
2,2673446010,201392387,47873,11444,2024-10-04 19:41:12,0,0,0,0,0,0
3,2673446010,201392388,47873,33466,2024-10-04 19:41:12,0,0,0,0,0,0
3,2673446010,201392388,47873,27791,2024-10-04 19:41:12,0,0,0,0,0,0
3,2673446010,201392388,47873,28800,2024-10-04 19:41:13,0,0,0,0,0,0
3,2673446010,201392388,47873,33466,2024-10-04 19:41:13,0,0,0,0,0,0
3,2673446010,201392388,47873,27791,2024-10-04 19:41:13,0,0,0,0,0,0
3,2673446010,201392388,47873,28800,2024-10-04 19:41:14,0,0,0,0,0,0
3,2673446010,201392388,47873,33466,2024-10-04 19:41:14,0,0,0,0,0,0
3,2673446010,201392388,47873,27791,2024-10-04 19:41:14,0,0,0,0,0,0
3,2673446010,201392388,47873,28800,2024-10-04 19:41:15,0,0,0,0,0,0
3,2673446010,201392388,47873,33466,2024-10-04 19:41:15,0,0,0,0,0,0
3,2673446010,201392388,47873,27791,2024-10-04 19:41:15,0,0,0,0,0,0
3,2673446010,201392388,47873,28800,2024-10-04 19:41:16,0,0,0,0,0,0
3,2673446010,201392388,47873,33466,2024-10-04 19:41:16,0,0,0,0,0,0
3,2673446010,201392388,47873,27791,2024-10-04 19:41:16,0,0,0,0,0,0
3,2673446010,201392388,47873,28800,2024-10-04 19:41:17,0,0,0,0,0,0
3,2673446010,201392388,47873,33466,2024-10-04 19:41:17,0,0,0,0,0,0
3,2673446010,201392388,47873,27791,2024-10-04 19:41:17,0,0,0,0,0,0
3,2673446010,201392388,47873,28800,2024-10-04 19:41:18,0,0,0,0,0,0
3,2673446010,201392388,47873,33466,2024-10-04 19:41:18,0,0,0,0,0,0
3,2673446010,201392388,47873,27791,2024-10-04 19:41:18,0,0,0,0,0,0
3,2673446010,201392388,47873,28800,2024-10-04 19:41:19,0,0,0,0,0,0
3,2673446010,201392388,47873,33466,2024-10-04 19:41:19,0,0,0,0,0,0
3,2673446010,201392388,47873,27791,2024-10-04 19:41:19,0,0,0,0,0,0
3,2673446010,201392388,47873,28800,2024-10-04 19:41:20,0,0,0,0,0,0
3,2673446010,201392388,47873,33466,2024-10-04 19:41:20,0,0,0,0,0,0
3,2673446010,201392388,47873,27791,2024-10-04 19:41:20,0,0,0,0,0,0
3,2673446010,201392388,47873,28800,2024-10-04 19:41:21,0,0,0,0,0,0
3,2673446010,201392388,47873,33466,2024-10-04 19:41:21,0,0,0,0,0,0
3,2673446010,201392388,47873,27791,2024-10-04 19:41:21,0,0,0,0,0,0
3,2673446010,201392388,47873,28800,2024-10-04 19:41:22,0,0,0,0,0,0
3,2673446010,201392388,47873,33466,2024-10-04 19:41:22,0,0,0,0,0,0
3,2673446010,201392388,47873,27791,2024-10-04 19:41:22,0,0,0,0,0,0
3,2673446010,201392388,47873,28800,2024-10-04 19:41:23,0,0,0,0,0,0
3,2673446010,201392388,47873,33466,2024-10-04 19:41:23,0,0,0,0,0,0
3,2673446010,201392388,47873,27791,2024-10-04 19:41:23,0,0,0,0,0,0
3,2673446010,201392388,47873,28800,2024-10-04 19:41:24,0,0,0,0,0,0
3,2673446010,201392388,47873,33466,2024-10-04 19:41:24,0,0,0,0,0,0
3,2673446010,201392388,47873,27791,2024-10-04 19:41:24,0,0,0,0,0,0
3,2673446010,201392388,47873,28800,2024-10-04 19:41:25,0,0,0,0,0,0
3,2673446010,201392388,47873,33466,2024-10-04 19:41:25,0,0,0,0,0,0
3,2673446010,201392388,47873,27791,2024-10-04 19:41:25,0,0,0,0,0,0
3,2673446010,201392388,47873,28800,2024-10-04 19:41:26,0,0,0,0,0,0
3,2673446010,201392388,47873,33466,2024-10-04 19:41:26,0,0,0,0,0,0
3,2673446010,201392388,47873,27791,2024-10-04 19:41:26,0,0,0,0,0,0
3,2673446010,201392388,47873,28800,2024-10-04 19:41:27,0,0,0,0,0,0
3,2673446010,201392388,47873,33466,2024-10-04 19:41:27,0,0,0,0,0,0
3,2673446010,201392388,47873,27791,2024-10-04 19:41:27,0,0,0,0,0,0
3,2673446010,201392388,47873,28800,2024-10-04 19:41:28,0,0,0,0,0,0
3,2673446010,201392388,47873,33466,2024-10-04 19:41:28,0,0,0,0,0,0
3,2673446010,201392388,47873,27791,2024-10-04 19:41:28,0,0,0,0,0,0
3,2673446010,201392388,47873,28800,2024-10-04 19:41:29,0,0,0,0,0,0
3,2673446010,201392388,47873,33466,2024-10-04 19:41:29,0,0,0,0,0,0
3,2673446010,201392388,47873,27791,2024-10-04 19:41:29,0,0,0,0,0,0
3,2673446010,201392388,47873,28800,2024-10-04 19:41:30,0,0,0,0,0,0
3,2673446010,201392388,47873,33466,2024-10-04 19:41:30,0,0,0,0,0,0
3,2673446010,201392388,47873,27791,2024-10-04 19:41:30,0,0,0,0,0,0
3,2673446010,201392388,47873,28800,2024-10-04 19:41:31,0,0,0,0,0,0
3,2673446010,201392388,47873,33466,2024-10-04 19:41:31,0,0,0,0,0,0
3,2673446010,201392388,47873,27791,2024-10-04 19:41:31,0,0,0,0,0,0
3,2673446010,201392388,47873,28800,2024-10-04 19:41:32,0,0,0,0,0,0
3,2673446010,201392388,47873,33466,2024-10-04 19:41:32,0,0,0,0,0,0
3,2673446010,201392388,47873,27791,2024-10-04 19:41:32,0,0,0,0,0,0
3,2673446010,201392388,47873,28800,2024-10-04 19:41:33,0,0,0,0,0,0
3,2673446010,201392388,47873,33466,2024-10-04 19:41:33,0,0,0,0,0,0
3,2673446010,201392388,47873,27791,2024-10-04 19:41:33,0,0,0,0,0,0
3,2673446010,201392388,47873,4286,2024-10-04 19:41:33,3373,813,4186,4,3,7
3,2673446010,201392388,47873,28800,2024-10-04 19:41:34,0,0,0,0,0,0
1,2673446010,201392386,47873,2225,2024-10-04 19:41:34,11117,2114,13231,14,13,27
3,2673446010,201392388,47873,33466,2024-10-04 19:41:34,0,0,0,0,0,0
3,2673446010,201392388,47873,27791,2024-10-04 19:41:34,0,0,0,0,0,0
3,2673446010,201392388,47873,4286,2024-10-04 19:41:34,7726,1781,9507,10,15,25
1,2673446010,201392386,47873,2225,2024-10-04 19:41:35,128,480,608,2,5,7
3,2673446010,201392388,47873,33466,2024-10-04 19:41:35,0,0,0,0,0,0
3,2673446010,201392388,47873,27791,2024-10-04 19:41:35,0,0,0,0,0,0
3,2673446010,201392388,47873,4286,2024-10-04 19:41:35,0,0,0,0,0,0
2,2673446010,201392387,47873,64150,2024-10-04 19:41:36,3206,1886,5092,8,11,19
1,2673446010,201392386,47873,2225,2024-10-04 19:41:36,0,0,0,0,0,0
3,2673446010,201392388,47873,33466,2024-10-04 19:41:36,0,0,0,0,0,0
3,2673446010,201392388,47873,27791,2024-10-04 19:41:36,0,0,0,0,0,0
3,2673446010,201392388,47873,4286,2024-10-04 19:41:36,0,0,0,0,0,0
2,2673446010,201392387,47873,64150,2024-10-04 19:41:37,5915,696,6611,7,7,14
1,2673446010,201392386,47873,2225,2024-10-04 19:41:37,0,0,0,0,0,0
3,2673446010,201392388,47873,33466,2024-10-04 19:41:37,0,0,0,0,0,0
3,2673446010,201392388,47873,27791,2024-10-04 19:41:37,0,0,0,0,0,0
3,2673446010,201392388,47873,4286,2024-10-04 19:41:37,0,0,0,0,0,0
2,2673446010,201392387,47873,64150,2024-10-04 19:41:38,0,0,0,0,0,0
1,2673446010,201392386,47873,2225,2024-10-04 19:41:38,0,0,0,0,0,0
3,2673446010,201392388,47873,33466,2024-10-04 19:41:38,0,0,0,0,0,0
3,2673446010,201392388,47873,27791,2024-10-04 19:41:38,0,0,0,0,0,0
3,2673446010,201392388,47873,4286,2024-10-04 19:41:38,0,0,0,0,0,0
2,2673446010,201392387,47873,64150,2024-10-04 19:41:39,0,0,0,0,0,0
1,2673446010,201392386,47873,2225,2024-10-04 19:41:39,0,0,0,0,0,0
3,2673446010,201392388,47873,33466,2024-10-04 19:41:39,0,0,0,0,0,0
3,2673446010,201392388,47873,27791,2024-10-04 19:41:39,0,0,0,0,0,0
3,2673446010,201392388,47873,4286,2024-10-04 19:41:39,0,0,0,0,0,0
2,2673446010,201392387,47873,64150,2024-10-04 19:41:40,0,0,0,0,0,0
1,2673446010,201392386,47873,2225,2024-10-04 19:41:40,0,0,0,0,0,0
3,2673446010,201392388,47873,33466,2024-10-04 19:41:40,0,0,0,0,0,0
3,2673446010,201392388,47873,27791,2024-10-04 19:41:40,0,0,0,0,0,0
3,2673446010,201392388,47873,4286,2024-10-04 19:41:40,0,0,0,0,0,0
2,2673446010,201392387,47873,64150,2024-10-04 19:41:41,0,0,0,0,0,0
1,2673446010,201392386,47873,2225,2024-10-04 19:41:41,0,0,0,0,0,0
3,2673446010,201392388,47873,33466,2024-10-04 19:41:41,0,0,0,0,0,0
3,2673446010,201392388,47873,27791,2024-10-04 19:41:41,0,0,0,0,0,0
3,2673446010,201392388,47873,4286,2024-10-04 19:41:41,0,0,0,0,0,0
2,2673446010,201392387,47873,64150,2024-10-04 19:41:42,0,0,0,0,0,0
1,2673446010,201392386,47873,2225,2024-10-04 19:41:42,0,0,0,0,0,0
3,2673446010,201392388,47873,33466,2024-10-04 19:41:42,0,0,0,0,0,0
3,2673446010,201392388,47873,27791,2024-10-04 19:41:42,0,0,0,0,0,0
3,2673446010,201392388,47873,4286,2024-10-04 19:41:42,0,0,0,0,0,0
3,2673446010,201392388,47873,33466,2024-10-04 19:41:43,0,0,0,0,0,0
3,2673446010,201392388,47873,27791,2024-10-04 19:41:43,0,0,0,0,0,0
3,2673446010,201392388,47873,4286,2024-10-04 19:41:43,0,0,0,0,0,0
3,2673446010,201392388,47873,33466,2024-10-04 19:41:44,0,0,0,0,0,0
3,2673446010,201392388,47873,27791,2024-10-04 19:41:44,0,0,0,0,0,0
3,2673446010,201392388,47873,4286,2024-10-04 19:41:44,0,0,0,0,0,0
3,2673446010,201392388,47873,33466,2024-10-04 19:41:45,0,0,0,0,0,0
3,2673446010,201392388,47873,27791,2024-10-04 19:41:45,0,0,0,0,0,0
3,2673446010,201392388,47873,33466,2024-10-04 19:41:46,0,0,0,0,0,0
3,2673446010,201392388,47873,27791,2024-10-04 19:41:46,0,0,0,0,0,0
3,2673446010,201392388,47873,33466,2024-10-04 19:41:47,0,0,0,0,0,0
3,2673446010,201392388,47873,27791,2024-10-04 19:41:47,0,0,0,0,0,0
3,2673446010,201392388,47873,33466,2024-10-04 19:41:48,0,0,0,0,0,0
3,2673446010,201392388,47873,27791,2024-10-04 19:41:48,0,0,0,0,0,0
3,2673446010,201392388,47873,33466,2024-10-04 19:41:49,0,0,0,0,0,0
3,2673446010,201392388,47873,27791,2024-10-04 19:41:49,0,0,0,0,0,0
3,2673446010,201392388,47873,33466,2024-10-04 19:41:50,0,0,0,0,0,0
3,2673446010,201392388,47873,27791,2024-10-04 19:41:50,0,0,0,0,0,0
3,2673446010,201392388,47873,33466,2024-10-04 19:41:51,0,0,0,0,0,0
3,2673446010,201392388,47873,27791,2024-10-04 19:41:51,0,0,0,0,0,0
3,2673446010,201392388,47873,33466,2024-10-04 19:41:52,0,0,0,0,0,0
3,2673446010,201392388,47873,27791,2024-10-04 19:41:52,0,0,0,0,0,0
3,2673446010,201392388,47873,33466,2024-10-04 19:41:53,0,0,0,0,0,0
3,2673446010,201392388,47873,27791,2024-10-04 19:41:53,0,0,0,0,0,0
3,2673446010,201392388,47873,33466,2024-10-04 19:41:54,0,0,0,0,0,0
3,2673446010,201392388,47873,27791,2024-10-04 19:41:54,0,0,0,0,0,0
3,2673446010,201392388,47873,33466,2024-10-04 19:41:55,0,0,0,0,0,0
3,2673446010,201392388,47873,27791,2024-10-04 19:41:55,0,0,0,0,0,0
3,2673446010,201392388,47873,33466,2024-10-04 19:41:56,0,0,0,0,0,0
3,2673446010,201392388,47873,27791,2024-10-04 19:41:56,0,0,0,0,0,0
3,2673446010,201392388,47873,33466,2024-10-04 19:41:57,0,0,0,0,0,0
3,2673446010,201392388,47873,27791,2024-10-04 19:41:57,0,0,0,0,0,0
3,2673446010,201392388,47873,33466,2024-10-04 19:41:58,0,0,0,0,0,0
3,2673446010,201392388,47873,27791,2024-10-04 19:41:58,0,0,0,0,0,0
3,2673446010,201392388,47873,33466,2024-10-04 19:41:59,0,0,0,0,0,0
3,2673446010,201392388,47873,27791,2024-10-04 19:41:59,0,0,0,0,0,0
3,2673446010,201392388,47873,33466,2024-10-04 19:42:00,0,0,0,0,0,0
3,2673446010,201392388,47873,27791,2024-10-04 19:42:00,0,0,0,0,0,0
3,2673446010,201392388,47873,33466,2024-10-04 19:42:01,0,0,0,0,0,0
3,2673446010,201392388,47873,27791,2024-10-04 19:42:01,0,0,0,0,0,0
3,2673446010,201392388,47873,33466,2024-10-04 19:42:02,0,0,0,0,0,0
3,2673446010,201392388,47873,27791,2024-10-04 19:42:02,0,0,0,0,0,0
3,2673446010,201392388,47873,33466,2024-10-04 19:42:03,0,0,0,0,0,0
3,2673446010,201392388,47873,27791,2024-10-04 19:42:03,0,0,0,0,0,0
3,2673446010,201392388,47873,33466,2024-10-04 19:42:04,0,0,0,0,0,0
3,2673446010,201392388,47873,27791,2024-10-04 19:42:04,0,0,0,0,0,0
3,2673446010,201392388,47873,10967,2024-10-04 19:42:04,7101,2462,9563,14,17,31
1,2673446010,201392386,47873,22199,2024-10-04 19:42:05,4794,921,5715,5,4,9
3,2673446010,201392388,47873,33466,2024-10-04 19:42:05,0,0,0,0,0,0
3,2673446010,201392388,47873,27791,2024-10-04 19:42:05,0,0,0,0,0,0
3,2673446010,201392388,47873,10967,2024-10-04 19:42:05,0,0,0,0,0,0
2,2673446010,201392387,47873,49795,2024-10-04 19:42:06,0,104,104,0,1,1
1,2673446010,201392386,47873,22199,2024-10-04 19:42:06,4257,1541,5798,8,13,21
3,2673446010,201392388,47873,33466,2024-10-04 19:42:06,0,0,0,0,0,0
3,2673446010,201392388,47873,27791,2024-10-04 19:42:06,0,0,0,0,0,0
3,2673446010,201392388,47873,10967,2024-10-04 19:42:06,0,0,0,0,0,0
2,2673446010,201392387,47873,49795,2024-10-04 19:42:07,7227,2442,9669,16,17,33
1,2673446010,201392386,47873,22199,2024-10-04 19:42:07,0,0,0,0,0,0
3,2673446010,201392388,47873,33466,2024-10-04 19:42:07,0,0,0,0,0,0
3,2673446010,201392388,47873,27791,2024-10-04 19:42:07,0,0,0,0,0,0
3,2673446010,201392388,47873,10967,2024-10-04 19:42:07,0,0,0,0,0,0
2,2673446010,201392387,47873,49795,2024-10-04 19:42:08,0,0,0,0,0,0
1,2673446010,201392386,47873,22199,2024-10-04 19:42:08,0,0,0,0,0,0
3,2673446010,201392388,47873,33466,2024-10-04 19:42:08,0,0,0,0,0,0
3,2673446010,201392388,47873,27791,2024-10-04 19:42:08,0,0,0,0,0,0
3,2673446010,201392388,47873,10967,2024-10-04 19:42:08,0,0,0,0,0,0
2,2673446010,201392387,47873,49795,2024-10-04 19:42:09,0,0,0,0,0,0
1,2673446010,201392386,47873,22199,2024-10-04 19:42:09,0,0,0,0,0,0
3,2673446010,201392388,47873,33466,2024-10-04 19:42:09,0,0,0,0,0,0
3,2673446010,201392388,47873,27791,2024-10-04 19:42:09,0,0,0,0,0,0
3,2673446010,201392388,47873,10967,2024-10-04 19:42:09,0,0,0,0,0,0
2,2673446010,201392387,47873,49795,2024-10-04 19:42:10,0,0,0,0,0,0
1,2673446010,201392386,47873,22199,2024-10-04 19:42:10,0,0,0,0,0,0
3,2673446010,201392388,47873,33466,2024-10-04 19:42:10,0,0,0,0,0,0
3,2673446010,201392388,47873,27791,2024-10-04 19:42:10,0,0,0,0,0,0
3,2673446010,201392388,47873,10967,2024-10-04 19:42:10,0,0,0,0,0,0
2,2673446010,201392387,47873,49795,2024-10-04 19:42:11,0,0,0,0,0,0
1,2673446010,201392386,47873,22199,2024-10-04 19:42:11,0,0,0,0,0,0
3,2673446010,201392388,47873,33466,2024-10-04 19:42:11,0,0,0,0,0,0
3,2673446010,201392388,47873,27791,2024-10-04 19:42:11,0,0,0,0,0,0
3,2673446010,201392388,47873,10967,2024-10-04 19:42:11,0,0,0,0,0,0
2,2673446010,201392387,47873,49795,2024-10-04 19:42:12,0,0,0,0,0,0
1,2673446010,201392386,47873,22199,2024-10-04 19:42:12,0,0,0,0,0,0
3,2673446010,201392388,47873,33466,2024-10-04 19:42:12,0,0,0,0,0,0
3,2673446010,201392388,47873,27791,2024-10-04 19:42:12,0,0,0,0,0,0
3,2673446010,201392388,47873,10967,2024-10-04 19:42:12,0,0,0,0,0,0
1,2673446010,201392386,47873,22199,2024-10-04 19:42:13,0,0,0,0,0,0
3,2673446010,201392388,47873,33466,2024-10-04 19:42:13,0,0,0,0,0,0
3,2673446010,201392388,47873,27791,2024-10-04 19:42:13,0,0,0,0,0,0
3,2673446010,201392388,47873,10967,2024-10-04 19:42:13,0,0,0,0,0,0
3,2673446010,201392388,47873,33466,2024-10-04 19:42:14,0,0,0,0,0,0
3,2673446010,201392388,47873,27791,2024-10-04 19:42:14,0,0,0,0,0,0
3,2673446010,201392388,47873,10967,2024-10-04 19:42:14,0,0,0,0,0,0
3,2673446010,201392388,47873,33466,2024-10-04 19:42:15,0,0,0,0,0,0
3,2673446010,201392388,47873,27791,2024-10-04 19:42:15,0,0,0,0,0,0
3,2673446010,201392388,47873,10967,2024-10-04 19:42:15,0,0,0,0,0,0
3,2673446010,201392388,47873,33466,2024-10-04 19:42:16,0,0,0,0,0,0
3,2673446010,201392388,47873,27791,2024-10-04 19:42:16,0,0,0,0,0,0
3,2673446010,201392388,47873,10967,2024-10-04 19:42:16,0,0,0,0,0,0
3,2673446010,201392388,47873,33466,2024-10-04 19:42:17,0,0,0,0,0,0
3,2673446010,201392388,47873,27791,2024-10-04 19:42:17,0,0,0,0,0,0
3,2673446010,201392388,47873,10967,2024-10-04 19:42:17,0,0,0,0,0,0
3,2673446010,201392388,47873,33466,2024-10-04 19:42:18,0,0,0,0,0,0
3,2673446010,201392388,47873,27791,2024-10-04 19:42:18,0,0,0,0,0,0
3,2673446010,201392388,47873,10967,2024-10-04 19:42:18,0,0,0,0,0,0
3,2673446010,201392388,47873,33466,2024-10-04 19:42:19,0,0,0,0,0,0
3,2673446010,201392388,47873,27791,2024-10-04 19:42:19,0,0,0,0,0,0
3,2673446010,201392388,47873,10967,2024-10-04 19:42:19,0,0,0,0,0,0
3,2673446010,201392388,47873,33466,2024-10-04 19:42:20,0,0,0,0,0,0
3,2673446010,201392388,47873,27791,2024-10-04 19:42:20,0,0,0,0,0,0
3,2673446010,201392388,47873,10967,2024-10-04 19:42:20,0,0,0,0,0,0
3,2673446010,201392388,47873,33466,2024-10-04 19:42:21,0,0,0,0,0,0
3,2673446010,201392388,47873,27791,2024-10-04 19:42:21,0,0,0,0,0,0
3,2673446010,201392388,47873,10967,2024-10-04 19:42:21,0,0,0,0,0,0
3,2673446010,201392388,47873,33466,2024-10-04 19:42:22,0,0,0,0,0,0
3,2673446010,201392388,47873,27791,2024-10-04 19:42:22,0,0,0,0,0,0
3,2673446010,201392388,47873,10967,2024-10-04 19:42:22,0,0,0,0,0,0
3,2673446010,201392388,47873,33466,2024-10-04 19:42:23,0,0,0,0,0,0
3,2673446010,201392388,47873,27791,2024-10-04 19:42:23,0,0,0,0,0,0
3,2673446010,201392388,47873,10967,2024-10-04 19:42:23,0,0,0,0,0,0
3,2673446010,201392388,47873,33466,2024-10-04 19:42:24,0,0,0,0,0,0
3,2673446010,201392388,47873,27791,2024-10-04 19:42:24,0,0,0,0,0,0
3,2673446010,201392388,47873,10967,2024-10-04 19:42:24,0,0,0,0,0,0
3,2673446010,201392388,47873,33466,2024-10-04 19:42:25,0,0,0,0,0,0
3,2673446010,201392388,47873,27791,2024-10-04 19:42:25,0,0,0,0,0,0
3,2673446010,201392388,47873,10967,2024-10-04 19:42:25,0,0,0,0,0,0
3,2673446010,201392388,47873,33466,2024-10-04 19:42:26,0,0,0,0,0,0
3,2673446010,201392388,47873,27791,2024-10-04 19:42:26,0,0,0,0,0,0
3,2673446010,201392388,47873,10967,2024-10-04 19:42:26,0,0,0,0,0,0
3,2673446010,201392388,47873,33466,2024-10-04 19:42:27,0,0,0,0,0,0
3,2673446010,201392388,47873,27791,2024-10-04 19:42:27,0,0,0,0,0,0
3,2673446010,201392388,47873,10967,2024-10-04 19:42:27,0,0,0,0,0,0
3,2673446010,201392388,47873,33466,2024-10-04 19:42:28,0,0,0,0,0,0
3,2673446010,201392388,47873,27791,2024-10-04 19:42:28,0,0,0,0,0,0
3,2673446010,201392388,47873,10967,2024-10-04 19:42:28,0,0,0,0,0,0
3,2673446010,201392388,47873,33466,2024-10-04 19:42:29,0,0,0,0,0,0
3,2673446010,201392388,47873,27791,2024-10-04 19:42:29,0,0,0,0,0,0
3,2673446010,201392388,47873,10967,2024-10-04 19:42:29,0,0,0,0,0,0
3,2673446010,201392388,47873,33466,2024-10-04 19:42:30,0,0,0,0,0,0
3,2673446010,201392388,47873,27791,2024-10-04 19:42:30,0,0,0,0,0,0
3,2673446010,201392388,47873,10967,2024-10-04 19:42:30,0,0,0,0,0,0
3,2673446010,201392388,47873,33466,2024-10-04 19:42:31,0,0,0,0,0,0
3,2673446010,201392388,47873,27791,2024-10-04 19:42:31,0,0,0,0,0,0
3,2673446010,201392388,47873,10967,2024-10-04 19:42:31,0,0,0,0,0,0
3,2673446010,201392388,47873,33466,2024-10-04 19:42:32,0,0,0,0,0,0
3,2673446010,201392388,47873,27791,2024-10-04 19:42:32,0,0,0,0,0,0
3,2673446010,201392388,47873,10967,2024-10-04 19:42:32,0,0,0,0,0,0
3,2673446010,201392388,47873,33466,2024-10-04 19:42:33,0,0,0,0,0,0
3,2673446010,201392388,47873,27791,2024-10-04 19:42:33,0,0,0,0,0,0
3,2673446010,201392388,47873,10967,2024-10-04 19:42:33,0,0,0,0,0,0
3,2673446010,201392388,47873,7830,2024-10-04 19:42:34,2760,1759,4519,4,10,14
3,2673446010,201392388,47873,33466,2024-10-04 19:42:34,0,0,0,0,0,0
3,2673446010,201392388,47873,27791,2024-10-04 19:42:34,0,0,0,0,0,0
3,2673446010,201392388,47873,10967,2024-10-04 19:42:34,0,0,0,0,0,0
3,2673446010,201392388,47873,7830,2024-10-04 19:42:35,6419,823,7242,11,8,19
3,2673446010,201392388,47873,33466,2024-10-04 19:42:35,0,0,0,0,0,0
3,2673446010,201392388,47873,27791,2024-10-04 19:42:35,0,0,0,0,0,0
3,2673446010,201392388,47873,10967,2024-10-04 19:42:35,0,0,0,0,0,0
1,2673446010,201392386,47873,13532,2024-10-04 19:42:36,4794,921,5715,5,4,9
3,2673446010,201392388,47873,7830,2024-10-04 19:42:36,0,0,0,0,0,0
3,2673446010,201392388,47873,33466,2024-10-04 19:42:36,0,0,0,0,0,0
3,2673446010,201392388,47873,27791,2024-10-04 19:42:36,0,0,0,0,0,0
3,2673446010,201392388,47873,10967,2024-10-04 19:42:36,0,0,0,0,0,0
1,2673446010,201392386,47873,13532,2024-10-04 19:42:37,4324,1457,5781,8,12,20
3,2673446010,201392388,47873,7830,2024-10-04 19:42:37,0,0,0,0,0,0
3,2673446010,201392388,47873,33466,2024-10-04 19:42:37,0,0,0,0,0,0
3,2673446010,201392388,47873,27791,2024-10-04 19:42:37,0,0,0,0,0,0
2,2673446010,201392387,47873,32921,2024-10-04 19:42:37,9281,2666,11947,17,19,36
1,2673446010,201392386,47873,13532,2024-10-04 19:42:38,0,0,0,0,0,0
3,2673446010,201392388,47873,7830,2024-10-04 19:42:38,0,0,0,0,0,0
3,2673446010,201392388,47873,33466,2024-10-04 19:42:38,0,0,0,0,0,0
3,2673446010,201392388,47873,27791,2024-10-04 19:42:38,0,0,0,0,0,0
2,2673446010,201392387,47873,32921,2024-10-04 19:42:38,0,0,0,0,0,0
1,2673446010,201392386,47873,13532,2024-10-04 19:42:39,0,0,0,0,0,0
3,2673446010,201392388,47873,7830,2024-10-04 19:42:39,0,0,0,0,0,0
3,2673446010,201392388,47873,33466,2024-10-04 19:42:39,0,0,0,0,0,0
3,2673446010,201392388,47873,27791,2024-10-04 19:42:39,0,0,0,0,0,0
2,2673446010,201392387,47873,32921,2024-10-04 19:42:39,0,0,0,0,0,0
1,2673446010,201392386,47873,13532,2024-10-04 19:42:40,0,0,0,0,0,0
3,2673446010,201392388,47873,7830,2024-10-04 19:42:40,0,0,0,0,0,0
3,2673446010,201392388,47873,33466,2024-10-04 19:42:40,0,0,0,0,0,0
3,2673446010,201392388,47873,27791,2024-10-04 19:42:40,0,0,0,0,0,0
2,2673446010,201392387,47873,32921,2024-10-04 19:42:40,0,0,0,0,0,0
1,2673446010,201392386,47873,13532,2024-10-04 19:42:41,0,0,0,0,0,0
3,2673446010,201392388,47873,7830,2024-10-04 19:42:41,0,0,0,0,0,0
3,2673446010,201392388,47873,33466,2024-10-04 19:42:41,0,0,0,0,0,0
3,2673446010,201392388,47873,27791,2024-10-04 19:42:41,0,0,0,0,0,0
2,2673446010,201392387,47873,32921,2024-10-04 19:42:41,0,0,0,0,0,0
1,2673446010,201392386,47873,13532,2024-10-04 19:42:42,0,0,0,0,0,0
3,2673446010,201392388,47873,7830,2024-10-04 19:42:42,0,0,0,0,0,0
3,2673446010,201392388,47873,33466,2024-10-04 19:42:42,0,0,0,0,0,0
3,2673446010,201392388,47873,27791,2024-10-04 19:42:42,0,0,0,0,0,0
2,2673446010,201392387,47873,32921,2024-10-04 19:42:42,0,0,0,0,0,0
1,2673446010,201392386,47873,13532,2024-10-04 19:42:43,0,0,0,0,0,0
3,2673446010,201392388,47873,7830,2024-10-04 19:42:43,0,0,0,0,0,0
3,2673446010,201392388,47873,33466,2024-10-04 19:42:43,0,0,0,0,0,0
3,2673446010,201392388,47873,27791,2024-10-04 19:42:43,0,0,0,0,0,0
1,2673446010,201392386,47873,13532,2024-10-04 19:42:44,0,0,0,0,0,0
3,2673446010,201392388,47873,7830,2024-10-04 19:42:44,0,0,0,0,0,0
3,2673446010,201392388,47873,33466,2024-10-04 19:42:44,0,0,0,0,0,0
3,2673446010,201392388,47873,27791,2024-10-04 19:42:44,0,0,0,0,0,0
3,2673446010,201392388,47873,7830,2024-10-04 19:42:45,0,0,0,0,0,0
3,2673446010,201392388,47873,33466,2024-10-04 19:42:45,0,0,0,0,0,0
3,2673446010,201392388,47873,27791,2024-10-04 19:42:45,0,0,0,0,0,0
3,2673446010,201392388,47873,33466,2024-10-04 19:42:46,0,0,0,0,0,0
3,2673446010,201392388,47873,27791,2024-10-04 19:42:46,0,0,0,0,0,0
3,2673446010,201392388,47873,33466,2024-10-04 19:42:47,0,0,0,0,0,0
3,2673446010,201392388,47873,27791,2024-10-04 19:42:47,0,0,0,0,0,0
3,2673446010,201392388,47873,33466,2024-10-04 19:42:48,0,0,0,0,0,0
3,2673446010,201392388,47873,27791,2024-10-04 19:42:48,0,0,0,0,0,0
3,2673446010,201392388,47873,33466,2024-10-04 19:42:49,0,0,0,0,0,0
3,2673446010,201392388,47873,27791,2024-10-04 19:42:49,0,0,0,0,0,0
3,2673446010,201392388,47873,33466,2024-10-04 19:42:50,0,0,0,0,0,0
3,2673446010,201392388,47873,27791,2024-10-04 19:42:50,0,0,0,0,0,0
3,2673446010,201392388,47873,33466,2024-10-04 19:42:51,0,0,0,0,0,0
3,2673446010,201392388,47873,27791,2024-10-04 19:42:51,0,0,0,0,0,0
3,2673446010,201392388,47873,33466,2024-10-04 19:42:52,0,0,0,0,0,0
3,2673446010,201392388,47873,27791,2024-10-04 19:42:52,0,0,0,0,0,0
3,2673446010,201392388,47873,33466,2024-10-04 19:42:53,0,0,0,0,0,0
3,2673446010,201392388,47873,27791,2024-10-04 19:42:53,0,0,0,0,0,0
3,2673446010,201392388,47873,33466,2024-10-04 19:42:54,0,0,0,0,0,0
3,2673446010,201392388,47873,27791,2024-10-04 19:42:54,0,0,0,0,0,0
3,2673446010,201392388,47873,33466,2024-10-04 19:42:55,0,0,0,0,0,0
3,2673446010,201392388,47873,27791,2024-10-04 19:42:55,0,0,0,0,0,0
3,2673446010,201392388,47873,33466,2024-10-04 19:42:56,0,0,0,0,0,0
3,2673446010,201392388,47873,27791,2024-10-04 19:42:56,0,0,0,0,0,0
3,2673446010,201392388,47873,33466,2024-10-04 19:42:57,0,0,0,0,0,0
3,2673446010,201392388,47873,27791,2024-10-04 19:42:57,0,0,0,0,0,0
3,2673446010,201392388,47873,33466,2024-10-04 19:42:58,0,0,0,0,0,0
3,2673446010,201392388,47873,27791,2024-10-04 19:42:58,0,0,0,0,0,0
3,2673446010,201392388,47873,33466,2024-10-04 19:42:59,0,0,0,0,0,0
3,2673446010,201392388,47873,27791,2024-10-04 19:42:59,0,0,0,0,0,0
3,2673446010,201392388,47873,33466,2024-10-04 19:43:00,0,0,0,0,0,0
3,2673446010,201392388,47873,27791,2024-10-04 19:43:00,0,0,0,0,0,0
3,2673446010,201392388,47873,33466,2024-10-04 19:43:01,0,0,0,0,0,0
3,2673446010,201392388,47873,27791,2024-10-04 19:43:01,0,0,0,0,0,0
3,2673446010,201392388,47873,33466,2024-10-04 19:43:02,0,0,0,0,0,0
3,2673446010,201392388,47873,27791,2024-10-04 19:43:02,0,0,0,0,0,0
3,2673446010,201392388,47873,33466,2024-10-04 19:43:03,0,0,0,0,0,0
3,2673446010,201392388,47873,27791,2024-10-04 19:43:03,0,0,0,0,0,0
3,2673446010,201392388,47873,33466,2024-10-04 19:43:04,0,0,0,0,0,0
3,2673446010,201392388,47873,27791,2024-10-04 19:43:04,0,0,0,0,0,0
3,2673446010,201392388,47873,52379,2024-10-04 19:43:05,3373,921,4294,4,4,8
3,2673446010,201392388,47873,33466,2024-10-04 19:43:05,0,0,0,0,0,0
3,2673446010,201392388,47873,27791,2024-10-04 19:43:05,0,0,0,0,0,0
3,2673446010,201392388,47873,52379,2024-10-04 19:43:06,7694,1769,9463,9,15,24
3,2673446010,201392388,47873,33466,2024-10-04 19:43:06,0,0,0,0,0,0
3,2673446010,201392388,47873,27791,2024-10-04 19:43:06,0,0,0,0,0,0
3,2673446010,201392388,47873,52379,2024-10-04 19:43:07,0,0,0,0,0,0
3,2673446010,201392388,47873,33466,2024-10-04 19:43:07,0,0,0,0,0,0
3,2673446010,201392388,47873,27791,2024-10-04 19:43:07,0,0,0,0,0,0
1,2673446010,201392386,47873,34456,2024-10-04 19:43:07,0,104,104,0,1,1
3,2673446010,201392388,47873,52379,2024-10-04 19:43:08,0,0,0,0,0,0
3,2673446010,201392388,47873,33466,2024-10-04 19:43:08,0,0,0,0,0,0
3,2673446010,201392388,47873,27791,2024-10-04 19:43:08,0,0,0,0,0,0
1,2673446010,201392386,47873,34456,2024-10-04 19:43:08,0,0,0,0,0,0
3,2673446010,201392388,47873,52379,2024-10-04 19:43:09,0,0,0,0,0,0
2,2673446010,201392387,47873,48804,2024-10-04 19:43:09,9183,2678,11861,16,19,35
3,2673446010,201392388,47873,33466,2024-10-04 19:43:09,0,0,0,0,0,0
3,2673446010,201392388,47873,27791,2024-10-04 19:43:09,0,0,0,0,0,0
1,2673446010,201392386,47873,34456,2024-10-04 19:43:09,9140,2358,11498,14,16,30
3,2673446010,201392388,47873,52379,2024-10-04 19:43:10,0,0,0,0,0,0
2,2673446010,201392387,47873,48804,2024-10-04 19:43:10,0,0,0,0,0,0
3,2673446010,201392388,47873,33466,2024-10-04 19:43:10,0,0,0,0,0,0
3,2673446010,201392388,47873,27791,2024-10-04 19:43:10,0,0,0,0,0,0
1,2673446010,201392386,47873,34456,2024-10-04 19:43:10,0,0,0,0,0,0
3,2673446010,201392388,47873,52379,2024-10-04 19:43:11,0,0,0,0,0,0
2,2673446010,201392387,47873,48804,2024-10-04 19:43:11,0,0,0,0,0,0
3,2673446010,201392388,47873,33466,2024-10-04 19:43:11,0,0,0,0,0,0
3,2673446010,201392388,47873,27791,2024-10-04 19:43:11,0,0,0,0,0,0
1,2673446010,201392386,47873,34456,2024-10-04 19:43:11,0,0,0,0,0,0
3,2673446010,201392388,47873,52379,2024-10-04 19:43:12,0,0,0,0,0,0
2,2673446010,201392387,47873,48804,2024-10-04 19:43:12,0,0,0,0,0,0
3,2673446010,201392388,47873,33466,2024-10-04 19:43:12,0,0,0,0,0,0
3,2673446010,201392388,47873,27791,2024-10-04 19:43:12,0,0,0,0,0,0
1,2673446010,201392386,47873,34456,2024-10-04 19:43:12,0,0,0,0,0,0
3,2673446010,201392388,47873,52379,2024-10-04 19:43:13,0,0,0,0,0,0
2,2673446010,201392387,47873,48804,2024-10-04 19:43:13,0,0,0,0,0,0
3,2673446010,201392388,47873,33466,2024-10-04 19:43:13,0,0,0,0,0,0
3,2673446010,201392388,47873,27791,2024-10-04 19:43:13,0,0,0,0,0,0
1,2673446010,201392386,47873,34456,2024-10-04 19:43:13,0,0,0,0,0,0
3,2673446010,201392388,47873,52379,2024-10-04 19:43:14,0,0,0,0,0,0
2,2673446010,201392387,47873,48804,2024-10-04 19:43:14,0,0,0,0,0,0
3,2673446010,201392388,47873,33466,2024-10-04 19:43:14,0,0,0,0,0,0
3,2673446010,201392388,47873,27791,2024-10-04 19:43:14,0,0,0,0,0,0
1,2673446010,201392386,47873,34456,2024-10-04 19:43:14,0,0,0,0,0,0
3,2673446010,201392388,47873,52379,2024-10-04 19:43:15,0,0,0,0,0,0
3,2673446010,201392388,47873,33466,2024-10-04 19:43:15,0,0,0,0,0,0
3,2673446010,201392388,47873,27791,2024-10-04 19:43:15,0,0,0,0,0,0
1,2673446010,201392386,47873,34456,2024-10-04 19:43:15,0,0,0,0,0,0
3,2673446010,201392388,47873,52379,2024-10-04 19:43:16,0,0,0,0,0,0
3,2673446010,201392388,47873,33466,2024-10-04 19:43:16,0,0,0,0,0,0
3,2673446010,201392388,47873,27791,2024-10-04 19:43:16,0,0,0,0,0,0
1,2673446010,201392386,47873,34456,2024-10-04 19:43:16,0,0,0,0,0,0
3,2673446010,201392388,47873,33466,2024-10-04 19:43:17,0,0,0,0,0,0
3,2673446010,201392388,47873,27791,2024-10-04 19:43:17,0,0,0,0,0,0
3,2673446010,201392388,47873,33466,2024-10-04 19:43:18,0,0,0,0,0,0
3,2673446010,201392388,47873,27791,2024-10-04 19:43:18,0,0,0,0,0,0
3,2673446010,201392388,47873,33466,2024-10-04 19:43:19,0,0,0,0,0,0
3,2673446010,201392388,47873,27791,2024-10-04 19:43:19,0,0,0,0,0,0
3,2673446010,201392388,47873,33466,2024-10-04 19:43:20,0,0,0,0,0,0
3,2673446010,201392388,47873,27791,2024-10-04 19:43:20,0,0,0,0,0,0
3,2673446010,201392388,47873,33466,2024-10-04 19:43:21,0,0,0,0,0,0
3,2673446010,201392388,47873,27791,2024-10-04 19:43:21,0,0,0,0,0,0
3,2673446010,201392388,47873,33466,2024-10-04 19:43:22,0,0,0,0,0,0
3,2673446010,201392388,47873,27791,2024-10-04 19:43:22,0,0,0,0,0,0
3,2673446010,201392388,47873,33466,2024-10-04 19:43:23,0,0,0,0,0,0
3,2673446010,201392388,47873,27791,2024-10-04 19:43:23,0,0,0,0,0,0
3,2673446010,201392388,47873,33466,2024-10-04 19:43:24,0,0,0,0,0,0
3,2673446010,201392388,47873,27791,2024-10-04 19:43:24,0,0,0,0,0,0
3,2673446010,201392388,47873,33466,2024-10-04 19:43:25,0,0,0,0,0,0
3,2673446010,201392388,47873,27791,2024-10-04 19:43:25,0,0,0,0,0,0
3,2673446010,201392388,47873,33466,2024-10-04 19:43:26,0,0,0,0,0,0
3,2673446010,201392388,47873,27791,2024-10-04 19:43:26,0,0,0,0,0,0
3,2673446010,201392388,47873,33466,2024-10-04 19:43:27,0,0,0,0,0,0
3,2673446010,201392388,47873,27791,2024-10-04 19:43:27,0,0,0,0,0,0
3,2673446010,201392388,47873,33466,2024-10-04 19:43:28,0,0,0,0,0,0
3,2673446010,201392388,47873,27791,2024-10-04 19:43:28,0,0,0,0,0,0
3,2673446010,201392388,47873,33466,2024-10-04 19:43:29,0,0,0,0,0,0
3,2673446010,201392388,47873,27791,2024-10-04 19:43:29,0,0,0,0,0,0
3,2673446010,201392388,47873,33466,2024-10-04 19:43:30,0,0,0,0,0,0
3,2673446010,201392388,47873,27791,2024-10-04 19:43:30,0,0,0,0,0,0
3,2673446010,201392388,47873,33466,2024-10-04 19:43:31,0,0,0,0,0,0
3,2673446010,201392388,47873,27791,2024-10-04 19:43:31,0,0,0,0,0,0
3,2673446010,201392388,47873,33466,2024-10-04 19:43:32,0,0,0,0,0,0
3,2673446010,201392388,47873,27791,2024-10-04 19:43:32,0,0,0,0,0,0
3,2673446010,201392388,47873,33466,2024-10-04 19:43:33,0,0,0,0,0,0
3,2673446010,201392388,47873,27791,2024-10-04 19:43:33,0,0,0,0,0,0
3,2673446010,201392388,47873,33466,2024-10-04 19:43:34,0,0,0,0,0,0
3,2673446010,201392388,47873,27791,2024-10-04 19:43:34,0,0,0,0,0,0
3,2673446010,201392388,47873,33466,2024-10-04 19:43:35,0,0,0,0,0,0
3,2673446010,201392388,47873,27791,2024-10-04 19:43:35,0,0,0,0,0,0
3,2673446010,201392388,47873,17062,2024-10-04 19:43:36,4794,921,5715,5,4,9
3,2673446010,201392388,47873,33466,2024-10-04 19:43:36,0,0,0,0,0,0
3,2673446010,201392388,47873,27791,2024-10-04 19:43:36,0,0,0,0,0,0
3,2673446010,201392388,47873,17062,2024-10-04 19:43:37,6301,1769,8070,9,15,24
3,2673446010,201392388,47873,33466,2024-10-04 19:43:37,0,0,0,0,0,0
3,2673446010,201392388,47873,27791,2024-10-04 19:43:37,0,0,0,0,0,0
3,2673446010,201392388,47873,17062,2024-10-04 19:43:38,0,0,0,0,0,0
2,2673446010,201392387,47873,58557,2024-10-04 19:43:38,9125,2678,11803,15,19,34
3,2673446010,201392388,47873,33466,2024-10-04 19:43:38,0,0,0,0,0,0
1,2673446010,201392386,47873,53955,2024-10-04 19:43:38,0,104,104,0,1,1
3,2673446010,201392388,47873,27791,2024-10-04 19:43:38,0,0,0,0,0,0
3,2673446010,201392388,47873,17062,2024-10-04 19:43:39,0,0,0,0,0,0
2,2673446010,201392387,47873,58557,2024-10-04 19:43:39,0,0,0,0,0,0
3,2673446010,201392388,47873,33466,2024-10-04 19:43:39,0,0,0,0,0,0
1,2673446010,201392386,47873,53955,2024-10-04 19:43:39,11416,2670,14086,20,19,39
3,2673446010,201392388,47873,27791,2024-10-04 19:43:39,0,0,0,0,0,0
3,2673446010,201392388,47873,17062,2024-10-04 19:43:40,0,0,0,0,0,0
2,2673446010,201392387,47873,58557,2024-10-04 19:43:40,0,0,0,0,0,0
3,2673446010,201392388,47873,33466,2024-10-04 19:43:40,0,0,0,0,0,0
1,2673446010,201392386,47873,53955,2024-10-04 19:43:40,0,0,0,0,0,0
3,2673446010,201392388,47873,27791,2024-10-04 19:43:40,0,0,0,0,0,0
3,2673446010,201392388,47873,17062,2024-10-04 19:43:41,0,0,0,0,0,0
2,2673446010,201392387,47873,58557,2024-10-04 19:43:41,0,0,0,0,0,0
3,2673446010,201392388,47873,33466,2024-10-04 19:43:41,0,0,0,0,0,0
1,2673446010,201392386,47873,53955,2024-10-04 19:43:41,0,0,0,0,0,0
3,2673446010,201392388,47873,27791,2024-10-04 19:43:41,0,0,0,0,0,0
3,2673446010,201392388,47873,17062,2024-10-04 19:43:42,0,0,0,0,0,0
2,2673446010,201392387,47873,58557,2024-10-04 19:43:42,0,0,0,0,0,0
3,2673446010,201392388,47873,33466,2024-10-04 19:43:42,0,0,0,0,0,0
1,2673446010,201392386,47873,53955,2024-10-04 19:43:42,0,0,0,0,0,0
3,2673446010,201392388,47873,27791,2024-10-04 19:43:42,0,0,0,0,0,0
3,2673446010,201392388,47873,17062,2024-10-04 19:43:43,0,0,0,0,0,0
2,2673446010,201392387,47873,58557,2024-10-04 19:43:43,0,0,0,0,0,0
3,2673446010,201392388,47873,33466,2024-10-04 19:43:43,0,0,0,0,0,0
1,2673446010,201392386,47873,53955,2024-10-04 19:43:43,0,0,0,0,0,0
3,2673446010,201392388,47873,27791,2024-10-04 19:43:43,0,0,0,0,0,0
3,2673446010,201392388,47873,17062,2024-10-04 19:43:44,0,0,0,0,0,0
2,2673446010,201392387,47873,58557,2024-10-04 19:43:44,0,0,0,0,0,0
3,2673446010,201392388,47873,33466,2024-10-04 19:43:44,0,0,0,0,0,0
1,2673446010,201392386,47873,53955,2024-10-04 19:43:44,0,0,0,0,0,0
3,2673446010,201392388,47873,27791,2024-10-04 19:43:44,0,0,0,0,0,0
3,2673446010,201392388,47873,17062,2024-10-04 19:43:45,0,0,0,0,0,0
2,2673446010,201392387,47873,58557,2024-10-04 19:43:45,0,0,0,0,0,0
3,2673446010,201392388,47873,33466,2024-10-04 19:43:45,0,0,0,0,0,0
3,2673446010,201392388,47873,27791,2024-10-04 19:43:45,0,0,0,0,0,0
3,2673446010,201392388,47873,17062,2024-10-04 19:43:46,0,0,0,0,0,0
2,2673446010,201392387,47873,58557,2024-10-04 19:43:46,0,0,0,0,0,0
3,2673446010,201392388,47873,33466,2024-10-04 19:43:46,0,0,0,0,0,0
3,2673446010,201392388,47873,27791,2024-10-04 19:43:46,0,0,0,0,0,0
3,2673446010,201392388,47873,17062,2024-10-04 19:43:47,0,0,0,0,0,0
3,2673446010,201392388,47873,33466,2024-10-04 19:43:47,0,0,0,0,0,0
3,2673446010,201392388,47873,27791,2024-10-04 19:43:47,0,0,0,0,0,0
3,2673446010,201392388,47873,33466,2024-10-04 19:43:48,0,0,0,0,0,0
3,2673446010,201392388,47873,27791,2024-10-04 19:43:48,0,0,0,0,0,0
3,2673446010,201392388,47873,33466,2024-10-04 19:43:49,0,0,0,0,0,0
3,2673446010,201392388,47873,27791,2024-10-04 19:43:49,0,0,0,0,0,0
3,2673446010,201392388,47873,33466,2024-10-04 19:43:50,0,0,0,0,0,0
3,2673446010,201392388,47873,27791,2024-10-04 19:43:50,0,0,0,0,0,0
3,2673446010,201392388,47873,33466,2024-10-04 19:43:51,0,0,0,0,0,0
3,2673446010,201392388,47873,27791,2024-10-04 19:43:51,0,0,0,0,0,0
3,2673446010,201392388,47873,33466,2024-10-04 19:43:52,0,0,0,0,0,0
3,2673446010,201392388,47873,27791,2024-10-04 19:43:52,0,0,0,0,0,0
3,2673446010,201392388,47873,33466,2024-10-04 19:43:53,0,0,0,0,0,0
3,2673446010,201392388,47873,27791,2024-10-04 19:43:53,0,0,0,0,0,0
3,2673446010,201392388,47873,33466,2024-10-04 19:43:54,0,0,0,0,0,0
3,2673446010,201392388,47873,27791,2024-10-04 19:43:54,0,0,0,0,0,0
3,2673446010,201392388,47873,33466,2024-10-04 19:43:55,0,0,0,0,0,0
3,2673446010,201392388,47873,27791,2024-10-04 19:43:55,0,0,0,0,0,0
3,2673446010,201392388,47873,33466,2024-10-04 19:43:56,0,0,0,0,0,0
3,2673446010,201392388,47873,27791,2024-10-04 19:43:56,0,0,0,0,0,0
3,2673446010,201392388,47873,33466,2024-10-04 19:43:57,0,0,0,0,0,0
3,2673446010,201392388,47873,27791,2024-10-04 19:43:57,0,0,0,0,0,0
3,2673446010,201392388,47873,33466,2024-10-04 19:43:58,0,0,0,0,0,0
3,2673446010,201392388,47873,27791,2024-10-04 19:43:58,0,0,0,0,0,0
3,2673446010,201392388,47873,33466,2024-10-04 19:43:59,0,0,0,0,0,0
3,2673446010,201392388,47873,27791,2024-10-04 19:43:59,0,0,0,0,0,0
3,2673446010,201392388,47873,33466,2024-10-04 19:44:00,0,0,0,0,0,0
3,2673446010,201392388,47873,27791,2024-10-04 19:44:00,0,0,0,0,0,0
3,2673446010,201392388,47873,33466,2024-10-04 19:44:01,0,0,0,0,0,0
3,2673446010,201392388,47873,27791,2024-10-04 19:44:01,0,0,0,0,0,0
3,2673446010,201392388,47873,33466,2024-10-04 19:44:02,0,0,0,0,0,0
3,2673446010,201392388,47873,27791,2024-10-04 19:44:02,0,0,0,0,0,0
3,2673446010,201392388,47873,33466,2024-10-04 19:44:03,0,0,0,0,0,0
3,2673446010,201392388,47873,27791,2024-10-04 19:44:03,0,0,0,0,0,0
3,2673446010,201392388,47873,33466,2024-10-04 19:44:04,0,0,0,0,0,0
3,2673446010,201392388,47873,27791,2024-10-04 19:44:04,0,0,0,0,0,0
3,2673446010,201392388,47873,33466,2024-10-04 19:44:05,0,0,0,0,0,0
3,2673446010,201392388,47873,27791,2024-10-04 19:44:05,0,0,0,0,0,0
3,2673446010,201392388,47873,5344,2024-10-04 19:44:06,3373,813,4186,4,3,7
3,2673446010,201392388,47873,33466,2024-10-04 19:44:06,0,0,0,0,0,0
3,2673446010,201392388,47873,27791,2024-10-04 19:44:06,0,0,0,0,0,0
3,2673446010,201392388,47873,5344,2024-10-04 19:44:07,7779,1865,9644,11,16,27
3,2673446010,201392388,47873,33466,2024-10-04 19:44:07,0,0,0,0,0,0
3,2673446010,201392388,47873,27791,2024-10-04 19:44:07,0,0,0,0,0,0
3,2673446010,201392388,47873,5344,2024-10-04 19:44:08,0,0,0,0,0,0
3,2673446010,201392388,47873,33466,2024-10-04 19:44:08,0,0,0,0,0,0
1,2673446010,201392386,47873,26813,2024-10-04 19:44:08,0,104,104,0,1,1
3,2673446010,201392388,47873,27791,2024-10-04 19:44:08,0,0,0,0,0,0
2,2673446010,201392387,47873,42215,2024-10-04 19:44:09,2146,813,2959,3,3,6
3,2673446010,201392388,47873,5344,2024-10-04 19:44:09,0,0,0,0,0,0
3,2673446010,201392388,47873,33466,2024-10-04 19:44:09,0,0,0,0,0,0
1,2673446010,201392386,47873,26813,2024-10-04 19:44:09,4795,817,5612,5,3,8
3,2673446010,201392388,47873,27791,2024-10-04 19:44:09,0,0,0,0,0,0
2,2673446010,201392387,47873,42215,2024-10-04 19:44:10,0,0,0,0,0,0
3,2673446010,201392388,47873,5344,2024-10-04 19:44:10,0,0,0,0,0,0
3,2673446010,201392388,47873,33466,2024-10-04 19:44:10,0,0,0,0,0,0
1,2673446010,201392386,47873,26813,2024-10-04 19:44:10,0,0,0,0,0,0
3,2673446010,201392388,47873,27791,2024-10-04 19:44:10,0,0,0,0,0,0
2,2673446010,201392387,47873,42215,2024-10-04 19:44:11,8960,1781,10741,11,15,26
3,2673446010,201392388,47873,5344,2024-10-04 19:44:11,0,0,0,0,0,0
3,2673446010,201392388,47873,33466,2024-10-04 19:44:11,0,0,0,0,0,0
1,2673446010,201392386,47873,26813,2024-10-04 19:44:11,6362,1757,8119,11,15,26
3,2673446010,201392388,47873,27791,2024-10-04 19:44:11,0,0,0,0,0,0
2,2673446010,201392387,47873,42215,2024-10-04 19:44:12,0,0,0,0,0,0
3,2673446010,201392388,47873,5344,2024-10-04 19:44:12,0,0,0,0,0,0
3,2673446010,201392388,47873,33466,2024-10-04 19:44:12,0,0,0,0,0,0
1,2673446010,201392386,47873,26813,2024-10-04 19:44:12,0,0,0,0,0,0
3,2673446010,201392388,47873,27791,2024-10-04 19:44:12,0,0,0,0,0,0
2,2673446010,201392387,47873,42215,2024-10-04 19:44:13,0,0,0,0,0,0
3,2673446010,201392388,47873,5344,2024-10-04 19:44:13,0,0,0,0,0,0
3,2673446010,201392388,47873,33466,2024-10-04 19:44:13,0,0,0,0,0,0
1,2673446010,201392386,47873,26813,2024-10-04 19:44:13,0,0,0,0,0,0
3,2673446010,201392388,47873,27791,2024-10-04 19:44:13,0,0,0,0,0,0
2,2673446010,201392387,47873,42215,2024-10-04 19:44:14,0,0,0,0,0,0
3,2673446010,201392388,47873,5344,2024-10-04 19:44:14,0,0,0,0,0,0
3,2673446010,201392388,47873,33466,2024-10-04 19:44:14,0,0,0,0,0,0
1,2673446010,201392386,47873,26813,2024-10-04 19:44:14,0,0,0,0,0,0
3,2673446010,201392388,47873,27791,2024-10-04 19:44:14,0,0,0,0,0,0
2,2673446010,201392387,47873,42215,2024-10-04 19:44:15,0,0,0,0,0,0
3,2673446010,201392388,47873,5344,2024-10-04 19:44:15,0,0,0,0,0,0
3,2673446010,201392388,47873,33466,2024-10-04 19:44:15,0,0,0,0,0,0
1,2673446010,201392386,47873,26813,2024-10-04 19:44:15,0,0,0,0,0,0
3,2673446010,201392388,47873,27791,2024-10-04 19:44:15,0,0,0,0,0,0
3,2673446010,201392388,47873,5344,2024-10-04 19:44:16,0,0,0,0,0,0
3,2673446010,201392388,47873,33466,2024-10-04 19:44:16,0,0,0,0,0,0
1,2673446010,201392386,47873,26813,2024-10-04 19:44:16,0,0,0,0,0,0
3,2673446010,201392388,47873,27791,2024-10-04 19:44:16,0,0,0,0,0,0
3,2673446010,201392388,47873,5344,2024-10-04 19:44:17,0,0,0,0,0,0
3,2673446010,201392388,47873,33466,2024-10-04 19:44:17,0,0,0,0,0,0
1,2673446010,201392386,47873,26813,2024-10-04 19:44:17,0,0,0,0,0,0
3,2673446010,201392388,47873,27791,2024-10-04 19:44:17,0,0,0,0,0,0
3,2673446010,201392388,47873,5344,2024-10-04 19:44:18,0,0,0,0,0,0
3,2673446010,201392388,47873,33466,2024-10-04 19:44:18,0,0,0,0,0,0
1,2673446010,201392386,47873,26813,2024-10-04 19:44:18,0,0,0,0,0,0
3,2673446010,201392388,47873,27791,2024-10-04 19:44:18,0,0,0,0,0,0
3,2673446010,201392388,47873,5344,2024-10-04 19:44:19,0,0,0,0,0,0
3,2673446010,201392388,47873,33466,2024-10-04 19:44:19,0,0,0,0,0,0
3,2673446010,201392388,47873,27791,2024-10-04 19:44:19,0,0,0,0,0,0
3,2673446010,201392388,47873,5344,2024-10-04 19:44:20,0,0,0,0,0,0
3,2673446010,201392388,47873,33466,2024-10-04 19:44:20,0,0,0,0,0,0
3,2673446010,201392388,47873,27791,2024-10-04 19:44:20,0,0,0,0,0,0
3,2673446010,201392388,47873,5344,2024-10-04 19:44:21,0,0,0,0,0,0
3,2673446010,201392388,47873,33466,2024-10-04 19:44:21,0,0,0,0,0,0
3,2673446010,201392388,47873,27791,2024-10-04 19:44:21,0,0,0,0,0,0
3,2673446010,201392388,47873,5344,2024-10-04 19:44:22,0,0,0,0,0,0
3,2673446010,201392388,47873,33466,2024-10-04 19:44:22,0,0,0,0,0,0
3,2673446010,201392388,47873,27791,2024-10-04 19:44:22,0,0,0,0,0,0
3,2673446010,201392388,47873,5344,2024-10-04 19:44:23,0,0,0,0,0,0
3,2673446010,201392388,47873,33466,2024-10-04 19:44:23,0,0,0,0,0,0
3,2673446010,201392388,47873,27791,2024-10-04 19:44:23,0,0,0,0,0,0
3,2673446010,201392388,47873,5344,2024-10-04 19:44:24,0,0,0,0,0,0
3,2673446010,201392388,47873,33466,2024-10-04 19:44:24,0,0,0,0,0,0
3,2673446010,201392388,47873,27791,2024-10-04 19:44:24,0,0,0,0,0,0
3,2673446010,201392388,47873,5344,2024-10-04 19:44:25,0,0,0,0,0,0
3,2673446010,201392388,47873,33466,2024-10-04 19:44:25,0,0,0,0,0,0
3,2673446010,201392388,47873,27791,2024-10-04 19:44:25,0,0,0,0,0,0
3,2673446010,201392388,47873,5344,2024-10-04 19:44:26,0,0,0,0,0,0
3,2673446010,201392388,47873,33466,2024-10-04 19:44:26,0,0,0,0,0,0
3,2673446010,201392388,47873,27791,2024-10-04 19:44:26,0,0,0,0,0,0
3,2673446010,201392388,47873,5344,2024-10-04 19:44:27,0,0,0,0,0,0
3,2673446010,201392388,47873,33466,2024-10-04 19:44:27,0,0,0,0,0,0
3,2673446010,201392388,47873,27791,2024-10-04 19:44:27,0,0,0,0,0,0
3,2673446010,201392388,47873,5344,2024-10-04 19:44:28,0,0,0,0,0,0
3,2673446010,201392388,47873,33466,2024-10-04 19:44:28,0,0,0,0,0,0
3,2673446010,201392388,47873,27791,2024-10-04 19:44:28,0,0,0,0,0,0
3,2673446010,201392388,47873,5344,2024-10-04 19:44:29,0,0,0,0,0,0
3,2673446010,201392388,47873,33466,2024-10-04 19:44:29,0,0,0,0,0,0
3,2673446010,201392388,47873,27791,2024-10-04 19:44:29,0,0,0,0,0,0
3,2673446010,201392388,47873,5344,2024-10-04 19:44:30,0,0,0,0,0,0
3,2673446010,201392388,47873,33466,2024-10-04 19:44:30,0,0,0,0,0,0
3,2673446010,201392388,47873,27791,2024-10-04 19:44:30,0,0,0,0,0,0
3,2673446010,201392388,47873,5344,2024-10-04 19:44:31,0,0,0,0,0,0
3,2673446010,201392388,47873,33466,2024-10-04 19:44:31,0,0,0,0,0,0
3,2673446010,201392388,47873,27791,2024-10-04 19:44:31,0,0,0,0,0,0
3,2673446010,201392388,47873,5344,2024-10-04 19:44:32,0,0,0,0,0,0
3,2673446010,201392388,47873,33466,2024-10-04 19:44:32,0,0,0,0,0,0
3,2673446010,201392388,47873,27791,2024-10-04 19:44:32,0,0,0,0,0,0
3,2673446010,201392388,47873,5344,2024-10-04 19:44:33,0,0,0,0,0,0
3,2673446010,201392388,47873,33466,2024-10-04 19:44:33,0,0,0,0,0,0
3,2673446010,201392388,47873,27791,2024-10-04 19:44:33,0,0,0,0,0,0
3,2673446010,201392388,47873,5344,2024-10-04 19:44:34,0,0,0,0,0,0
3,2673446010,201392388,47873,33466,2024-10-04 19:44:34,0,0,0,0,0,0
3,2673446010,201392388,47873,27791,2024-10-04 19:44:34,0,0,0,0,0,0
3,2673446010,201392388,47873,5344,2024-10-04 19:44:35,0,0,0,0,0,0
3,2673446010,201392388,47873,33466,2024-10-04 19:44:35,0,0,0,0,0,0
3,2673446010,201392388,47873,27791,2024-10-04 19:44:35,0,0,0,0,0,0
3,2673446010,201392388,47873,5344,2024-10-04 19:44:36,0,0,0,0,0,0
3,2673446010,201392388,47873,33466,2024-10-04 19:44:36,0,0,0,0,0,0
3,2673446010,201392388,47873,27791,2024-10-04 19:44:36,0,0,0,0,0,0
3,2673446010,201392388,47873,5344,2024-10-04 19:44:37,0,0,0,0,0,0
3,2673446010,201392388,47873,33466,2024-10-04 19:44:37,0,0,0,0,0,0
3,2673446010,201392388,47873,27791,2024-10-04 19:44:37,0,0,0,0,0,0
3,2673446010,201392388,47873,5344,2024-10-04 19:44:38,0,0,0,0,0,0
3,2673446010,201392388,47873,33466,2024-10-04 19:44:38,0,0,0,0,0,0
3,2673446010,201392388,47873,10982,2024-10-04 19:44:38,11282,2786,14068,17,20,37
3,2673446010,201392388,47873,27791,2024-10-04 19:44:38,0,0,0,0,0,0
3,2673446010,201392388,47873,5344,2024-10-04 19:44:39,0,0,0,0,0,0
3,2673446010,201392388,47873,33466,2024-10-04 19:44:39,0,0,0,0,0,0
3,2673446010,201392388,47873,10982,2024-10-04 19:44:39,0,0,0,0,0,0
3,2673446010,201392388,47873,27791,2024-10-04 19:44:39,0,0,0,0,0,0
2,2673446010,201392387,47873,22225,2024-10-04 19:44:40,0,104,104,0,1,1
3,2673446010,201392388,47873,5344,2024-10-04 19:44:40,0,0,0,0,0,0
3,2673446010,201392388,47873,33466,2024-10-04 19:44:40,0,0,0,0,0,0
3,2673446010,201392388,47873,10982,2024-10-04 19:44:40,0,0,0,0,0,0
3,2673446010,201392388,47873,27791,2024-10-04 19:44:40,0,0,0,0,0,0
2,2673446010,201392387,47873,22225,2024-10-04 19:44:41,7214,2442,9656,16,17,33
1,2673446010,201392386,47873,40087,2024-10-04 19:44:41,4795,921,5716,5,4,9
3,2673446010,201392388,47873,5344,2024-10-04 19:44:41,0,0,0,0,0,0
3,2673446010,201392388,47873,33466,2024-10-04 19:44:41,0,0,0,0,0,0
3,2673446010,201392388,47873,10982,2024-10-04 19:44:41,0,0,0,0,0,0
3,2673446010,201392388,47873,27791,2024-10-04 19:44:41,0,0,0,0,0,0
2,2673446010,201392387,47873,22225,2024-10-04 19:44:42,0,0,0,0,0,0
1,2673446010,201392386,47873,40087,2024-10-04 19:44:42,6248,1589,7837,8,13,21
3,2673446010,201392388,47873,33466,2024-10-04 19:44:42,0,0,0,0,0,0
3,2673446010,201392388,47873,10982,2024-10-04 19:44:42,0,0,0,0,0,0
3,2673446010,201392388,47873,27791,2024-10-04 19:44:42,0,0,0,0,0,0
2,2673446010,201392387,47873,22225,2024-10-04 19:44:43,0,0,0,0,0,0
1,2673446010,201392386,47873,40087,2024-10-04 19:44:43,0,0,0,0,0,0
3,2673446010,201392388,47873,33466,2024-10-04 19:44:43,0,0,0,0,0,0
3,2673446010,201392388,47873,10982,2024-10-04 19:44:43,0,0,0,0,0,0
3,2673446010,201392388,47873,27791,2024-10-04 19:44:43,0,0,0,0,0,0
2,2673446010,201392387,47873,22225,2024-10-04 19:44:44,0,0,0,0,0,0
1,2673446010,201392386,47873,40087,2024-10-04 19:44:44,0,0,0,0,0,0
3,2673446010,201392388,47873,33466,2024-10-04 19:44:44,0,0,0,0,0,0
3,2673446010,201392388,47873,10982,2024-10-04 19:44:44,0,0,0,0,0,0
3,2673446010,201392388,47873,27791,2024-10-04 19:44:44,0,0,0,0,0,0
2,2673446010,201392387,47873,22225,2024-10-04 19:44:45,0,0,0,0,0,0
1,2673446010,201392386,47873,40087,2024-10-04 19:44:45,0,0,0,0,0,0
3,2673446010,201392388,47873,33466,2024-10-04 19:44:45,0,0,0,0,0,0
3,2673446010,201392388,47873,10982,2024-10-04 19:44:45,0,0,0,0,0,0
3,2673446010,201392388,47873,27791,2024-10-04 19:44:45,0,0,0,0,0,0
2,2673446010,201392387,47873,22225,2024-10-04 19:44:46,0,0,0,0,0,0
1,2673446010,201392386,47873,40087,2024-10-04 19:44:46,0,0,0,0,0,0
3,2673446010,201392388,47873,33466,2024-10-04 19:44:46,0,0,0,0,0,0
3,2673446010,201392388,47873,10982,2024-10-04 19:44:46,0,0,0,0,0,0
3,2673446010,201392388,47873,27791,2024-10-04 19:44:46,0,0,0,0,0,0
1,2673446010,201392386,47873,40087,2024-10-04 19:44:47,0,0,0,0,0,0
3,2673446010,201392388,47873,33466,2024-10-04 19:44:47,0,0,0,0,0,0
3,2673446010,201392388,47873,10982,2024-10-04 19:44:47,0,0,0,0,0,0
3,2673446010,201392388,47873,27791,2024-10-04 19:44:47,0,0,0,0,0,0
1,2673446010,201392386,47873,40087,2024-10-04 19:44:48,0,0,0,0,0,0
3,2673446010,201392388,47873,33466,2024-10-04 19:44:48,0,0,0,0,0,0
3,2673446010,201392388,47873,10982,2024-10-04 19:44:48,0,0,0,0,0,0
3,2673446010,201392388,47873,27791,2024-10-04 19:44:48,0,0,0,0,0,0
1,2673446010,201392386,47873,40087,2024-10-04 19:44:49,0,0,0,0,0,0
3,2673446010,201392388,47873,33466,2024-10-04 19:44:49,0,0,0,0,0,0
3,2673446010,201392388,47873,10982,2024-10-04 19:44:49,0,0,0,0,0,0
3,2673446010,201392388,47873,27791,2024-10-04 19:44:49,0,0,0,0,0,0
3,2673446010,201392388,47873,33466,2024-10-04 19:44:50,0,0,0,0,0,0
3,2673446010,201392388,47873,10982,2024-10-04 19:44:50,0,0,0,0,0,0
3,2673446010,201392388,47873,27791,2024-10-04 19:44:50,0,0,0,0,0,0
3,2673446010,201392388,47873,33466,2024-10-04 19:44:51,0,0,0,0,0,0
3,2673446010,201392388,47873,10982,2024-10-04 19:44:51,0,0,0,0,0,0
3,2673446010,201392388,47873,27791,2024-10-04 19:44:51,0,0,0,0,0,0
3,2673446010,201392388,47873,33466,2024-10-04 19:44:52,0,0,0,0,0,0
3,2673446010,201392388,47873,10982,2024-10-04 19:44:52,0,0,0,0,0,0
3,2673446010,201392388,47873,27791,2024-10-04 19:44:52,0,0,0,0,0,0
3,2673446010,201392388,47873,33466,2024-10-04 19:44:53,0,0,0,0,0,0
3,2673446010,201392388,47873,10982,2024-10-04 19:44:53,0,0,0,0,0,0
3,2673446010,201392388,47873,27791,2024-10-04 19:44:53,0,0,0,0,0,0
3,2673446010,201392388,47873,33466,2024-10-04 19:44:54,0,0,0,0,0,0
3,2673446010,201392388,47873,10982,2024-10-04 19:44:54,0,0,0,0,0,0
3,2673446010,201392388,47873,27791,2024-10-04 19:44:54,0,0,0,0,0,0
3,2673446010,201392388,47873,33466,2024-10-04 19:44:55,0,0,0,0,0,0
3,2673446010,201392388,47873,10982,2024-10-04 19:44:55,0,0,0,0,0,0
3,2673446010,201392388,47873,27791,2024-10-04 19:44:55,0,0,0,0,0,0
3,2673446010,201392388,47873,33466,2024-10-04 19:44:56,0,0,0,0,0,0
3,2673446010,201392388,47873,10982,2024-10-04 19:44:56,0,0,0,0,0,0
3,2673446010,201392388,47873,27791,2024-10-04 19:44:56,0,0,0,0,0,0
3,2673446010,201392388,47873,33466,2024-10-04 19:44:57,0,0,0,0,0,0
3,2673446010,201392388,47873,10982,2024-10-04 19:44:57,0,0,0,0,0,0
3,2673446010,201392388,47873,27791,2024-10-04 19:44:57,0,0,0,0,0,0
3,2673446010,201392388,47873,33466,2024-10-04 19:44:58,0,0,0,0,0,0
3,2673446010,201392388,47873,10982,2024-10-04 19:44:58,0,0,0,0,0,0
3,2673446010,201392388,47873,27791,2024-10-04 19:44:58,0,0,0,0,0,0
3,2673446010,201392388,47873,33466,2024-10-04 19:44:59,0,0,0,0,0,0
3,2673446010,201392388,47873,10982,2024-10-04 19:44:59,0,0,0,0,0,0
3,2673446010,201392388,47873,27791,2024-10-04 19:44:59,0,0,0,0,0,0
3,2673446010,201392388,47873,33466,2024-10-04 19:45:00,0,0,0,0,0,0
3,2673446010,201392388,47873,10982,2024-10-04 19:45:00,0,0,0,0,0,0
3,2673446010,201392388,47873,27791,2024-10-04 19:45:00,0,0,0,0,0,0
3,2673446010,201392388,47873,33466,2024-10-04 19:45:01,0,0,0,0,0,0
3,2673446010,201392388,47873,10982,2024-10-04 19:45:01,0,0,0,0,0,0
3,2673446010,201392388,47873,27791,2024-10-04 19:45:01,0,0,0,0,0,0
3,2673446010,201392388,47873,33466,2024-10-04 19:45:02,0,0,0,0,0,0
3,2673446010,201392388,47873,10982,2024-10-04 19:45:02,0,0,0,0,0,0
3,2673446010,201392388,47873,27791,2024-10-04 19:45:02,0,0,0,0,0,0
3,2673446010,201392388,47873,33466,2024-10-04 19:45:03,0,0,0,0,0,0
3,2673446010,201392388,47873,10982,2024-10-04 19:45:03,0,0,0,0,0,0
3,2673446010,201392388,47873,27791,2024-10-04 19:45:03,0,0,0,0,0,0
3,2673446010,201392388,47873,33466,2024-10-04 19:45:04,0,0,0,0,0,0
3,2673446010,201392388,47873,10982,2024-10-04 19:45:04,0,0,0,0,0,0
3,2673446010,201392388,47873,27791,2024-10-04 19:45:04,0,0,0,0,0,0
3,2673446010,201392388,47873,33466,2024-10-04 19:45:05,0,0,0,0,0,0
3,2673446010,201392388,47873,10982,2024-10-04 19:45:05,0,0,0,0,0,0
3,2673446010,201392388,47873,27791,2024-10-04 19:45:05,0,0,0,0,0,0
3,2673446010,201392388,47873,33466,2024-10-04 19:45:06,0,0,0,0,0,0
3,2673446010,201392388,47873,10982,2024-10-04 19:45:06,0,0,0,0,0,0
3,2673446010,201392388,47873,27791,2024-10-04 19:45:06,0,0,0,0,0,0
3,2673446010,201392388,47873,33466,2024-10-04 19:45:07,0,0,0,0,0,0
3,2673446010,201392388,47873,10982,2024-10-04 19:45:07,0,0,0,0,0,0
3,2673446010,201392388,47873,27791,2024-10-04 19:45:07,0,0,0,0,0,0
3,2673446010,201392388,47873,212,2024-10-04 19:45:08,4795,921,5716,5,4,9
3,2673446010,201392388,47873,33466,2024-10-04 19:45:08,0,0,0,0,0,0
3,2673446010,201392388,47873,10982,2024-10-04 19:45:08,0,0,0,0,0,0
3,2673446010,201392388,47873,27791,2024-10-04 19:45:08,0,0,0,0,0,0
3,2673446010,201392388,47873,212,2024-10-04 19:45:09,6296,1769,8065,10,15,25
3,2673446010,201392388,47873,33466,2024-10-04 19:45:09,0,0,0,0,0,0
3,2673446010,201392388,47873,10982,2024-10-04 19:45:09,0,0,0,0,0,0
3,2673446010,201392388,47873,27791,2024-10-04 19:45:09,0,0,0,0,0,0
3,2673446010,201392388,47873,212,2024-10-04 19:45:10,0,0,0,0,0,0
3,2673446010,201392388,47873,33466,2024-10-04 19:45:10,0,0,0,0,0,0
3,2673446010,201392388,47873,10982,2024-10-04 19:45:10,0,0,0,0,0,0
3,2673446010,201392388,47873,27791,2024-10-04 19:45:10,0,0,0,0,0,0
2,2673446010,201392387,47873,60608,2024-10-04 19:45:11,0,104,104,0,1,1
3,2673446010,201392388,47873,212,2024-10-04 19:45:11,0,0,0,0,0,0
3,2673446010,201392388,47873,33466,2024-10-04 19:45:11,0,0,0,0,0,0
3,2673446010,201392388,47873,10982,2024-10-04 19:45:11,0,0,0,0,0,0
3,2673446010,201392388,47873,27791,2024-10-04 19:45:11,0,0,0,0,0,0
2,2673446010,201392387,47873,60608,2024-10-04 19:45:12,9096,2490,11586,14,17,31
1,2673446010,201392386,47873,24299,2024-10-04 19:45:12,4794,921,5715,5,4,9
3,2673446010,201392388,47873,212,2024-10-04 19:45:12,0,0,0,0,0,0
3,2673446010,201392388,47873,33466,2024-10-04 19:45:12,0,0,0,0,0,0
3,2673446010,201392388,47873,10982,2024-10-04 19:45:12,0,0,0,0,0,0
3,2673446010,201392388,47873,27791,2024-10-04 19:45:12,0,0,0,0,0,0
2,2673446010,201392387,47873,60608,2024-10-04 19:45:13,0,0,0,0,0,0
1,2673446010,201392386,47873,24299,2024-10-04 19:45:13,0,0,0,0,0,0
3,2673446010,201392388,47873,212,2024-10-04 19:45:13,0,0,0,0,0,0
3,2673446010,201392388,47873,33466,2024-10-04 19:45:13,0,0,0,0,0,0
3,2673446010,201392388,47873,10982,2024-10-04 19:45:13,0,0,0,0,0,0
3,2673446010,201392388,47873,27791,2024-10-04 19:45:13,0,0,0,0,0,0
2,2673446010,201392387,47873,60608,2024-10-04 19:45:14,0,0,0,0,0,0
1,2673446010,201392386,47873,24299,2024-10-04 19:45:14,6350,1769,8119,9,15,24
3,2673446010,201392388,47873,212,2024-10-04 19:45:14,0,0,0,0,0,0
3,2673446010,201392388,47873,33466,2024-10-04 19:45:14,0,0,0,0,0,0
3,2673446010,201392388,47873,27791,2024-10-04 19:45:14,0,0,0,0,0,0
2,2673446010,201392387,47873,60608,2024-10-04 19:45:15,0,0,0,0,0,0
1,2673446010,201392386,47873,24299,2024-10-04 19:45:15,0,0,0,0,0,0
3,2673446010,201392388,47873,212,2024-10-04 19:45:15,0,0,0,0,0,0
3,2673446010,201392388,47873,33466,2024-10-04 19:45:15,0,0,0,0,0,0
3,2673446010,201392388,47873,27791,2024-10-04 19:45:15,0,0,0,0,0,0
2,2673446010,201392387,47873,60608,2024-10-04 19:45:16,0,0,0,0,0,0
1,2673446010,201392386,47873,24299,2024-10-04 19:45:16,0,0,0,0,0,0
3,2673446010,201392388,47873,212,2024-10-04 19:45:16,0,0,0,0,0,0
3,2673446010,201392388,47873,33466,2024-10-04 19:45:16,0,0,0,0,0,0
3,2673446010,201392388,47873,27791,2024-10-04 19:45:16,0,0,0,0,0,0
2,2673446010,201392387,47873,60608,2024-10-04 19:45:17,0,0,0,0,0,0
1,2673446010,201392386,47873,24299,2024-10-04 19:45:17,0,0,0,0,0,0
3,2673446010,201392388,47873,212,2024-10-04 19:45:17,0,0,0,0,0,0
3,2673446010,201392388,47873,33466,2024-10-04 19:45:17,0,0,0,0,0,0
3,2673446010,201392388,47873,27791,2024-10-04 19:45:17,0,0,0,0,0,0
2,2673446010,201392387,47873,60608,2024-10-04 19:45:18,0,0,0,0,0,0
1,2673446010,201392386,47873,24299,2024-10-04 19:45:18,0,0,0,0,0,0
3,2673446010,201392388,47873,212,2024-10-04 19:45:18,0,0,0,0,0,0
3,2673446010,201392388,47873,33466,2024-10-04 19:45:18,0,0,0,0,0,0
3,2673446010,201392388,47873,27791,2024-10-04 19:45:18,0,0,0,0,0,0
2,2673446010,201392387,47873,60608,2024-10-04 19:45:19,0,0,0,0,0,0
1,2673446010,201392386,47873,24299,2024-10-04 19:45:19,0,0,0,0,0,0
3,2673446010,201392388,47873,212,2024-10-04 19:45:19,0,0,0,0,0,0
3,2673446010,201392388,47873,33466,2024-10-04 19:45:19,0,0,0,0,0,0
3,2673446010,201392388,47873,27791,2024-10-04 19:45:19,0,0,0,0,0,0
2,2673446010,201392387,47873,60608,2024-10-04 19:45:20,0,0,0,0,0,0
1,2673446010,201392386,47873,24299,2024-10-04 19:45:20,0,0,0,0,0,0
3,2673446010,201392388,47873,212,2024-10-04 19:45:20,0,0,0,0,0,0
3,2673446010,201392388,47873,33466,2024-10-04 19:45:20,0,0,0,0,0,0
3,2673446010,201392388,47873,27791,2024-10-04 19:45:20,0,0,0,0,0,0
2,2673446010,201392387,47873,60608,2024-10-04 19:45:21,0,0,0,0,0,0
1,2673446010,201392386,47873,24299,2024-10-04 19:45:21,0,0,0,0,0,0
3,2673446010,201392388,47873,212,2024-10-04 19:45:21,0,0,0,0,0,0
3,2673446010,201392388,47873,33466,2024-10-04 19:45:21,0,0,0,0,0,0
3,2673446010,201392388,47873,27791,2024-10-04 19:45:21,0,0,0,0,0,0
2,2673446010,201392387,47873,60608,2024-10-04 19:45:22,0,0,0,0,0,0
3,2673446010,201392388,47873,212,2024-10-04 19:45:22,0,0,0,0,0,0
3,2673446010,201392388,47873,33466,2024-10-04 19:45:22,0,0,0,0,0,0
3,2673446010,201392388,47873,27791,2024-10-04 19:45:22,0,0,0,0,0,0
2,2673446010,201392387,47873,60608,2024-10-04 19:45:23,0,0,0,0,0,0
3,2673446010,201392388,47873,212,2024-10-04 19:45:23,0,0,0,0,0,0
3,2673446010,201392388,47873,33466,2024-10-04 19:45:23,0,0,0,0,0,0
3,2673446010,201392388,47873,27791,2024-10-04 19:45:23,0,0,0,0,0,0
2,2673446010,201392387,47873,60608,2024-10-04 19:45:24,0,0,0,0,0,0
3,2673446010,201392388,47873,212,2024-10-04 19:45:24,0,0,0,0,0,0
3,2673446010,201392388,47873,33466,2024-10-04 19:45:24,0,0,0,0,0,0
3,2673446010,201392388,47873,27791,2024-10-04 19:45:24,0,0,0,0,0,0
2,2673446010,201392387,47873,60608,2024-10-04 19:45:25,0,0,0,0,0,0
3,2673446010,201392388,47873,212,2024-10-04 19:45:25,0,0,0,0,0,0
3,2673446010,201392388,47873,33466,2024-10-04 19:45:25,0,0,0,0,0,0
3,2673446010,201392388,47873,27791,2024-10-04 19:45:25,0,0,0,0,0,0
2,2673446010,201392387,47873,60608,2024-10-04 19:45:26,0,0,0,0,0,0
3,2673446010,201392388,47873,212,2024-10-04 19:45:26,0,0,0,0,0,0
3,2673446010,201392388,47873,33466,2024-10-04 19:45:26,0,0,0,0,0,0
3,2673446010,201392388,47873,27791,2024-10-04 19:45:26,0,0,0,0,0,0
2,2673446010,201392387,47873,60608,2024-10-04 19:45:27,0,0,0,0,0,0
3,2673446010,201392388,47873,212,2024-10-04 19:45:27,0,0,0,0,0,0
3,2673446010,201392388,47873,33466,2024-10-04 19:45:27,0,0,0,0,0,0
3,2673446010,201392388,47873,27791,2024-10-04 19:45:27,0,0,0,0,0,0
2,2673446010,201392387,47873,60608,2024-10-04 19:45:28,0,0,0,0,0,0
3,2673446010,201392388,47873,212,2024-10-04 19:45:28,0,0,0,0,0,0
3,2673446010,201392388,47873,33466,2024-10-04 19:45:28,0,0,0,0,0,0
3,2673446010,201392388,47873,27791,2024-10-04 19:45:28,0,0,0,0,0,0
2,2673446010,201392387,47873,60608,2024-10-04 19:45:29,0,0,0,0,0,0
3,2673446010,201392388,47873,212,2024-10-04 19:45:29,0,0,0,0,0,0
3,2673446010,201392388,47873,33466,2024-10-04 19:45:29,0,0,0,0,0,0
3,2673446010,201392388,47873,27791,2024-10-04 19:45:29,0,0,0,0,0,0
2,2673446010,201392387,47873,60608,2024-10-04 19:45:30,0,0,0,0,0,0
3,2673446010,201392388,47873,212,2024-10-04 19:45:30,0,0,0,0,0,0
3,2673446010,201392388,47873,33466,2024-10-04 19:45:30,0,0,0,0,0,0
3,2673446010,201392388,47873,27791,2024-10-04 19:45:30,0,0,0,0,0,0
2,2673446010,201392387,47873,60608,2024-10-04 19:45:31,0,0,0,0,0,0
3,2673446010,201392388,47873,212,2024-10-04 19:45:31,0,0,0,0,0,0
3,2673446010,201392388,47873,33466,2024-10-04 19:45:31,0,0,0,0,0,0
3,2673446010,201392388,47873,27791,2024-10-04 19:45:31,0,0,0,0,0,0
2,2673446010,201392387,47873,60608,2024-10-04 19:45:32,0,0,0,0,0,0
3,2673446010,201392388,47873,212,2024-10-04 19:45:32,0,0,0,0,0,0
3,2673446010,201392388,47873,33466,2024-10-04 19:45:32,0,0,0,0,0,0
3,2673446010,201392388,47873,27791,2024-10-04 19:45:32,0,0,0,0,0,0
2,2673446010,201392387,47873,60608,2024-10-04 19:45:33,0,0,0,0,0,0
3,2673446010,201392388,47873,212,2024-10-04 19:45:33,0,0,0,0,0,0
3,2673446010,201392388,47873,33466,2024-10-04 19:45:33,0,0,0,0,0,0
3,2673446010,201392388,47873,27791,2024-10-04 19:45:33,0,0,0,0,0,0
2,2673446010,201392387,47873,60608,2024-10-04 19:45:34,0,0,0,0,0,0
3,2673446010,201392388,47873,212,2024-10-04 19:45:34,0,0,0,0,0,0
3,2673446010,201392388,47873,33466,2024-10-04 19:45:34,0,0,0,0,0,0
3,2673446010,201392388,47873,27791,2024-10-04 19:45:34,0,0,0,0,0,0
2,2673446010,201392387,47873,60608,2024-10-04 19:45:35,0,0,0,0,0,0
3,2673446010,201392388,47873,212,2024-10-04 19:45:35,0,0,0,0,0,0
3,2673446010,201392388,47873,33466,2024-10-04 19:45:35,0,0,0,0,0,0
3,2673446010,201392388,47873,27791,2024-10-04 19:45:35,0,0,0,0,0,0
2,2673446010,201392387,47873,60608,2024-10-04 19:45:36,0,0,0,0,0,0
3,2673446010,201392388,47873,212,2024-10-04 19:45:36,0,0,0,0,0,0
3,2673446010,201392388,47873,33466,2024-10-04 19:45:36,0,0,0,0,0,0
3,2673446010,201392388,47873,27791,2024-10-04 19:45:36,0,0,0,0,0,0
2,2673446010,201392387,47873,60608,2024-10-04 19:45:37,0,0,0,0,0,0
3,2673446010,201392388,47873,212,2024-10-04 19:45:37,0,0,0,0,0,0
3,2673446010,201392388,47873,33466,2024-10-04 19:45:37,0,0,0,0,0,0
3,2673446010,201392388,47873,27791,2024-10-04 19:45:37,0,0,0,0,0,0
2,2673446010,201392387,47873,60608,2024-10-04 19:45:38,0,0,0,0,0,0
3,2673446010,201392388,47873,45795,2024-10-04 19:45:38,4793,921,5714,5,4,9
3,2673446010,201392388,47873,212,2024-10-04 19:45:38,0,0,0,0,0,0
3,2673446010,201392388,47873,33466,2024-10-04 19:45:38,0,0,0,0,0,0
3,2673446010,201392388,47873,27791,2024-10-04 19:45:38,0,0,0,0,0,0
2,2673446010,201392387,47873,60608,2024-10-04 19:45:39,0,0,0,0,0,0
3,2673446010,201392388,47873,45795,2024-10-04 19:45:39,6357,1757,8114,9,15,24
3,2673446010,201392388,47873,212,2024-10-04 19:45:39,0,0,0,0,0,0
3,2673446010,201392388,47873,33466,2024-10-04 19:45:39,0,0,0,0,0,0
3,2673446010,201392388,47873,27791,2024-10-04 19:45:39,0,0,0,0,0,0
2,2673446010,201392387,47873,60608,2024-10-04 19:45:40,0,0,0,0,0,0
3,2673446010,201392388,47873,45795,2024-10-04 19:45:40,0,0,0,0,0,0
3,2673446010,201392388,47873,212,2024-10-04 19:45:40,0,0,0,0,0,0
3,2673446010,201392388,47873,33466,2024-10-04 19:45:40,0,0,0,0,0,0
3,2673446010,201392388,47873,27791,2024-10-04 19:45:40,0,0,0,0,0,0
2,2673446010,201392387,47873,60608,2024-10-04 19:45:41,0,0,0,0,0,0
3,2673446010,201392388,47873,45795,2024-10-04 19:45:41,0,0,0,0,0,0
3,2673446010,201392388,47873,212,2024-10-04 19:45:41,0,0,0,0,0,0
3,2673446010,201392388,47873,33466,2024-10-04 19:45:41,0,0,0,0,0,0
3,2673446010,201392388,47873,27791,2024-10-04 19:45:41,0,0,0,0,0,0
2,2673446010,201392387,47873,60608,2024-10-04 19:45:42,0,0,0,0,0,0
3,2673446010,201392388,47873,45795,2024-10-04 19:45:42,0,0,0,0,0,0
3,2673446010,201392388,47873,212,2024-10-04 19:45:42,0,0,0,0,0,0
3,2673446010,201392388,47873,33466,2024-10-04 19:45:42,0,0,0,0,0,0
2,2673446010,201392387,47873,43669,2024-10-04 19:45:42,60,104,164,1,1,2
3,2673446010,201392388,47873,27791,2024-10-04 19:45:42,0,0,0,0,0,0
1,2673446010,201392386,47873,20168,2024-10-04 19:45:43,3373,813,4186,4,3,7
3,2673446010,201392388,47873,45795,2024-10-04 19:45:43,0,0,0,0,0,0
3,2673446010,201392388,47873,212,2024-10-04 19:45:43,0,0,0,0,0,0
3,2673446010,201392388,47873,33466,2024-10-04 19:45:43,0,0,0,0,0,0
2,2673446010,201392387,47873,43669,2024-10-04 19:45:43,11083,2490,13573,13,17,30
3,2673446010,201392388,47873,27791,2024-10-04 19:45:43,0,0,0,0,0,0
1,2673446010,201392386,47873,20168,2024-10-04 19:45:44,0,0,0,0,0,0
3,2673446010,201392388,47873,45795,2024-10-04 19:45:44,0,0,0,0,0,0
3,2673446010,201392388,47873,212,2024-10-04 19:45:44,0,0,0,0,0,0
3,2673446010,201392388,47873,33466,2024-10-04 19:45:44,0,0,0,0,0,0
2,2673446010,201392387,47873,43669,2024-10-04 19:45:44,0,0,0,0,0,0
3,2673446010,201392388,47873,27791,2024-10-04 19:45:44,0,0,0,0,0,0
1,2673446010,201392386,47873,20168,2024-10-04 19:45:45,5738,1565,7303,9,13,22
3,2673446010,201392388,47873,45795,2024-10-04 19:45:45,0,0,0,0,0,0
3,2673446010,201392388,47873,33466,2024-10-04 19:45:45,0,0,0,0,0,0
2,2673446010,201392387,47873,43669,2024-10-04 19:45:45,0,0,0,0,0,0
3,2673446010,201392388,47873,27791,2024-10-04 19:45:45,0,0,0,0,0,0
1,2673446010,201392386,47873,20168,2024-10-04 19:45:46,0,0,0,0,0,0
3,2673446010,201392388,47873,45795,2024-10-04 19:45:46,0,0,0,0,0,0
3,2673446010,201392388,47873,33466,2024-10-04 19:45:46,0,0,0,0,0,0
2,2673446010,201392387,47873,43669,2024-10-04 19:45:46,0,0,0,0,0,0
3,2673446010,201392388,47873,27791,2024-10-04 19:45:46,0,0,0,0,0,0
1,2673446010,201392386,47873,20168,2024-10-04 19:45:47,0,0,0,0,0,0
3,2673446010,201392388,47873,45795,2024-10-04 19:45:47,0,0,0,0,0,0
3,2673446010,201392388,47873,33466,2024-10-04 19:45:47,0,0,0,0,0,0
2,2673446010,201392387,47873,43669,2024-10-04 19:45:47,0,0,0,0,0,0
3,2673446010,201392388,47873,27791,2024-10-04 19:45:47,0,0,0,0,0,0
1,2673446010,201392386,47873,20168,2024-10-04 19:45:48,0,0,0,0,0,0
3,2673446010,201392388,47873,45795,2024-10-04 19:45:48,0,0,0,0,0,0
3,2673446010,201392388,47873,33466,2024-10-04 19:45:48,0,0,0,0,0,0
2,2673446010,201392387,47873,43669,2024-10-04 19:45:48,0,0,0,0,0,0
3,2673446010,201392388,47873,27791,2024-10-04 19:45:48,0,0,0,0,0,0
1,2673446010,201392386,47873,20168,2024-10-04 19:45:49,0,0,0,0,0,0
3,2673446010,201392388,47873,45795,2024-10-04 19:45:49,0,0,0,0,0,0
3,2673446010,201392388,47873,33466,2024-10-04 19:45:49,0,0,0,0,0,0
2,2673446010,201392387,47873,43669,2024-10-04 19:45:49,0,0,0,0,0,0
3,2673446010,201392388,47873,27791,2024-10-04 19:45:49,0,0,0,0,0,0
1,2673446010,201392386,47873,20168,2024-10-04 19:45:50,0,0,0,0,0,0
3,2673446010,201392388,47873,45795,2024-10-04 19:45:50,0,0,0,0,0,0
3,2673446010,201392388,47873,33466,2024-10-04 19:45:50,0,0,0,0,0,0
2,2673446010,201392387,47873,43669,2024-10-04 19:45:50,0,0,0,0,0,0
3,2673446010,201392388,47873,27791,2024-10-04 19:45:50,0,0,0,0,0,0
1,2673446010,201392386,47873,20168,2024-10-04 19:45:51,0,0,0,0,0,0
3,2673446010,201392388,47873,45795,2024-10-04 19:45:51,0,0,0,0,0,0
3,2673446010,201392388,47873,33466,2024-10-04 19:45:51,0,0,0,0,0,0
2,2673446010,201392387,47873,43669,2024-10-04 19:45:51,0,0,0,0,0,0
3,2673446010,201392388,47873,27791,2024-10-04 19:45:51,0,0,0,0,0,0
1,2673446010,201392386,47873,20168,2024-10-04 19:45:52,0,0,0,0,0,0
3,2673446010,201392388,47873,45795,2024-10-04 19:45:52,0,0,0,0,0,0
3,2673446010,201392388,47873,33466,2024-10-04 19:45:52,0,0,0,0,0,0
2,2673446010,201392387,47873,43669,2024-10-04 19:45:52,0,0,0,0,0,0
3,2673446010,201392388,47873,27791,2024-10-04 19:45:52,0,0,0,0,0,0
3,2673446010,201392388,47873,45795,2024-10-04 19:45:53,0,0,0,0,0,0
3,2673446010,201392388,47873,33466,2024-10-04 19:45:53,0,0,0,0,0,0
2,2673446010,201392387,47873,43669,2024-10-04 19:45:53,0,0,0,0,0,0
3,2673446010,201392388,47873,27791,2024-10-04 19:45:53,0,0,0,0,0,0
3,2673446010,201392388,47873,45795,2024-10-04 19:45:54,0,0,0,0,0,0
3,2673446010,201392388,47873,33466,2024-10-04 19:45:54,0,0,0,0,0,0
2,2673446010,201392387,47873,43669,2024-10-04 19:45:54,0,0,0,0,0,0
3,2673446010,201392388,47873,27791,2024-10-04 19:45:54,0,0,0,0,0,0
3,2673446010,201392388,47873,45795,2024-10-04 19:45:55,0,0,0,0,0,0
3,2673446010,201392388,47873,33466,2024-10-04 19:45:55,0,0,0,0,0,0
2,2673446010,201392387,47873,43669,2024-10-04 19:45:55,0,0,0,0,0,0
3,2673446010,201392388,47873,27791,2024-10-04 19:45:55,0,0,0,0,0,0
3,2673446010,201392388,47873,45795,2024-10-04 19:45:56,0,0,0,0,0,0
3,2673446010,201392388,47873,33466,2024-10-04 19:45:56,0,0,0,0,0,0
2,2673446010,201392387,47873,43669,2024-10-04 19:45:56,0,0,0,0,0,0
3,2673446010,201392388,47873,27791,2024-10-04 19:45:56,0,0,0,0,0,0
3,2673446010,201392388,47873,45795,2024-10-04 19:45:57,0,0,0,0,0,0
3,2673446010,201392388,47873,33466,2024-10-04 19:45:57,0,0,0,0,0,0
2,2673446010,201392387,47873,43669,2024-10-04 19:45:57,0,0,0,0,0,0
3,2673446010,201392388,47873,27791,2024-10-04 19:45:57,0,0,0,0,0,0
3,2673446010,201392388,47873,45795,2024-10-04 19:45:58,0,0,0,0,0,0
3,2673446010,201392388,47873,33466,2024-10-04 19:45:58,0,0,0,0,0,0
2,2673446010,201392387,47873,43669,2024-10-04 19:45:58,0,0,0,0,0,0
3,2673446010,201392388,47873,27791,2024-10-04 19:45:58,0,0,0,0,0,0
3,2673446010,201392388,47873,45795,2024-10-04 19:45:59,0,0,0,0,0,0
3,2673446010,201392388,47873,33466,2024-10-04 19:45:59,0,0,0,0,0,0
2,2673446010,201392387,47873,43669,2024-10-04 19:45:59,0,0,0,0,0,0
3,2673446010,201392388,47873,27791,2024-10-04 19:45:59,0,0,0,0,0,0
3,2673446010,201392388,47873,45795,2024-10-04 19:46:00,0,0,0,0,0,0
3,2673446010,201392388,47873,33466,2024-10-04 19:46:00,0,0,0,0,0,0
2,2673446010,201392387,47873,43669,2024-10-04 19:46:00,0,0,0,0,0,0
3,2673446010,201392388,47873,27791,2024-10-04 19:46:00,0,0,0,0,0,0
3,2673446010,201392388,47873,45795,2024-10-04 19:46:01,0,0,0,0,0,0
3,2673446010,201392388,47873,33466,2024-10-04 19:46:01,0,0,0,0,0,0
2,2673446010,201392387,47873,43669,2024-10-04 19:46:01,0,0,0,0,0,0
3,2673446010,201392388,47873,27791,2024-10-04 19:46:01,0,0,0,0,0,0
3,2673446010,201392388,47873,45795,2024-10-04 19:46:02,0,0,0,0,0,0
3,2673446010,201392388,47873,33466,2024-10-04 19:46:02,0,0,0,0,0,0
2,2673446010,201392387,47873,43669,2024-10-04 19:46:02,0,0,0,0,0,0
3,2673446010,201392388,47873,27791,2024-10-04 19:46:02,0,0,0,0,0,0
3,2673446010,201392388,47873,45795,2024-10-04 19:46:03,0,0,0,0,0,0
3,2673446010,201392388,47873,33466,2024-10-04 19:46:03,0,0,0,0,0,0
2,2673446010,201392387,47873,43669,2024-10-04 19:46:03,0,0,0,0,0,0
3,2673446010,201392388,47873,27791,2024-10-04 19:46:03,0,0,0,0,0,0
3,2673446010,201392388,47873,45795,2024-10-04 19:46:04,0,0,0,0,0,0
3,2673446010,201392388,47873,33466,2024-10-04 19:46:04,0,0,0,0,0,0
2,2673446010,201392387,47873,43669,2024-10-04 19:46:04,0,0,0,0,0,0
3,2673446010,201392388,47873,27791,2024-10-04 19:46:04,0,0,0,0,0,0
3,2673446010,201392388,47873,45795,2024-10-04 19:46:05,0,0,0,0,0,0
3,2673446010,201392388,47873,33466,2024-10-04 19:46:05,0,0,0,0,0,0
2,2673446010,201392387,47873,43669,2024-10-04 19:46:05,0,0,0,0,0,0
3,2673446010,201392388,47873,27791,2024-10-04 19:46:05,0,0,0,0,0,0
3,2673446010,201392388,47873,45795,2024-10-04 19:46:06,0,0,0,0,0,0
3,2673446010,201392388,47873,33466,2024-10-04 19:46:06,0,0,0,0,0,0
2,2673446010,201392387,47873,43669,2024-10-04 19:46:06,0,0,0,0,0,0
3,2673446010,201392388,47873,27791,2024-10-04 19:46:06,0,0,0,0,0,0
3,2673446010,201392388,47873,45795,2024-10-04 19:46:07,0,0,0,0,0,0
3,2673446010,201392388,47873,33466,2024-10-04 19:46:07,0,0,0,0,0,0
2,2673446010,201392387,47873,43669,2024-10-04 19:46:07,0,0,0,0,0,0
3,2673446010,201392388,47873,27791,2024-10-04 19:46:07,0,0,0,0,0,0
3,2673446010,201392388,47873,45795,2024-10-04 19:46:08,0,0,0,0,0,0
3,2673446010,201392388,47873,1184,2024-10-04 19:46:08,0,104,104,0,1,1
3,2673446010,201392388,47873,33466,2024-10-04 19:46:08,0,0,0,0,0,0
2,2673446010,201392387,47873,43669,2024-10-04 19:46:08,0,0,0,0,0,0
3,2673446010,201392388,47873,27791,2024-10-04 19:46:08,0,0,0,0,0,0
3,2673446010,201392388,47873,45795,2024-10-04 19:46:09,0,0,0,0,0,0
3,2673446010,201392388,47873,1184,2024-10-04 19:46:09,4953,1667,6620,7,9,16
3,2673446010,201392388,47873,33466,2024-10-04 19:46:09,0,0,0,0,0,0
2,2673446010,201392387,47873,43669,2024-10-04 19:46:09,0,0,0,0,0,0
3,2673446010,201392388,47873,27791,2024-10-04 19:46:09,0,0,0,0,0,0
3,2673446010,201392388,47873,45795,2024-10-04 19:46:10,0,0,0,0,0,0
3,2673446010,201392388,47873,1184,2024-10-04 19:46:10,4224,607,4831,7,6,13
3,2673446010,201392388,47873,33466,2024-10-04 19:46:10,0,0,0,0,0,0
2,2673446010,201392387,47873,43669,2024-10-04 19:46:10,0,0,0,0,0,0
3,2673446010,201392388,47873,27791,2024-10-04 19:46:10,0,0,0,0,0,0
3,2673446010,201392388,47873,45795,2024-10-04 19:46:11,0,0,0,0,0,0
3,2673446010,201392388,47873,1184,2024-10-04 19:46:11,0,0,0,0,0,0
3,2673446010,201392388,47873,33466,2024-10-04 19:46:11,0,0,0,0,0,0
2,2673446010,201392387,47873,43669,2024-10-04 19:46:11,0,0,0,0,0,0
3,2673446010,201392388,47873,27791,2024-10-04 19:46:11,0,0,0,0,0,0
3,2673446010,201392388,47873,45795,2024-10-04 19:46:12,0,0,0,0,0,0
3,2673446010,201392388,47873,1184,2024-10-04 19:46:12,0,0,0,0,0,0
3,2673446010,201392388,47873,33466,2024-10-04 19:46:12,0,0,0,0,0,0
2,2673446010,201392387,47873,43669,2024-10-04 19:46:12,0,0,0,0,0,0
3,2673446010,201392388,47873,27791,2024-10-04 19:46:12,0,0,0,0,0,0
3,2673446010,201392388,47873,45795,2024-10-04 19:46:13,0,0,0,0,0,0
3,2673446010,201392388,47873,1184,2024-10-04 19:46:13,0,0,0,0,0,0
3,2673446010,201392388,47873,33466,2024-10-04 19:46:13,0,0,0,0,0,0
2,2673446010,201392387,47873,43669,2024-10-04 19:46:13,0,0,0,0,0,0
3,2673446010,201392388,47873,27791,2024-10-04 19:46:13,0,0,0,0,0,0
1,2673446010,201392386,47873,50352,2024-10-04 19:46:14,0,104,104,0,1,1
3,2673446010,201392388,47873,45795,2024-10-04 19:46:14,0,0,0,0,0,0
3,2673446010,201392388,47873,1184,2024-10-04 19:46:14,0,0,0,0,0,0
3,2673446010,201392388,47873,33466,2024-10-04 19:46:14,0,0,0,0,0,0
2,2673446010,201392387,47873,43669,2024-10-04 19:46:14,0,0,0,0,0,0
3,2673446010,201392388,47873,27791,2024-10-04 19:46:14,0,0,0,0,0,0
1,2673446010,201392386,47873,50352,2024-10-04 19:46:15,9248,2574,11822,16,18,34
3,2673446010,201392388,47873,45795,2024-10-04 19:46:15,0,0,0,0,0,0
3,2673446010,201392388,47873,33466,2024-10-04 19:46:15,0,0,0,0,0,0
2,2673446010,201392387,47873,6361,2024-10-04 19:46:15,112,813,925,2,3,5
3,2673446010,201392388,47873,27791,2024-10-04 19:46:15,0,0,0,0,0,0
1,2673446010,201392386,47873,50352,2024-10-04 19:46:16,0,0,0,0,0,0
3,2673446010,201392388,47873,45795,2024-10-04 19:46:16,0,0,0,0,0,0
3,2673446010,201392388,47873,33466,2024-10-04 19:46:16,0,0,0,0,0,0
2,2673446010,201392387,47873,6361,2024-10-04 19:46:16,0,0,0,0,0,0
3,2673446010,201392388,47873,27791,2024-10-04 19:46:16,0,0,0,0,0,0
1,2673446010,201392386,47873,50352,2024-10-04 19:46:17,0,0,0,0,0,0
3,2673446010,201392388,47873,45795,2024-10-04 19:46:17,0,0,0,0,0,0
3,2673446010,201392388,47873,33466,2024-10-04 19:46:17,0,0,0,0,0,0
2,2673446010,201392387,47873,6361,2024-10-04 19:46:17,9076,1649,10725,12,14,26
3,2673446010,201392388,47873,27791,2024-10-04 19:46:17,0,0,0,0,0,0
1,2673446010,201392386,47873,50352,2024-10-04 19:46:18,0,0,0,0,0,0
3,2673446010,201392388,47873,45795,2024-10-04 19:46:18,0,0,0,0,0,0
3,2673446010,201392388,47873,33466,2024-10-04 19:46:18,0,0,0,0,0,0
2,2673446010,201392387,47873,6361,2024-10-04 19:46:18,0,0,0,0,0,0
3,2673446010,201392388,47873,27791,2024-10-04 19:46:18,0,0,0,0,0,0
1,2673446010,201392386,47873,50352,2024-10-04 19:46:19,0,0,0,0,0,0
3,2673446010,201392388,47873,45795,2024-10-04 19:46:19,0,0,0,0,0,0
3,2673446010,201392388,47873,33466,2024-10-04 19:46:19,0,0,0,0,0,0
2,2673446010,201392387,47873,6361,2024-10-04 19:46:19,0,0,0,0,0,0
3,2673446010,201392388,47873,27791,2024-10-04 19:46:19,0,0,0,0,0,0
1,2673446010,201392386,47873,50352,2024-10-04 19:46:20,0,0,0,0,0,0
3,2673446010,201392388,47873,45795,2024-10-04 19:46:20,0,0,0,0,0,0
3,2673446010,201392388,47873,33466,2024-10-04 19:46:20,0,0,0,0,0,0
2,2673446010,201392387,47873,6361,2024-10-04 19:46:20,0,0,0,0,0,0
3,2673446010,201392388,47873,27791,2024-10-04 19:46:20,0,0,0,0,0,0
1,2673446010,201392386,47873,50352,2024-10-04 19:46:21,0,0,0,0,0,0
3,2673446010,201392388,47873,45795,2024-10-04 19:46:21,0,0,0,0,0,0
3,2673446010,201392388,47873,33466,2024-10-04 19:46:21,0,0,0,0,0,0
2,2673446010,201392387,47873,6361,2024-10-04 19:46:21,0,0,0,0,0,0
3,2673446010,201392388,47873,27791,2024-10-04 19:46:21,0,0,0,0,0,0
1,2673446010,201392386,47873,50352,2024-10-04 19:46:22,0,0,0,0,0,0
3,2673446010,201392388,47873,45795,2024-10-04 19:46:22,0,0,0,0,0,0
3,2673446010,201392388,47873,33466,2024-10-04 19:46:22,0,0,0,0,0,0
2,2673446010,201392387,47873,6361,2024-10-04 19:46:22,0,0,0,0,0,0
3,2673446010,201392388,47873,27791,2024-10-04 19:46:22,0,0,0,0,0,0
1,2673446010,201392386,47873,50352,2024-10-04 19:46:23,0,0,0,0,0,0
3,2673446010,201392388,47873,45795,2024-10-04 19:46:23,0,0,0,0,0,0
3,2673446010,201392388,47873,33466,2024-10-04 19:46:23,0,0,0,0,0,0
2,2673446010,201392387,47873,6361,2024-10-04 19:46:23,0,0,0,0,0,0
3,2673446010,201392388,47873,27791,2024-10-04 19:46:23,0,0,0,0,0,0
1,2673446010,201392386,47873,50352,2024-10-04 19:46:24,0,0,0,0,0,0
3,2673446010,201392388,47873,45795,2024-10-04 19:46:24,0,0,0,0,0,0
3,2673446010,201392388,47873,33466,2024-10-04 19:46:24,0,0,0,0,0,0
2,2673446010,201392387,47873,6361,2024-10-04 19:46:24,0,0,0,0,0,0
3,2673446010,201392388,47873,27791,2024-10-04 19:46:24,0,0,0,0,0,0
1,2673446010,201392386,47873,50352,2024-10-04 19:46:25,0,0,0,0,0,0
3,2673446010,201392388,47873,45795,2024-10-04 19:46:25,0,0,0,0,0,0
3,2673446010,201392388,47873,33466,2024-10-04 19:46:25,0,0,0,0,0,0
3,2673446010,201392388,47873,27791,2024-10-04 19:46:25,0,0,0,0,0,0
1,2673446010,201392386,47873,50352,2024-10-04 19:46:26,0,0,0,0,0,0
3,2673446010,201392388,47873,45795,2024-10-04 19:46:26,0,0,0,0,0,0
3,2673446010,201392388,47873,33466,2024-10-04 19:46:26,0,0,0,0,0,0
3,2673446010,201392388,47873,27791,2024-10-04 19:46:26,0,0,0,0,0,0
1,2673446010,201392386,47873,50352,2024-10-04 19:46:27,0,0,0,0,0,0
3,2673446010,201392388,47873,45795,2024-10-04 19:46:27,0,0,0,0,0,0
3,2673446010,201392388,47873,33466,2024-10-04 19:46:27,0,0,0,0,0,0
3,2673446010,201392388,47873,27791,2024-10-04 19:46:27,0,0,0,0,0,0
1,2673446010,201392386,47873,50352,2024-10-04 19:46:28,0,0,0,0,0,0
3,2673446010,201392388,47873,45795,2024-10-04 19:46:28,0,0,0,0,0,0
3,2673446010,201392388,47873,33466,2024-10-04 19:46:28,0,0,0,0,0,0
3,2673446010,201392388,47873,27791,2024-10-04 19:46:28,0,0,0,0,0,0
1,2673446010,201392386,47873,50352,2024-10-04 19:46:29,0,0,0,0,0,0
3,2673446010,201392388,47873,45795,2024-10-04 19:46:29,0,0,0,0,0,0
3,2673446010,201392388,47873,33466,2024-10-04 19:46:29,0,0,0,0,0,0
3,2673446010,201392388,47873,27791,2024-10-04 19:46:29,0,0,0,0,0,0
1,2673446010,201392386,47873,50352,2024-10-04 19:46:30,0,0,0,0,0,0
3,2673446010,201392388,47873,45795,2024-10-04 19:46:30,0,0,0,0,0,0
3,2673446010,201392388,47873,33466,2024-10-04 19:46:30,0,0,0,0,0,0
3,2673446010,201392388,47873,27791,2024-10-04 19:46:30,0,0,0,0,0,0
1,2673446010,201392386,47873,50352,2024-10-04 19:46:31,0,0,0,0,0,0
3,2673446010,201392388,47873,45795,2024-10-04 19:46:31,0,0,0,0,0,0
3,2673446010,201392388,47873,33466,2024-10-04 19:46:31,0,0,0,0,0,0
3,2673446010,201392388,47873,27791,2024-10-04 19:46:31,0,0,0,0,0,0
1,2673446010,201392386,47873,50352,2024-10-04 19:46:32,0,0,0,0,0,0
3,2673446010,201392388,47873,45795,2024-10-04 19:46:32,0,0,0,0,0,0
3,2673446010,201392388,47873,33466,2024-10-04 19:46:32,0,0,0,0,0,0
3,2673446010,201392388,47873,27791,2024-10-04 19:46:32,0,0,0,0,0,0
1,2673446010,201392386,47873,50352,2024-10-04 19:46:33,0,0,0,0,0,0
3,2673446010,201392388,47873,45795,2024-10-04 19:46:33,0,0,0,0,0,0
3,2673446010,201392388,47873,33466,2024-10-04 19:46:33,0,0,0,0,0,0
3,2673446010,201392388,47873,27791,2024-10-04 19:46:33,0,0,0,0,0,0
1,2673446010,201392386,47873,50352,2024-10-04 19:46:34,0,0,0,0,0,0
3,2673446010,201392388,47873,45795,2024-10-04 19:46:34,0,0,0,0,0,0
3,2673446010,201392388,47873,33466,2024-10-04 19:46:34,0,0,0,0,0,0
3,2673446010,201392388,47873,27791,2024-10-04 19:46:34,0,0,0,0,0,0
1,2673446010,201392386,47873,50352,2024-10-04 19:46:35,0,0,0,0,0,0
3,2673446010,201392388,47873,45795,2024-10-04 19:46:35,0,0,0,0,0,0
3,2673446010,201392388,47873,33466,2024-10-04 19:46:35,0,0,0,0,0,0
3,2673446010,201392388,47873,27791,2024-10-04 19:46:35,0,0,0,0,0,0
1,2673446010,201392386,47873,50352,2024-10-04 19:46:36,0,0,0,0,0,0
3,2673446010,201392388,47873,45795,2024-10-04 19:46:36,0,0,0,0,0,0
3,2673446010,201392388,47873,33466,2024-10-04 19:46:36,0,0,0,0,0,0
3,2673446010,201392388,47873,27791,2024-10-04 19:46:36,0,0,0,0,0,0
1,2673446010,201392386,47873,50352,2024-10-04 19:46:37,0,0,0,0,0,0
3,2673446010,201392388,47873,45795,2024-10-04 19:46:37,0,0,0,0,0,0
3,2673446010,201392388,47873,33466,2024-10-04 19:46:37,0,0,0,0,0,0
3,2673446010,201392388,47873,27791,2024-10-04 19:46:37,0,0,0,0,0,0
1,2673446010,201392386,47873,50352,2024-10-04 19:46:38,0,0,0,0,0,0
3,2673446010,201392388,47873,45795,2024-10-04 19:46:38,0,0,0,0,0,0
3,2673446010,201392388,47873,33466,2024-10-04 19:46:38,0,0,0,0,0,0
3,2673446010,201392388,47873,27791,2024-10-04 19:46:38,0,0,0,0,0,0
1,2673446010,201392386,47873,50352,2024-10-04 19:46:39,0,0,0,0,0,0
3,2673446010,201392388,47873,45795,2024-10-04 19:46:39,0,0,0,0,0,0
3,2673446010,201392388,47873,33466,2024-10-04 19:46:39,0,0,0,0,0,0
3,2673446010,201392388,47873,27791,2024-10-04 19:46:39,0,0,0,0,0,0
1,2673446010,201392386,47873,50352,2024-10-04 19:46:40,0,0,0,0,0,0
3,2673446010,201392388,47873,45795,2024-10-04 19:46:40,0,0,0,0,0,0
3,2673446010,201392388,47873,33466,2024-10-04 19:46:40,0,0,0,0,0,0
3,2673446010,201392388,47873,39135,2024-10-04 19:46:40,112,813,925,2,3,5
3,2673446010,201392388,47873,27791,2024-10-04 19:46:40,0,0,0,0,0,0
1,2673446010,201392386,47873,50352,2024-10-04 19:46:41,0,0,0,0,0,0
3,2673446010,201392388,47873,45795,2024-10-04 19:46:41,0,0,0,0,0,0
3,2673446010,201392388,47873,33466,2024-10-04 19:46:41,0,0,0,0,0,0
3,2673446010,201392388,47873,39135,2024-10-04 19:46:41,0,0,0,0,0,0
3,2673446010,201392388,47873,27791,2024-10-04 19:46:41,0,0,0,0,0,0
1,2673446010,201392386,47873,50352,2024-10-04 19:46:42,0,0,0,0,0,0
3,2673446010,201392388,47873,45795,2024-10-04 19:46:42,0,0,0,0,0,0
3,2673446010,201392388,47873,33466,2024-10-04 19:46:42,0,0,0,0,0,0
3,2673446010,201392388,47873,39135,2024-10-04 19:46:42,9183,1661,10844,15,14,29
3,2673446010,201392388,47873,27791,2024-10-04 19:46:42,0,0,0,0,0,0
1,2673446010,201392386,47873,50352,2024-10-04 19:46:43,0,0,0,0,0,0
3,2673446010,201392388,47873,45795,2024-10-04 19:46:43,0,0,0,0,0,0
3,2673446010,201392388,47873,33466,2024-10-04 19:46:43,0,0,0,0,0,0
3,2673446010,201392388,47873,39135,2024-10-04 19:46:43,0,0,0,0,0,0
3,2673446010,201392388,47873,27791,2024-10-04 19:46:43,0,0,0,0,0,0
1,2673446010,201392386,47873,50352,2024-10-04 19:46:44,0,0,0,0,0,0
3,2673446010,201392388,47873,45795,2024-10-04 19:46:44,0,0,0,0,0,0
3,2673446010,201392388,47873,33466,2024-10-04 19:46:44,0,0,0,0,0,0
3,2673446010,201392388,47873,39135,2024-10-04 19:46:44,0,0,0,0,0,0
3,2673446010,201392388,47873,27791,2024-10-04 19:46:44,0,0,0,0,0,0
1,2673446010,201392386,47873,50352,2024-10-04 19:46:45,0,0,0,0,0,0
3,2673446010,201392388,47873,45795,2024-10-04 19:46:45,0,0,0,0,0,0
1,2673446010,201392386,47873,55957,2024-10-04 19:46:45,60,813,873,1,3,4
3,2673446010,201392388,47873,33466,2024-10-04 19:46:45,0,0,0,0,0,0
3,2673446010,201392388,47873,39135,2024-10-04 19:46:45,0,0,0,0,0,0
3,2673446010,201392388,47873,27791,2024-10-04 19:46:45,0,0,0,0,0,0
2,2673446010,201392387,47873,10395,2024-10-04 19:46:46,2866,1759,4625,5,10,15
3,2673446010,201392388,47873,45795,2024-10-04 19:46:46,0,0,0,0,0,0
1,2673446010,201392386,47873,55957,2024-10-04 19:46:46,11113,1865,12978,15,16,31
3,2673446010,201392388,47873,33466,2024-10-04 19:46:46,0,0,0,0,0,0
3,2673446010,201392388,47873,39135,2024-10-04 19:46:46,0,0,0,0,0,0
3,2673446010,201392388,47873,27791,2024-10-04 19:46:46,0,0,0,0,0,0
2,2673446010,201392387,47873,10395,2024-10-04 19:46:47,6559,1003,7562,13,10,23
3,2673446010,201392388,47873,45795,2024-10-04 19:46:47,0,0,0,0,0,0
1,2673446010,201392386,47873,55957,2024-10-04 19:46:47,0,0,0,0,0,0
3,2673446010,201392388,47873,33466,2024-10-04 19:46:47,0,0,0,0,0,0
3,2673446010,201392388,47873,27791,2024-10-04 19:46:47,0,0,0,0,0,0
2,2673446010,201392387,47873,10395,2024-10-04 19:46:48,0,0,0,0,0,0
3,2673446010,201392388,47873,45795,2024-10-04 19:46:48,0,0,0,0,0,0
1,2673446010,201392386,47873,55957,2024-10-04 19:46:48,0,0,0,0,0,0
3,2673446010,201392388,47873,33466,2024-10-04 19:46:48,0,0,0,0,0,0
3,2673446010,201392388,47873,27791,2024-10-04 19:46:48,0,0,0,0,0,0
2,2673446010,201392387,47873,10395,2024-10-04 19:46:49,0,0,0,0,0,0
3,2673446010,201392388,47873,45795,2024-10-04 19:46:49,0,0,0,0,0,0
1,2673446010,201392386,47873,55957,2024-10-04 19:46:49,0,0,0,0,0,0
3,2673446010,201392388,47873,33466,2024-10-04 19:46:49,0,0,0,0,0,0
3,2673446010,201392388,47873,27791,2024-10-04 19:46:49,0,0,0,0,0,0
2,2673446010,201392387,47873,10395,2024-10-04 19:46:50,0,0,0,0,0,0
3,2673446010,201392388,47873,45795,2024-10-04 19:46:50,0,0,0,0,0,0
1,2673446010,201392386,47873,55957,2024-10-04 19:46:50,0,0,0,0,0,0
3,2673446010,201392388,47873,33466,2024-10-04 19:46:50,0,0,0,0,0,0
3,2673446010,201392388,47873,27791,2024-10-04 19:46:50,0,0,0,0,0,0
2,2673446010,201392387,47873,10395,2024-10-04 19:46:51,0,0,0,0,0,0
3,2673446010,201392388,47873,45795,2024-10-04 19:46:51,0,0,0,0,0,0
1,2673446010,201392386,47873,55957,2024-10-04 19:46:51,0,0,0,0,0,0
3,2673446010,201392388,47873,33466,2024-10-04 19:46:51,0,0,0,0,0,0
3,2673446010,201392388,47873,27791,2024-10-04 19:46:51,0,0,0,0,0,0
2,2673446010,201392387,47873,10395,2024-10-04 19:46:52,0,0,0,0,0,0
3,2673446010,201392388,47873,45795,2024-10-04 19:46:52,0,0,0,0,0,0
1,2673446010,201392386,47873,55957,2024-10-04 19:46:52,0,0,0,0,0,0
3,2673446010,201392388,47873,33466,2024-10-04 19:46:52,0,0,0,0,0,0
3,2673446010,201392388,47873,27791,2024-10-04 19:46:52,0,0,0,0,0,0
2,2673446010,201392387,47873,10395,2024-10-04 19:46:53,0,0,0,0,0,0
3,2673446010,201392388,47873,45795,2024-10-04 19:46:53,0,0,0,0,0,0
1,2673446010,201392386,47873,55957,2024-10-04 19:46:53,0,0,0,0,0,0
3,2673446010,201392388,47873,33466,2024-10-04 19:46:53,0,0,0,0,0,0
3,2673446010,201392388,47873,27791,2024-10-04 19:46:53,0,0,0,0,0,0
2,2673446010,201392387,47873,10395,2024-10-04 19:46:54,0,0,0,0,0,0
3,2673446010,201392388,47873,45795,2024-10-04 19:46:54,0,0,0,0,0,0
1,2673446010,201392386,47873,55957,2024-10-04 19:46:54,0,0,0,0,0,0
3,2673446010,201392388,47873,33466,2024-10-04 19:46:54,0,0,0,0,0,0
3,2673446010,201392388,47873,27791,2024-10-04 19:46:54,0,0,0,0,0,0
3,2673446010,201392388,47873,45795,2024-10-04 19:46:55,0,0,0,0,0,0
1,2673446010,201392386,47873,55957,2024-10-04 19:46:55,0,0,0,0,0,0
3,2673446010,201392388,47873,33466,2024-10-04 19:46:55,0,0,0,0,0,0
3,2673446010,201392388,47873,27791,2024-10-04 19:46:55,0,0,0,0,0,0
3,2673446010,201392388,47873,45795,2024-10-04 19:46:56,0,0,0,0,0,0
1,2673446010,201392386,47873,55957,2024-10-04 19:46:56,0,0,0,0,0,0
3,2673446010,201392388,47873,33466,2024-10-04 19:46:56,0,0,0,0,0,0
3,2673446010,201392388,47873,27791,2024-10-04 19:46:56,0,0,0,0,0,0
3,2673446010,201392388,47873,45795,2024-10-04 19:46:57,0,0,0,0,0,0
1,2673446010,201392386,47873,55957,2024-10-04 19:46:57,0,0,0,0,0,0
3,2673446010,201392388,47873,33466,2024-10-04 19:46:57,0,0,0,0,0,0
3,2673446010,201392388,47873,27791,2024-10-04 19:46:57,0,0,0,0,0,0
3,2673446010,201392388,47873,45795,2024-10-04 19:46:58,0,0,0,0,0,0
1,2673446010,201392386,47873,55957,2024-10-04 19:46:58,0,0,0,0,0,0
3,2673446010,201392388,47873,33466,2024-10-04 19:46:58,0,0,0,0,0,0
3,2673446010,201392388,47873,27791,2024-10-04 19:46:58,0,0,0,0,0,0
3,2673446010,201392388,47873,45795,2024-10-04 19:46:59,0,0,0,0,0,0
1,2673446010,201392386,47873,55957,2024-10-04 19:46:59,0,0,0,0,0,0
3,2673446010,201392388,47873,33466,2024-10-04 19:46:59,0,0,0,0,0,0
3,2673446010,201392388,47873,27791,2024-10-04 19:46:59,0,0,0,0,0,0
3,2673446010,201392388,47873,45795,2024-10-04 19:47:00,0,0,0,0,0,0
1,2673446010,201392386,47873,55957,2024-10-04 19:47:00,0,0,0,0,0,0
3,2673446010,201392388,47873,33466,2024-10-04 19:47:00,0,0,0,0,0,0
3,2673446010,201392388,47873,27791,2024-10-04 19:47:00,0,0,0,0,0,0
3,2673446010,201392388,47873,45795,2024-10-04 19:47:01,0,0,0,0,0,0
1,2673446010,201392386,47873,55957,2024-10-04 19:47:01,0,0,0,0,0,0
3,2673446010,201392388,47873,33466,2024-10-04 19:47:01,0,0,0,0,0,0
3,2673446010,201392388,47873,27791,2024-10-04 19:47:01,0,0,0,0,0,0
3,2673446010,201392388,47873,45795,2024-10-04 19:47:02,0,0,0,0,0,0
1,2673446010,201392386,47873,55957,2024-10-04 19:47:02,0,0,0,0,0,0
3,2673446010,201392388,47873,33466,2024-10-04 19:47:02,0,0,0,0,0,0
3,2673446010,201392388,47873,27791,2024-10-04 19:47:02,0,0,0,0,0,0
3,2673446010,201392388,47873,45795,2024-10-04 19:47:03,0,0,0,0,0,0
1,2673446010,201392386,47873,55957,2024-10-04 19:47:03,0,0,0,0,0,0
3,2673446010,201392388,47873,33466,2024-10-04 19:47:03,0,0,0,0,0,0
3,2673446010,201392388,47873,27791,2024-10-04 19:47:03,0,0,0,0,0,0
3,2673446010,201392388,47873,45795,2024-10-04 19:47:04,0,0,0,0,0,0
1,2673446010,201392386,47873,55957,2024-10-04 19:47:04,0,0,0,0,0,0
3,2673446010,201392388,47873,33466,2024-10-04 19:47:04,0,0,0,0,0,0
3,2673446010,201392388,47873,27791,2024-10-04 19:47:04,0,0,0,0,0,0
3,2673446010,201392388,47873,45795,2024-10-04 19:47:05,0,0,0,0,0,0
1,2673446010,201392386,47873,55957,2024-10-04 19:47:05,0,0,0,0,0,0
3,2673446010,201392388,47873,33466,2024-10-04 19:47:05,0,0,0,0,0,0
3,2673446010,201392388,47873,27791,2024-10-04 19:47:05,0,0,0,0,0,0
3,2673446010,201392388,47873,45795,2024-10-04 19:47:06,0,0,0,0,0,0
1,2673446010,201392386,47873,55957,2024-10-04 19:47:06,0,0,0,0,0,0
3,2673446010,201392388,47873,33466,2024-10-04 19:47:06,0,0,0,0,0,0
3,2673446010,201392388,47873,27791,2024-10-04 19:47:06,0,0,0,0,0,0
3,2673446010,201392388,47873,45795,2024-10-04 19:47:07,0,0,0,0,0,0
1,2673446010,201392386,47873,55957,2024-10-04 19:47:07,0,0,0,0,0,0
3,2673446010,201392388,47873,33466,2024-10-04 19:47:07,0,0,0,0,0,0
3,2673446010,201392388,47873,27791,2024-10-04 19:47:07,0,0,0,0,0,0
3,2673446010,201392388,47873,45795,2024-10-04 19:47:08,0,0,0,0,0,0
1,2673446010,201392386,47873,55957,2024-10-04 19:47:08,0,0,0,0,0,0
3,2673446010,201392388,47873,33466,2024-10-04 19:47:08,0,0,0,0,0,0
3,2673446010,201392388,47873,27791,2024-10-04 19:47:08,0,0,0,0,0,0
3,2673446010,201392388,47873,45795,2024-10-04 19:47:09,0,0,0,0,0,0
1,2673446010,201392386,47873,55957,2024-10-04 19:47:09,0,0,0,0,0,0
3,2673446010,201392388,47873,33466,2024-10-04 19:47:09,0,0,0,0,0,0
3,2673446010,201392388,47873,27791,2024-10-04 19:47:09,0,0,0,0,0,0
3,2673446010,201392388,47873,45795,2024-10-04 19:47:10,0,0,0,0,0,0
1,2673446010,201392386,47873,55957,2024-10-04 19:47:10,0,0,0,0,0,0
3,2673446010,201392388,47873,33466,2024-10-04 19:47:10,0,0,0,0,0,0
3,2673446010,201392388,47873,27791,2024-10-04 19:47:10,0,0,0,0,0,0
3,2673446010,201392388,47873,30350,2024-10-04 19:47:11,60,813,873,1,3,4
3,2673446010,201392388,47873,45795,2024-10-04 19:47:11,0,0,0,0,0,0
1,2673446010,201392386,47873,55957,2024-10-04 19:47:11,0,0,0,0,0,0
3,2673446010,201392388,47873,33466,2024-10-04 19:47:11,0,0,0,0,0,0
3,2673446010,201392388,47873,27791,2024-10-04 19:47:11,0,0,0,0,0,0
3,2673446010,201392388,47873,30350,2024-10-04 19:47:12,11376,2057,13433,19,18,37
3,2673446010,201392388,47873,45795,2024-10-04 19:47:12,0,0,0,0,0,0
1,2673446010,201392386,47873,55957,2024-10-04 19:47:12,0,0,0,0,0,0
3,2673446010,201392388,47873,33466,2024-10-04 19:47:12,0,0,0,0,0,0
3,2673446010,201392388,47873,27791,2024-10-04 19:47:12,0,0,0,0,0,0
3,2673446010,201392388,47873,30350,2024-10-04 19:47:13,0,0,0,0,0,0
3,2673446010,201392388,47873,45795,2024-10-04 19:47:13,0,0,0,0,0,0
1,2673446010,201392386,47873,55957,2024-10-04 19:47:13,0,0,0,0,0,0
3,2673446010,201392388,47873,33466,2024-10-04 19:47:13,0,0,0,0,0,0
3,2673446010,201392388,47873,27791,2024-10-04 19:47:13,0,0,0,0,0,0
3,2673446010,201392388,47873,30350,2024-10-04 19:47:14,0,0,0,0,0,0
3,2673446010,201392388,47873,45795,2024-10-04 19:47:14,0,0,0,0,0,0
1,2673446010,201392386,47873,55957,2024-10-04 19:47:14,0,0,0,0,0,0
3,2673446010,201392388,47873,33466,2024-10-04 19:47:14,0,0,0,0,0,0
3,2673446010,201392388,47873,27791,2024-10-04 19:47:14,0,0,0,0,0,0
3,2673446010,201392388,47873,30350,2024-10-04 19:47:15,0,0,0,0,0,0
3,2673446010,201392388,47873,45795,2024-10-04 19:47:15,0,0,0,0,0,0
1,2673446010,201392386,47873,55957,2024-10-04 19:47:15,0,0,0,0,0,0
3,2673446010,201392388,47873,33466,2024-10-04 19:47:15,0,0,0,0,0,0
3,2673446010,201392388,47873,27791,2024-10-04 19:47:15,0,0,0,0,0,0
3,2673446010,201392388,47873,30350,2024-10-04 19:47:16,0,0,0,0,0,0
3,2673446010,201392388,47873,45795,2024-10-04 19:47:16,0,0,0,0,0,0
1,2673446010,201392386,47873,55957,2024-10-04 19:47:16,0,0,0,0,0,0
3,2673446010,201392388,47873,33466,2024-10-04 19:47:16,0,0,0,0,0,0
3,2673446010,201392388,47873,27791,2024-10-04 19:47:16,0,0,0,0,0,0
2,2673446010,201392387,47873,3772,2024-10-04 19:47:17,9122,2666,11788,13,19,32
3,2673446010,201392388,47873,30350,2024-10-04 19:47:17,0,0,0,0,0,0
3,2673446010,201392388,47873,45795,2024-10-04 19:47:17,0,0,0,0,0,0
3,2673446010,201392388,47873,33466,2024-10-04 19:47:17,0,0,0,0,0,0
1,2673446010,201392386,47873,39049,2024-10-04 19:47:17,0,104,104,0,1,1
3,2673446010,201392388,47873,27791,2024-10-04 19:47:17,0,0,0,0,0,0
2,2673446010,201392387,47873,3772,2024-10-04 19:47:18,0,0,0,0,0,0
3,2673446010,201392388,47873,45795,2024-10-04 19:47:18,0,0,0,0,0,0
3,2673446010,201392388,47873,33466,2024-10-04 19:47:18,0,0,0,0,0,0
1,2673446010,201392386,47873,39049,2024-10-04 19:47:18,9386,2574,11960,18,18,36
3,2673446010,201392388,47873,27791,2024-10-04 19:47:18,0,0,0,0,0,0
2,2673446010,201392387,47873,3772,2024-10-04 19:47:19,0,0,0,0,0,0
3,2673446010,201392388,47873,45795,2024-10-04 19:47:19,0,0,0,0,0,0
3,2673446010,201392388,47873,33466,2024-10-04 19:47:19,0,0,0,0,0,0
1,2673446010,201392386,47873,39049,2024-10-04 19:47:19,0,0,0,0,0,0
3,2673446010,201392388,47873,27791,2024-10-04 19:47:19,0,0,0,0,0,0
2,2673446010,201392387,47873,3772,2024-10-04 19:47:20,0,0,0,0,0,0
3,2673446010,201392388,47873,45795,2024-10-04 19:47:20,0,0,0,0,0,0
3,2673446010,201392388,47873,33466,2024-10-04 19:47:20,0,0,0,0,0,0
1,2673446010,201392386,47873,39049,2024-10-04 19:47:20,0,0,0,0,0,0
3,2673446010,201392388,47873,27791,2024-10-04 19:47:20,0,0,0,0,0,0
2,2673446010,201392387,47873,3772,2024-10-04 19:47:21,0,0,0,0,0,0
3,2673446010,201392388,47873,45795,2024-10-04 19:47:21,0,0,0,0,0,0
3,2673446010,201392388,47873,33466,2024-10-04 19:47:21,0,0,0,0,0,0
1,2673446010,201392386,47873,39049,2024-10-04 19:47:21,0,0,0,0,0,0
3,2673446010,201392388,47873,27791,2024-10-04 19:47:21,0,0,0,0,0,0
2,2673446010,201392387,47873,3772,2024-10-04 19:47:22,0,0,0,0,0,0
3,2673446010,201392388,47873,45795,2024-10-04 19:47:22,0,0,0,0,0,0
3,2673446010,201392388,47873,33466,2024-10-04 19:47:22,0,0,0,0,0,0
1,2673446010,201392386,47873,39049,2024-10-04 19:47:22,0,0,0,0,0,0
3,2673446010,201392388,47873,27791,2024-10-04 19:47:22,0,0,0,0,0,0
2,2673446010,201392387,47873,3772,2024-10-04 19:47:23,0,0,0,0,0,0
3,2673446010,201392388,47873,45795,2024-10-04 19:47:23,0,0,0,0,0,0
3,2673446010,201392388,47873,33466,2024-10-04 19:47:23,0,0,0,0,0,0
1,2673446010,201392386,47873,39049,2024-10-04 19:47:23,0,0,0,0,0,0
3,2673446010,201392388,47873,27791,2024-10-04 19:47:23,0,0,0,0,0,0
2,2673446010,201392387,47873,3772,2024-10-04 19:47:24,0,0,0,0,0,0
3,2673446010,201392388,47873,45795,2024-10-04 19:47:24,0,0,0,0,0,0
3,2673446010,201392388,47873,33466,2024-10-04 19:47:24,0,0,0,0,0,0
1,2673446010,201392386,47873,39049,2024-10-04 19:47:24,0,0,0,0,0,0
3,2673446010,201392388,47873,27791,2024-10-04 19:47:24,0,0,0,0,0,0
2,2673446010,201392387,47873,3772,2024-10-04 19:47:25,0,0,0,0,0,0
3,2673446010,201392388,47873,45795,2024-10-04 19:47:25,0,0,0,0,0,0
3,2673446010,201392388,47873,33466,2024-10-04 19:47:25,0,0,0,0,0,0
1,2673446010,201392386,47873,39049,2024-10-04 19:47:25,0,0,0,0,0,0
3,2673446010,201392388,47873,27791,2024-10-04 19:47:25,0,0,0,0,0,0
2,2673446010,201392387,47873,3772,2024-10-04 19:47:26,0,0,0,0,0,0
3,2673446010,201392388,47873,45795,2024-10-04 19:47:26,0,0,0,0,0,0
3,2673446010,201392388,47873,33466,2024-10-04 19:47:26,0,0,0,0,0,0
1,2673446010,201392386,47873,39049,2024-10-04 19:47:26,0,0,0,0,0,0
3,2673446010,201392388,47873,27791,2024-10-04 19:47:26,0,0,0,0,0,0
2,2673446010,201392387,47873,3772,2024-10-04 19:47:27,0,0,0,0,0,0
3,2673446010,201392388,47873,45795,2024-10-04 19:47:27,0,0,0,0,0,0
3,2673446010,201392388,47873,33466,2024-10-04 19:47:27,0,0,0,0,0,0
3,2673446010,201392388,47873,27791,2024-10-04 19:47:27,0,0,0,0,0,0
2,2673446010,201392387,47873,3772,2024-10-04 19:47:28,0,0,0,0,0,0
3,2673446010,201392388,47873,45795,2024-10-04 19:47:28,0,0,0,0,0,0
3,2673446010,201392388,47873,33466,2024-10-04 19:47:28,0,0,0,0,0,0
3,2673446010,201392388,47873,27791,2024-10-04 19:47:28,0,0,0,0,0,0
2,2673446010,201392387,47873,3772,2024-10-04 19:47:29,0,0,0,0,0,0
3,2673446010,201392388,47873,45795,2024-10-04 19:47:29,0,0,0,0,0,0
3,2673446010,201392388,47873,33466,2024-10-04 19:47:29,0,0,0,0,0,0
3,2673446010,201392388,47873,27791,2024-10-04 19:47:29,0,0,0,0,0,0
2,2673446010,201392387,47873,3772,2024-10-04 19:47:30,0,0,0,0,0,0
3,2673446010,201392388,47873,45795,2024-10-04 19:47:30,0,0,0,0,0,0
3,2673446010,201392388,47873,33466,2024-10-04 19:47:30,0,0,0,0,0,0
3,2673446010,201392388,47873,27791,2024-10-04 19:47:30,0,0,0,0,0,0
2,2673446010,201392387,47873,3772,2024-10-04 19:47:31,0,0,0,0,0,0
3,2673446010,201392388,47873,45795,2024-10-04 19:47:31,0,0,0,0,0,0
3,2673446010,201392388,47873,33466,2024-10-04 19:47:31,0,0,0,0,0,0
3,2673446010,201392388,47873,27791,2024-10-04 19:47:31,0,0,0,0,0,0
2,2673446010,201392387,47873,3772,2024-10-04 19:47:32,0,0,0,0,0,0
3,2673446010,201392388,47873,45795,2024-10-04 19:47:32,0,0,0,0,0,0
3,2673446010,201392388,47873,33466,2024-10-04 19:47:32,0,0,0,0,0,0
3,2673446010,201392388,47873,27791,2024-10-04 19:47:32,0,0,0,0,0,0
2,2673446010,201392387,47873,3772,2024-10-04 19:47:33,0,0,0,0,0,0
3,2673446010,201392388,47873,45795,2024-10-04 19:47:33,0,0,0,0,0,0
3,2673446010,201392388,47873,33466,2024-10-04 19:47:33,0,0,0,0,0,0
3,2673446010,201392388,47873,27791,2024-10-04 19:47:33,0,0,0,0,0,0
2,2673446010,201392387,47873,3772,2024-10-04 19:47:34,0,0,0,0,0,0
3,2673446010,201392388,47873,45795,2024-10-04 19:47:34,0,0,0,0,0,0
3,2673446010,201392388,47873,33466,2024-10-04 19:47:34,0,0,0,0,0,0
3,2673446010,201392388,47873,27791,2024-10-04 19:47:34,0,0,0,0,0,0
2,2673446010,201392387,47873,3772,2024-10-04 19:47:35,0,0,0,0,0,0
3,2673446010,201392388,47873,45795,2024-10-04 19:47:35,0,0,0,0,0,0
3,2673446010,201392388,47873,33466,2024-10-04 19:47:35,0,0,0,0,0,0
3,2673446010,201392388,47873,27791,2024-10-04 19:47:35,0,0,0,0,0,0
2,2673446010,201392387,47873,3772,2024-10-04 19:47:36,0,0,0,0,0,0
3,2673446010,201392388,47873,45795,2024-10-04 19:47:36,0,0,0,0,0,0
3,2673446010,201392388,47873,33466,2024-10-04 19:47:36,0,0,0,0,0,0
3,2673446010,201392388,47873,27791,2024-10-04 19:47:36,0,0,0,0,0,0
2,2673446010,201392387,47873,3772,2024-10-04 19:47:37,0,0,0,0,0,0
3,2673446010,201392388,47873,45795,2024-10-04 19:47:37,0,0,0,0,0,0
3,2673446010,201392388,47873,33466,2024-10-04 19:47:37,0,0,0,0,0,0
3,2673446010,201392388,47873,27791,2024-10-04 19:47:37,0,0,0,0,0,0
2,2673446010,201392387,47873,3772,2024-10-04 19:47:38,0,0,0,0,0,0
3,2673446010,201392388,47873,45795,2024-10-04 19:47:38,0,0,0,0,0,0
3,2673446010,201392388,47873,33466,2024-10-04 19:47:38,0,0,0,0,0,0
3,2673446010,201392388,47873,27791,2024-10-04 19:47:38,0,0,0,0,0,0
2,2673446010,201392387,47873,3772,2024-10-04 19:47:39,0,0,0,0,0,0
3,2673446010,201392388,47873,45795,2024-10-04 19:47:39,0,0,0,0,0,0
3,2673446010,201392388,47873,33466,2024-10-04 19:47:39,0,0,0,0,0,0
3,2673446010,201392388,47873,27791,2024-10-04 19:47:39,0,0,0,0,0,0
2,2673446010,201392387,47873,3772,2024-10-04 19:47:40,0,0,0,0,0,0
3,2673446010,201392388,47873,45795,2024-10-04 19:47:40,0,0,0,0,0,0
3,2673446010,201392388,47873,33466,2024-10-04 19:47:40,0,0,0,0,0,0
3,2673446010,201392388,47873,27791,2024-10-04 19:47:40,0,0,0,0,0,0
2,2673446010,201392387,47873,3772,2024-10-04 19:47:41,0,0,0,0,0,0
3,2673446010,201392388,47873,45795,2024-10-04 19:47:41,0,0,0,0,0,0
3,2673446010,201392388,47873,33466,2024-10-04 19:47:41,0,0,0,0,0,0
3,2673446010,201392388,47873,27791,2024-10-04 19:47:41,0,0,0,0,0,0
2,2673446010,201392387,47873,3772,2024-10-04 19:47:42,0,0,0,0,0,0
3,2673446010,201392388,47873,45795,2024-10-04 19:47:42,0,0,0,0,0,0
3,2673446010,201392388,47873,33466,2024-10-04 19:47:42,0,0,0,0,0,0
3,2673446010,201392388,47873,13497,2024-10-04 19:47:42,3375,921,4296,4,4,8
3,2673446010,201392388,47873,27791,2024-10-04 19:47:42,0,0,0,0,0,0
2,2673446010,201392387,47873,3772,2024-10-04 19:47:43,0,0,0,0,0,0
3,2673446010,201392388,47873,45795,2024-10-04 19:47:43,0,0,0,0,0,0
3,2673446010,201392388,47873,33466,2024-10-04 19:47:43,0,0,0,0,0,0
3,2673446010,201392388,47873,13497,2024-10-04 19:47:43,7714,1769,9483,10,15,25
3,2673446010,201392388,47873,27791,2024-10-04 19:47:43,0,0,0,0,0,0
2,2673446010,201392387,47873,3772,2024-10-04 19:47:44,0,0,0,0,0,0
3,2673446010,201392388,47873,45795,2024-10-04 19:47:44,0,0,0,0,0,0
3,2673446010,201392388,47873,33466,2024-10-04 19:47:44,0,0,0,0,0,0
3,2673446010,201392388,47873,13497,2024-10-04 19:47:44,0,0,0,0,0,0
3,2673446010,201392388,47873,27791,2024-10-04 19:47:44,0,0,0,0,0,0
2,2673446010,201392387,47873,3772,2024-10-04 19:47:45,0,0,0,0,0,0
3,2673446010,201392388,47873,45795,2024-10-04 19:47:45,0,0,0,0,0,0
3,2673446010,201392388,47873,33466,2024-10-04 19:47:45,0,0,0,0,0,0
3,2673446010,201392388,47873,13497,2024-10-04 19:47:45,0,0,0,0,0,0
3,2673446010,201392388,47873,27791,2024-10-04 19:47:45,0,0,0,0,0,0
2,2673446010,201392387,47873,3772,2024-10-04 19:47:46,0,0,0,0,0,0
3,2673446010,201392388,47873,45795,2024-10-04 19:47:46,0,0,0,0,0,0
3,2673446010,201392388,47873,33466,2024-10-04 19:47:46,0,0,0,0,0,0
3,2673446010,201392388,47873,13497,2024-10-04 19:47:46,0,0,0,0,0,0
3,2673446010,201392388,47873,27791,2024-10-04 19:47:46,0,0,0,0,0,0
2,2673446010,201392387,47873,3772,2024-10-04 19:47:47,0,0,0,0,0,0
3,2673446010,201392388,47873,45795,2024-10-04 19:47:47,0,0,0,0,0,0
2,2673446010,201392387,47873,21145,2024-10-04 19:47:47,0,104,104,0,1,1
3,2673446010,201392388,47873,33466,2024-10-04 19:47:47,0,0,0,0,0,0
3,2673446010,201392388,47873,13497,2024-10-04 19:47:47,0,0,0,0,0,0
3,2673446010,201392388,47873,27791,2024-10-04 19:47:47,0,0,0,0,0,0
1,2673446010,201392386,47873,7302,2024-10-04 19:47:48,112,813,925,2,3,5
3,2673446010,201392388,47873,45795,2024-10-04 19:47:48,0,0,0,0,0,0
2,2673446010,201392387,47873,21145,2024-10-04 19:47:48,9309,2562,11871,17,18,35
3,2673446010,201392388,47873,33466,2024-10-04 19:47:48,0,0,0,0,0,0
3,2673446010,201392388,47873,13497,2024-10-04 19:47:48,0,0,0,0,0,0
3,2673446010,201392388,47873,27791,2024-10-04 19:47:48,0,0,0,0,0,0
1,2673446010,201392386,47873,7302,2024-10-04 19:47:49,8992,1649,10641,12,14,26
3,2673446010,201392388,47873,45795,2024-10-04 19:47:49,0,0,0,0,0,0
2,2673446010,201392387,47873,21145,2024-10-04 19:47:49,0,0,0,0,0,0
3,2673446010,201392388,47873,33466,2024-10-04 19:47:49,0,0,0,0,0,0
3,2673446010,201392388,47873,27791,2024-10-04 19:47:49,0,0,0,0,0,0
1,2673446010,201392386,47873,7302,2024-10-04 19:47:50,0,0,0,0,0,0
3,2673446010,201392388,47873,45795,2024-10-04 19:47:50,0,0,0,0,0,0
2,2673446010,201392387,47873,21145,2024-10-04 19:47:50,0,0,0,0,0,0
3,2673446010,201392388,47873,33466,2024-10-04 19:47:50,0,0,0,0,0,0
3,2673446010,201392388,47873,27791,2024-10-04 19:47:50,0,0,0,0,0,0
1,2673446010,201392386,47873,7302,2024-10-04 19:47:51,0,0,0,0,0,0
3,2673446010,201392388,47873,45795,2024-10-04 19:47:51,0,0,0,0,0,0
2,2673446010,201392387,47873,21145,2024-10-04 19:47:51,0,0,0,0,0,0
3,2673446010,201392388,47873,33466,2024-10-04 19:47:51,0,0,0,0,0,0
3,2673446010,201392388,47873,27791,2024-10-04 19:47:51,0,0,0,0,0,0
1,2673446010,201392386,47873,7302,2024-10-04 19:47:52,0,0,0,0,0,0
3,2673446010,201392388,47873,45795,2024-10-04 19:47:52,0,0,0,0,0,0
2,2673446010,201392387,47873,21145,2024-10-04 19:47:52,0,0,0,0,0,0
3,2673446010,201392388,47873,33466,2024-10-04 19:47:52,0,0,0,0,0,0
3,2673446010,201392388,47873,27791,2024-10-04 19:47:52,0,0,0,0,0,0
1,2673446010,201392386,47873,7302,2024-10-04 19:47:53,0,0,0,0,0,0
3,2673446010,201392388,47873,45795,2024-10-04 19:47:53,0,0,0,0,0,0
2,2673446010,201392387,47873,21145,2024-10-04 19:47:53,0,0,0,0,0,0
3,2673446010,201392388,47873,33466,2024-10-04 19:47:53,0,0,0,0,0,0
3,2673446010,201392388,47873,27791,2024-10-04 19:47:53,0,0,0,0,0,0
1,2673446010,201392386,47873,7302,2024-10-04 19:47:54,0,0,0,0,0,0
3,2673446010,201392388,47873,45795,2024-10-04 19:47:54,0,0,0,0,0,0
2,2673446010,201392387,47873,21145,2024-10-04 19:47:54,0,0,0,0,0,0
3,2673446010,201392388,47873,33466,2024-10-04 19:47:54,0,0,0,0,0,0
3,2673446010,201392388,47873,27791,2024-10-04 19:47:54,0,0,0,0,0,0
1,2673446010,201392386,47873,7302,2024-10-04 19:47:55,0,0,0,0,0,0
3,2673446010,201392388,47873,45795,2024-10-04 19:47:55,0,0,0,0,0,0
2,2673446010,201392387,47873,21145,2024-10-04 19:47:55,0,0,0,0,0,0
3,2673446010,201392388,47873,33466,2024-10-04 19:47:55,0,0,0,0,0,0
3,2673446010,201392388,47873,27791,2024-10-04 19:47:55,0,0,0,0,0,0
1,2673446010,201392386,47873,7302,2024-10-04 19:47:56,0,0,0,0,0,0
3,2673446010,201392388,47873,45795,2024-10-04 19:47:56,0,0,0,0,0,0
2,2673446010,201392387,47873,21145,2024-10-04 19:47:56,0,0,0,0,0,0
3,2673446010,201392388,47873,33466,2024-10-04 19:47:56,0,0,0,0,0,0
3,2673446010,201392388,47873,27791,2024-10-04 19:47:56,0,0,0,0,0,0
1,2673446010,201392386,47873,7302,2024-10-04 19:47:57,0,0,0,0,0,0
3,2673446010,201392388,47873,45795,2024-10-04 19:47:57,0,0,0,0,0,0
2,2673446010,201392387,47873,21145,2024-10-04 19:47:57,0,0,0,0,0,0
3,2673446010,201392388,47873,33466,2024-10-04 19:47:57,0,0,0,0,0,0
3,2673446010,201392388,47873,27791,2024-10-04 19:47:57,0,0,0,0,0,0
3,2673446010,201392388,47873,45795,2024-10-04 19:47:58,0,0,0,0,0,0
2,2673446010,201392387,47873,21145,2024-10-04 19:47:58,0,0,0,0,0,0
3,2673446010,201392388,47873,33466,2024-10-04 19:47:58,0,0,0,0,0,0
3,2673446010,201392388,47873,27791,2024-10-04 19:47:58,0,0,0,0,0,0
3,2673446010,201392388,47873,45795,2024-10-04 19:47:59,0,0,0,0,0,0
2,2673446010,201392387,47873,21145,2024-10-04 19:47:59,0,0,0,0,0,0
3,2673446010,201392388,47873,33466,2024-10-04 19:47:59,0,0,0,0,0,0
3,2673446010,201392388,47873,27791,2024-10-04 19:47:59,0,0,0,0,0,0
3,2673446010,201392388,47873,45795,2024-10-04 19:48:00,0,0,0,0,0,0
2,2673446010,201392387,47873,21145,2024-10-04 19:48:00,0,0,0,0,0,0
3,2673446010,201392388,47873,33466,2024-10-04 19:48:00,0,0,0,0,0,0
3,2673446010,201392388,47873,27791,2024-10-04 19:48:00,0,0,0,0,0,0
3,2673446010,201392388,47873,45795,2024-10-04 19:48:01,0,0,0,0,0,0
2,2673446010,201392387,47873,21145,2024-10-04 19:48:01,0,0,0,0,0,0
3,2673446010,201392388,47873,33466,2024-10-04 19:48:01,0,0,0,0,0,0
3,2673446010,201392388,47873,27791,2024-10-04 19:48:01,0,0,0,0,0,0
3,2673446010,201392388,47873,45795,2024-10-04 19:48:02,0,0,0,0,0,0
2,2673446010,201392387,47873,21145,2024-10-04 19:48:02,0,0,0,0,0,0
3,2673446010,201392388,47873,33466,2024-10-04 19:48:02,0,0,0,0,0,0
3,2673446010,201392388,47873,27791,2024-10-04 19:48:02,0,0,0,0,0,0
3,2673446010,201392388,47873,45795,2024-10-04 19:48:03,0,0,0,0,0,0
2,2673446010,201392387,47873,21145,2024-10-04 19:48:03,0,0,0,0,0,0
3,2673446010,201392388,47873,33466,2024-10-04 19:48:03,0,0,0,0,0,0
3,2673446010,201392388,47873,27791,2024-10-04 19:48:03,0,0,0,0,0,0
3,2673446010,201392388,47873,45795,2024-10-04 19:48:04,0,0,0,0,0,0
2,2673446010,201392387,47873,21145,2024-10-04 19:48:04,0,0,0,0,0,0
3,2673446010,201392388,47873,33466,2024-10-04 19:48:04,0,0,0,0,0,0
3,2673446010,201392388,47873,27791,2024-10-04 19:48:04,0,0,0,0,0,0
3,2673446010,201392388,47873,45795,2024-10-04 19:48:05,0,0,0,0,0,0
2,2673446010,201392387,47873,21145,2024-10-04 19:48:05,0,0,0,0,0,0
3,2673446010,201392388,47873,33466,2024-10-04 19:48:05,0,0,0,0,0,0
3,2673446010,201392388,47873,27791,2024-10-04 19:48:05,0,0,0,0,0,0
3,2673446010,201392388,47873,45795,2024-10-04 19:48:06,0,0,0,0,0,0
2,2673446010,201392387,47873,21145,2024-10-04 19:48:06,0,0,0,0,0,0
3,2673446010,201392388,47873,33466,2024-10-04 19:48:06,0,0,0,0,0,0
3,2673446010,201392388,47873,27791,2024-10-04 19:48:06,0,0,0,0,0,0
3,2673446010,201392388,47873,45795,2024-10-04 19:48:07,0,0,0,0,0,0
2,2673446010,201392387,47873,21145,2024-10-04 19:48:07,0,0,0,0,0,0
3,2673446010,201392388,47873,33466,2024-10-04 19:48:07,0,0,0,0,0,0
3,2673446010,201392388,47873,27791,2024-10-04 19:48:07,0,0,0,0,0,0
3,2673446010,201392388,47873,45795,2024-10-04 19:48:08,0,0,0,0,0,0
2,2673446010,201392387,47873,21145,2024-10-04 19:48:08,0,0,0,0,0,0
3,2673446010,201392388,47873,33466,2024-10-04 19:48:08,0,0,0,0,0,0
3,2673446010,201392388,47873,27791,2024-10-04 19:48:08,0,0,0,0,0,0
3,2673446010,201392388,47873,45795,2024-10-04 19:48:09,0,0,0,0,0,0
2,2673446010,201392387,47873,21145,2024-10-04 19:48:09,0,0,0,0,0,0
3,2673446010,201392388,47873,33466,2024-10-04 19:48:09,0,0,0,0,0,0
3,2673446010,201392388,47873,27791,2024-10-04 19:48:09,0,0,0,0,0,0
3,2673446010,201392388,47873,45795,2024-10-04 19:48:10,0,0,0,0,0,0
2,2673446010,201392387,47873,21145,2024-10-04 19:48:10,0,0,0,0,0,0
3,2673446010,201392388,47873,33466,2024-10-04 19:48:10,0,0,0,0,0,0
3,2673446010,201392388,47873,27791,2024-10-04 19:48:10,0,0,0,0,0,0
